 Date,合约,日期,前收盘价,前结算价,开盘价,最高价,最低价,收盘价,结算价,涨跌1,涨跌2,成交量,成交金额,持仓量 
 20100104,a1009,20100104,4038,4026,4080,4090,4049,4057,4069,31,43,321838,1309575.66,284296 
 20100105,a1009,20100105,4057,4069,4067,4082,4060,4066,4070,-3,1,253640,1032415.2,283384 
 20100106,a1009,20100106,4066,4070,4066,4194,4057,4154,4140,84,70,860812,3564243.02,352830 
 20100107,a1009,20100107,4154,4140,4165,4188,3975,4044,4090,-96,-50,705704,2886379.46,297236 
 20100108,a1009,20100108,4044,4090,4040,4050,3947,3981,4000,-109,-90,526594,2106492.62,270074 
 20100111,a1009,20100111,3981,4000,4012,4050,4012,4031,4035,31,35,316116,1275745.51,270738 
 20100112,a1009,20100112,4031,4035,4000,4029,3981,4004,4004,-31,-31,447848,1793378.68,271068 
 20100113,a1009,20100113,4004,4004,3905,3938,3896,3909,3917,-95,-87,300960,1178993.33,260966 
 20100114,a1009,20100114,3909,3917,3943,3943,3918,3919,3931,2,14,190364,748376.07,259500 
 20100115,a1009,20100115,3919,3931,3905,3949,3902,3915,3928,-16,-3,313576,1232023.38,265124 
 20100118,a1009,20100118,3915,3928,3908,3925,3890,3909,3908,-19,-20,249986,976977.45,269332 
 20100119,a1009,20100119,3909,3908,3935,3935,3910,3919,3921,11,13,167968,658724.03,274202 
 20100120,a1009,20100120,3919,3921,3910,3929,3858,3861,3881,-60,-40,335400,1301796.66,290088 
 20100121,a1009,20100121,3861,3881,3860,3903,3852,3901,3878,20,-3,271388,1052480.39,280512 
 20100122,a1009,20100122,3901,3878,3887,3893,3837,3889,3872,11,-6,280556,1086413.02,270304 
 20100125,a1009,20100125,3889,3872,3878,3926,3875,3911,3907,39,35,337600,1319098.17,277594 
 20100126,a1009,20100126,3911,3907,3910,3930,3883,3885,3904,-22,-3,470020,1834998.5,278582 
 20100127,a1009,20100127,3885,3904,3905,3938,3900,3922,3920,18,16,618382,2424612.58,296746 
 20100128,a1009,20100128,3922,3920,3900,3900,3842,3863,3865,-57,-55,401078,1550541.43,277646 
 20100129,a1009,20100129,3863,3865,3870,3884,3850,3853,3868,-12,3,260046,1006095.76,264630 
 20100201,a1009,20100201,3853,3868,3839,3849,3760,3768,3795,-100,-73,404240,1534095.33,282970 
 20100202,a1009,20100202,3768,3795,3785,3798,3728,3735,3755,-60,-40,374218,1405390.47,279460 
 20100203,a1009,20100203,3735,3755,3771,3785,3744,3782,3767,27,12,291838,1099613.11,271958 
 20100204,a1009,20100204,3782,3767,3740,3760,3720,3755,3742,-12,-25,250890,938905.99,274098 
 20100205,a1009,20100205,3755,3742,3740,3793,3728,3785,3777,43,35,539114,2036493.09,280652 
 20100208,a1009,20100208,3785,3777,3810,3825,3801,3812,3812,35,35,224846,857133.93,275382 
 20100209,a1009,20100209,3812,3812,3812,3819,3796,3809,3807,-3,-5,141526,538887.65,271300 
 20100210,a1009,20100210,3809,3807,3807,3815,3748,3769,3779,-38,-28,302080,1141588.46,273654 
 20100211,a1009,20100211,3769,3779,3807,3828,3784,3798,3807,19,28,243738,928005.44,251010 
 20100212,a1009,20100212,3798,3807,3801,3808,3763,3776,3780,-31,-27,133432,504474.68,246028 
 20100222,a1009,20100222,3776,3780,3815,3850,3800,3819,3816,39,36,171364,653926.18,249340 
 20100223,a1009,20100223,3819,3816,3830,3878,3825,3874,3854,58,38,342832,1321529.2,269414 
 20100224,a1009,20100224,3874,3854,3851,3867,3848,3858,3858,4,4,204128,787581.92,261240 
 20100225,a1009,20100225,3858,3858,3867,3874,3825,3838,3849,-20,-9,205796,792260.07,252990 
 20100226,a1009,20100226,3838,3849,3830,3845,3820,3830,3833,-19,-16,182768,700567.82,252534 
 20100301,a1009,20100301,3830,3833,3860,3904,3843,3883,3880,50,47,422434,1639175.26,272608 
 20100302,a1009,20100302,3883,3880,3881,3898,3865,3873,3882,-7,2,428712,1664286.76,272774 
 20100303,a1009,20100303,3873,3882,3886,3910,3878,3892,3894,10,12,388958,1514983.74,275790 
 20100304,a1009,20100304,3892,3894,3882,3889,3833,3834,3861,-60,-33,299648,1157182.69,272514 
 20100305,a1009,20100305,3834,3861,3814,3840,3804,3835,3822,-26,-39,212816,813502.64,262814 
 20100308,a1009,20100308,3835,3822,3842,3845,3821,3842,3836,20,14,201768,774005.65,267618 
 20100309,a1009,20100309,3842,3836,3836,3855,3826,3845,3840,9,4,217344,834778.34,263458 
 20100310,a1009,20100310,3845,3840,3835,3852,3834,3836,3842,-4,2,118736,456193.31,259312 
 20100311,a1009,20100311,3836,3842,3855,3876,3830,3850,3856,8,14,466534,1799082.41,261064 
 20100312,a1009,20100312,3850,3856,3825,3830,3806,3810,3815,-46,-41,293040,1118202.2,256978 
 20100315,a1009,20100315,3810,3815,3813,3816,3786,3800,3800,-15,-15,212506,807531.6,253694 
 20100316,a1009,20100316,3800,3800,3805,3839,3804,3838,3820,38,20,208026,794825.19,243116 
 20100317,a1009,20100317,3838,3820,3850,3859,3841,3846,3848,26,28,170430,655945.68,238796 
 20100318,a1009,20100318,3846,3848,3858,3858,3827,3835,3842,-13,-6,129994,499471.08,234726 
 20100319,a1009,20100319,3835,3842,3842,3875,3841,3861,3862,19,20,236678,914162.03,230474 
 20100322,a1009,20100322,3861,3862,3850,3885,3850,3870,3867,8,5,182286,705019.04,220340 
 20100323,a1009,20100323,3870,3867,3900,3901,3861,3870,3880,3,13,175342,680461.13,214350 
 20100324,a1009,20100324,3870,3880,3867,3871,3850,3858,3860,-22,-20,117950,455360.53,210272 
 20100325,a1009,20100325,3858,3860,3855,3874,3855,3862,3865,2,5,89278,345099.79,211644 
 20100326,a1009,20100326,3862,3865,3850,3858,3835,3853,3845,-12,-20,120740,464359.47,209620 
 20100329,a1009,20100329,3853,3845,3868,3878,3855,3869,3867,24,22,80396,310892.08,201918 
 20100330,a1009,20100330,3869,3867,3880,3898,3862,3893,3883,26,16,168978,656232.54,197156 
 20100331,a1009,20100331,3893,3883,3896,3920,3885,3888,3902,5,19,281680,1099166.9,205352 
 20100401,a1009,20100401,3888,3902,3847,3876,3838,3868,3863,-34,-39,122882,474701.19,194516 
 20100402,a1009,20100402,3868,3863,3867,3884,3867,3878,3876,15,13,64704,250819.92,196756 
 20100406,a1009,20100406,3878,3876,3872,3885,3869,3875,3878,-1,2,58094,225307.97,194454 
 20100407,a1009,20100407,3875,3878,3884,3903,3880,3894,3891,16,13,127604,496574.09,198182 
 20100408,a1009,20100408,3894,3891,3895,3916,3881,3883,3902,-8,11,142680,556749.8,191820 
 20100409,a1009,20100409,3883,3902,3885,3896,3885,3891,3890,-11,-12,56112,218291.53,189198 
 20100412,a1101,20100412,3890,3880,3905,3935,3902,3930,3915,50,35,99120,388113.34,106832 
 20100413,a1101,20100413,3930,3915,3915,3947,3902,3945,3924,30,9,249366,978732.7,120090 
 20100414,a1101,20100414,3945,3924,3960,3964,3936,3939,3948,15,24,173136,683619.91,103704 
 20100415,a1101,20100415,3939,3948,3938,3949,3926,3929,3937,-19,-11,96066,378261.18,102586 
 20100416,a1101,20100416,3929,3937,3952,3968,3945,3953,3955,16,18,126732,501260.13,110568 
 20100419,a1101,20100419,3953,3955,3940,3950,3903,3916,3928,-39,-27,136534,536385.03,111184 
 20100420,a1101,20100420,3916,3928,3931,3962,3931,3956,3951,28,23,192604,761120.06,126296 
 20100421,a1101,20100421,3956,3951,3960,3979,3955,3971,3969,20,18,231448,918636.37,144388 
 20100422,a1101,20100422,3971,3969,3978,3995,3977,3981,3985,12,16,213782,852070.74,157868 
 20100423,a1101,20100423,3981,3985,3986,4005,3986,3992,3995,7,10,228426,912685.72,166058 
 20100426,a1101,20100426,3992,3995,3998,4005,3980,3990,3993,-5,-2,171704,685653.25,157204 
 20100427,a1101,20100427,3990,3993,3980,3982,3958,3973,3969,-20,-24,143266,568636.32,148294 
 20100428,a1101,20100428,3973,3969,3943,3955,3906,3949,3940,-20,-29,147676,581945.61,146168 
 20100429,a1101,20100429,3949,3940,3950,3964,3950,3953,3957,13,17,73382,290391.02,147088 
 20100430,a1101,20100430,3953,3957,3957,3989,3953,3988,3965,31,8,128442,509357.54,150710 
 20100504,a1101,20100504,3988,3965,3965,3974,3956,3965,3963,0,-2,109026,432151.32,147120 
 20100505,a1101,20100505,3965,3963,3964,4031,3948,4026,4006,63,43,539238,2160696.68,236426 
 20100506,a1101,20100506,4026,4006,4025,4027,3972,3977,3995,-29,-11,489972,1957925.33,206120 
 20100507,a1101,20100507,3977,3995,3940,3944,3899,3911,3923,-84,-72,379706,1489782.65,194340 
 20100510,a1101,20100510,3911,3923,3940,3960,3928,3955,3944,32,21,261150,1030199.74,203512 
 20100511,a1101,20100511,3955,3944,3948,3952,3923,3928,3936,-16,-8,237636,935513.72,199814 
 20100512,a1101,20100512,3928,3936,3939,3971,3935,3958,3958,22,22,226094,894937.92,195902 
 20100513,a1101,20100513,3958,3958,3958,3966,3941,3956,3952,-2,-6,138812,548592.85,196232 
 20100514,a1101,20100514,3956,3952,3953,3955,3912,3923,3933,-29,-19,169968,668534.07,200978 
 20100517,a1101,20100517,3923,3933,3910,3912,3809,3843,3851,-90,-82,305380,1176041.28,205728 
 20100518,a1101,20100518,3843,3851,3840,3873,3825,3869,3856,18,5,210406,811505.94,203712 
 20100519,a1101,20100519,3869,3856,3835,3859,3827,3831,3842,-25,-14,178838,687197.2,198688 
 20100520,a1101,20100520,3831,3842,3850,3863,3836,3847,3851,5,9,164612,633945.42,199584 
 20100521,a1101,20100521,3847,3851,3844,3883,3840,3872,3866,21,15,328810,1271225.52,203494 
 20100524,a1101,20100524,3872,3866,3872,3890,3866,3886,3879,20,13,165108,640498.11,202658 
 20100525,a1101,20100525,3886,3879,3875,3875,3841,3846,3856,-33,-23,161154,621503.85,197734 
 20100526,a1101,20100526,3846,3856,3859,3880,3830,3874,3862,18,6,260208,1004980.25,210034 
 20100527,a1101,20100527,3874,3862,3879,3879,3859,3872,3868,10,6,172790,668435.78,199878 
 20100528,a1101,20100528,3872,3868,3882,3894,3864,3868,3878,0,10,219636,851864.26,201002 
 20100531,a1101,20100531,3868,3878,3854,3857,3831,3832,3844,-46,-34,179904,691627.58,208090 
 20100601,a1101,20100601,3832,3844,3838,3843,3806,3811,3821,-33,-23,175060,669059.15,206462 
 20100602,a1101,20100602,3811,3821,3800,3829,3800,3827,3818,6,-3,180870,690708.71,205608 
 20100603,a1101,20100603,3827,3818,3824,3840,3823,3830,3831,12,13,137288,525962.24,205006 
 20100604,a1101,20100604,3830,3831,3852,3856,3832,3842,3844,11,13,102152,392719.74,199150 
 20100607,a1101,20100607,3842,3844,3781,3798,3772,3789,3788,-55,-56,120568,456724.55,204794 
 20100608,a1101,20100608,3789,3788,3790,3818,3789,3807,3806,19,18,116218,442343.35,207114 
 20100609,a1101,20100609,3807,3806,3800,3800,3768,3796,3784,-10,-22,159430,603387.07,197242 
 20100610,a1101,20100610,3796,3784,3800,3821,3793,3800,3807,16,23,130832,498110.99,188042 
 20100611,a1101,20100611,3800,3807,3801,3809,3790,3795,3798,-12,-9,73402,278842.48,182804 
 20100617,a1101,20100617,3795,3798,3846,3846,3818,3823,3829,25,31,71140,272410.74,172496 
 20100618,a1101,20100618,3823,3829,3828,3838,3821,3830,3830,1,1,94266,361126.29,172690 
 20100621,a1101,20100621,3830,3830,3848,3888,3845,3882,3868,52,38,124578,481868.5,175674 
 20100622,a1101,20100622,3882,3868,3869,3875,3861,3870,3867,2,-1,55036,212834.42,175472 
 20100623,a1101,20100623,3870,3867,3852,3873,3851,3863,3862,-4,-5,62360,240858.66,172590 
 20100624,a1101,20100624,3863,3862,3855,3869,3853,3859,3861,-3,-1,49000,189221.76,171678 
 20100625,a1101,20100625,3859,3861,3849,3854,3838,3846,3845,-15,-16,38052,146343.91,171360 
 20100628,a1101,20100628,3846,3845,3844,3859,3842,3854,3854,9,9,48758,187936.37,174068 
 20100629,a1101,20100629,3854,3854,3856,3868,3828,3846,3851,-8,-3,77006,296550.56,170908 
 20100630,a1101,20100630,3846,3851,3832,3835,3811,3822,3821,-29,-30,47202,180371.56,171230 
 20100701,a1101,20100701,3822,3821,3812,3825,3812,3814,3819,-7,-2,31824,121544.15,172500 
 20100702,a1101,20100702,3814,3819,3815,3841,3815,3833,3827,14,8,48998,187516.19,172704 
 20100705,a1101,20100705,3833,3827,3825,3839,3820,3821,3825,-6,-2,29400,112473.52,172788 
 20100706,a1101,20100706,3821,3825,3820,3820,3794,3808,3804,-17,-21,67110,255348.58,175464 
 20100707,a1101,20100707,3808,3804,3805,3818,3804,3811,3811,7,7,29922,114045.11,174700 
 20100708,a1101,20100708,3811,3811,3859,3859,3841,3846,3848,35,37,56018,215602.38,163782 
 20100709,a1101,20100709,3846,3848,3860,3865,3843,3859,3854,11,6,86356,332859.44,161118 
 20100712,a1101,20100712,3859,3854,3888,3888,3848,3850,3861,-4,7,56184,216971.44,159328 
 20100713,a1101,20100713,3850,3861,3859,3859,3828,3832,3844,-29,-17,45282,174090.37,156064 
 20100714,a1101,20100714,3832,3844,3844,3849,3840,3845,3843,1,-1,27884,107177.43,153726 
 20100715,a1105,20100715,3869,3870,3871,3912,3867,3883,3894,13,24,71814,279712.6,113150 
 20100716,a1105,20100716,3883,3894,3920,3946,3912,3939,3935,45,41,93944,369709.03,126926 
 20100719,a1105,20100719,3939,3935,3934,3953,3922,3947,3932,12,-3,46790,184009.61,128846 
 20100720,a1105,20100720,3947,3932,3930,3970,3923,3961,3947,29,15,95356,376390.67,140980 
 20100721,a1105,20100721,3961,3947,3966,3976,3950,3956,3962,9,15,115282,456847.41,146764 
 20100722,a1105,20100722,3956,3962,3960,3967,3928,3941,3945,-21,-17,97526,384805.7,147638 
 20100723,a1105,20100723,3941,3945,3943,3978,3939,3959,3965,14,20,136958,543070.76,155262 
 20100726,a1105,20100726,3959,3965,3956,3985,3951,3972,3970,7,5,139252,552896.21,162848 
 20100727,a1105,20100727,3972,3970,3950,3957,3918,3922,3935,-48,-35,97242,382679.17,160484 
 20100728,a1105,20100728,3922,3935,3931,3937,3923,3936,3931,1,-4,71704,281892.62,161470 
 20100729,a1105,20100729,3936,3931,3950,3960,3934,3952,3948,21,17,103792,409857.31,162022 
 20100730,a1105,20100730,3952,3948,3965,3985,3964,3977,3975,29,27,120576,479342.89,167022 
 20100802,a1105,20100802,3977,3975,4006,4065,4000,4047,4044,72,69,212692,860241.45,190772 
 20100803,a1105,20100803,4047,4044,4039,4042,3995,4000,4019,-44,-25,184028,739750.01,191648 
 20100804,a1105,20100804,4000,4019,4018,4055,4007,4022,4030,3,11,286986,1156692.64,214804 
 20100805,a1105,20100805,4022,4030,4052,4054,3965,3973,4000,-57,-30,271196,1085024.38,216622 
 20100806,a1105,20100806,3973,4000,3990,4010,3963,4007,3989,7,-11,267860,1068599.69,223884 
 20100809,a1105,20100809,4007,3989,4015,4095,4001,4069,4055,80,66,634226,2572106.51,276712 
 20100810,a1105,20100810,4069,4055,4054,4054,4018,4027,4035,-28,-20,325578,1313759.45,267672 
 20100811,a1105,20100811,4027,4035,4019,4052,4015,4023,4036,-12,1,327614,1322552.22,254052 
 20100812,a1105,20100812,4023,4036,4021,4075,4002,4037,4049,1,13,657870,2663923.88,292660 
 20100813,a1105,20100813,4037,4049,4051,4106,4051,4103,4080,54,31,607018,2476834.46,331462 
 20100816,a1105,20100816,4103,4080,4115,4164,4105,4145,4142,65,62,757314,3137414.87,389952 
 20100817,a1105,20100817,4145,4142,4120,4137,4102,4135,4117,-7,-25,533466,2196689.43,390032 
 20100818,a1105,20100818,4135,4117,4159,4177,4085,4105,4139,-12,22,709270,2936234.3,368988 
 20100819,a1105,20100819,4105,4139,4110,4116,4071,4090,4093,-49,-46,553422,2265495.35,357956 
 20100820,a1105,20100820,4090,4093,4052,4056,4014,4020,4032,-73,-61,398900,1608425.29,333572 
 20100823,a1105,20100823,4020,4032,4032,4048,4008,4018,4027,-14,-5,378596,1524644.75,322426 
 20100824,a1105,20100824,4018,4027,4012,4032,3994,3997,4016,-30,-11,296472,1190866.98,313998 
 20100825,a1105,20100825,3997,4016,4001,4012,3974,3981,3995,-35,-21,267606,1069304.82,301682 
 20100826,a1105,20100826,3981,3995,3991,4011,3991,4010,4000,15,5,237798,951354.14,296874 
 20100827,a1105,20100827,4010,4000,4027,4037,4014,4026,4025,26,25,238032,958166.11,294502 
 20100830,a1105,20100830,4026,4025,4060,4078,4045,4059,4062,34,37,260856,1059857.37,278740 
 20100831,a1105,20100831,4059,4062,4031,4031,3987,3990,4004,-72,-58,245490,983057.96,267774 
 20100901,a1105,20100901,3990,4004,3999,4018,3981,4002,4001,-2,-3,234628,938922.88,268714 
 20100902,a1105,20100902,4002,4001,4005,4010,3983,3998,3996,-3,-5,295294,1180135.35,270996 
 20100903,a1105,20100903,3998,3996,4002,4037,3998,4033,4021,37,25,335558,1349278.99,262214 
 20100906,a1105,20100906,4033,4021,4069,4087,4053,4071,4072,50,51,298456,1215372.28,273996 
 20100907,a1105,20100907,4071,4072,4077,4092,4055,4092,4079,20,7,398622,1626139.59,279808 
 20100908,a1105,20100908,4092,4079,4112,4119,4063,4077,4091,-2,12,277396,1135073.68,280230 
 20100909,a1105,20100909,4077,4091,4070,4089,3982,4023,4036,-68,-55,326164,1316536.93,252780 
 20100910,a1105,20100910,4023,4036,4031,4042,4016,4034,4027,-2,-9,210198,846510.1,247048 
 20100913,a1105,20100913,4034,4027,4013,4031,4011,4030,4020,3,-7,188712,758632.69,239734 
 20100914,a1105,20100914,4030,4020,4025,4035,4006,4009,4020,-11,0,209300,841490.56,247630 
 20100915,a1105,20100915,4009,4020,4022,4045,4012,4038,4029,18,9,313248,1262352.44,246696 
 20100916,a1105,20100916,4038,4029,4044,4054,4014,4026,4034,-3,5,229816,927239.41,239682 
 20100917,a1105,20100917,4026,4034,4040,4045,4023,4037,4034,3,0,222414,897344.57,230018 
 20100920,a1105,20100920,4037,4034,4100,4190,4091,4146,4158,112,124,722904,3006162.03,282944 
 20100921,a1105,20100921,4146,4158,4130,4137,4081,4110,4111,-48,-47,385860,1586498.39,244682 
 20100927,a1105,20100927,4110,4111,4225,4254,4156,4177,4194,66,83,365840,1534388.33,237800 
 20100928,a1105,20100928,4177,4194,4160,4189,4148,4182,4169,-12,-25,180622,753092.7,222754 
 20100929,a1105,20100929,4182,4169,4149,4154,4088,4120,4123,-49,-46,179928,741949.89,202358 
 20100930,a1105,20100930,4120,4123,4110,4128,4095,4124,4116,1,-7,98480,405377.92,198250 
 20101008,a1105,20101008,4124,4116,4090,4131,4090,4092,4112,-24,-4,107540,442287.16,201478 
 20101011,a1105,20101011,4092,4112,4276,4276,4269,4276,4275,164,163,55002,235183.91,207710 
 20101012,a1105,20101012,4276,4275,4250,4287,4203,4257,4259,-18,-16,358862,1528623.27,217874 
 20101013,a1105,20101013,4257,4259,4286,4295,4250,4279,4273,20,14,258156,1103116.52,220940 
 20101014,a1105,20101014,4279,4273,4290,4299,4271,4280,4284,7,11,219138,938791.75,230496 
 20101015,a1105,20101015,4280,4284,4294,4309,4236,4302,4288,18,4,285458,1224248.43,234946 
 20101018,a1105,20101018,4302,4288,4257,4269,4230,4240,4247,-48,-41,179830,763915.68,228928 
 20101019,a1105,20101019,4240,4247,4258,4279,4240,4256,4262,9,15,160406,683706.12,219532 
 20101020,a1105,20101020,4256,4262,4206,4263,4184,4243,4235,-19,-27,158838,672738.12,214594 
 20101021,a1105,20101021,4243,4235,4288,4341,4278,4290,4312,55,77,281760,1215144.91,210408 
 20101022,a1109,20101022,4412,4429,4400,4456,4396,4430,4432,1,3,192122,851647.11,224818 
 20101025,a1109,20101025,4430,4432,4450,4564,4449,4519,4509,87,77,394104,1777219.25,274556 
 20101026,a1109,20101026,4519,4509,4521,4524,4464,4470,4488,-39,-21,328296,1473397.47,291206 
 20101027,a1109,20101027,4470,4488,4520,4521,4338,4380,4433,-108,-55,313268,1388905.85,286626 
 20101028,a1109,20101028,4380,4433,4415,4437,4388,4425,4416,-8,-17,187200,826772.97,287728 
 20101029,a1109,20101029,4425,4416,4400,4410,4325,4357,4371,-59,-45,203044,887595.59,271858 
 20101101,a1109,20101101,4357,4371,4381,4476,4381,4454,4452,83,81,367680,1637163.67,304702 
 20101102,a1109,20101102,4454,4452,4456,4466,4426,4441,4447,-11,-5,307044,1365526.73,310228 
 20101103,a1109,20101103,4441,4447,4455,4464,4398,4415,4441,-32,-6,300646,1335314.12,303316 
 20101104,a1109,20101104,4415,4441,4451,4508,4436,4505,4478,64,37,437570,1959653.35,312864 
 20101105,a1109,20101105,4505,4478,4577,4657,4558,4657,4627,179,149,627364,2903375.82,333626 
 20101108,a1109,20101108,4657,4627,4620,4722,4600,4656,4656,29,29,811736,3779899.81,331406 
 20101109,a1109,20101109,4656,4656,4633,4720,4620,4690,4671,34,15,607234,2836689.04,340112 
 20101110,a1109,20101110,4690,4671,4748,4835,4702,4748,4778,77,107,1002486,4790646.3,356864 
 20101111,a1109,20101111,4748,4778,4780,4816,4722,4769,4775,-9,-3,848684,4052708.63,365542 
 20101112,a1109,20101112,4769,4775,4778,4779,4584,4584,4637,-191,-138,801982,3719453.52,336810 
 20101115,a1109,20101115,4584,4637,4520,4631,4452,4538,4545,-99,-92,992420,4510757.76,320244 
 20101116,a1109,20101116,4538,4545,4553,4566,4455,4465,4517,-80,-28,805754,3639639.98,324792 
 20101117,a1109,20101117,4465,4517,4337,4357,4337,4337,4340,-180,-177,154270,669590.59,296840 
 20101118,a1109,20101118,4337,4340,4375,4398,4255,4341,4324,1,-16,687140,2971670.25,289258 
 20101119,a1109,20101119,4341,4324,4400,4402,4308,4362,4353,38,29,556640,2423122.36,290730 
 20101122,a1109,20101122,4362,4353,4281,4347,4280,4309,4319,-44,-34,388592,1678444.63,286236 
 20101123,a1109,20101123,4309,4319,4329,4378,4303,4345,4347,26,28,1388754,6037854.95,344508 
 20101124,a1109,20101124,4345,4347,4374,4413,4359,4380,4383,33,36,797182,3494711.67,334600 
 20101125,a1109,20101125,4380,4383,4399,4407,4365,4366,4388,-17,5,480134,2106899.18,305036 
 20101126,a1109,20101126,4366,4388,4380,4383,4288,4318,4330,-70,-58,474646,2055225.09,289954 
 20101129,a1109,20101129,4318,4330,4305,4333,4256,4332,4292,2,-38,336578,1444816.69,262524 
 20101130,a1109,20101130,4332,4292,4315,4325,4266,4304,4296,12,4,214764,922776.93,249054 
 20101201,a1109,20101201,4304,4296,4300,4332,4285,4330,4314,34,18,189216,816384.28,248152 
 20101202,a1109,20101202,4330,4314,4389,4408,4370,4383,4388,69,74,215522,945777.78,254700 
 20101203,a1109,20101203,4383,4388,4380,4428,4367,4407,4401,19,13,228554,1005921.24,257240 
 20101206,a1109,20101206,4407,4401,4430,4440,4402,4414,4424,13,23,176942,782837.95,249094 
 20101207,a1109,20101207,4414,4424,4403,4423,4385,4420,4404,-4,-20,133446,587827.76,244032 
 20101208,a1109,20101208,4420,4404,4360,4389,4335,4336,4368,-68,-36,137824,602024.08,239598 
 20101209,a1109,20101209,4336,4368,4378,4384,4350,4359,4367,-9,-1,126906,554323.18,230796 
 20101210,a1109,20101210,4359,4367,4345,4365,4336,4364,4349,-3,-18,84424,367180.79,226338 
 20101213,a1109,20101213,4364,4349,4339,4415,4333,4399,4391,50,42,195650,859194.11,219626 
 20101214,a1109,20101214,4399,4391,4420,4444,4409,4430,4425,39,34,234224,1036572,215474 
 20101215,a1109,20101215,4430,4425,4425,4459,4397,4399,4430,-26,5,245992,1089828.62,220104 
 20101216,a1109,20101216,4399,4430,4405,4425,4400,4408,4414,-22,-16,134128,592092.14,219748 
 20101217,a1109,20101217,4408,4414,4409,4425,4405,4414,4416,0,2,113218,500054.29,210978 
 20101220,a1109,20101220,4414,4416,4450,4459,4382,4414,4432,-2,16,148638,658869.01,206786 
 20101221,a1109,20101221,4414,4432,4429,4451,4416,4447,4436,15,4,142522,632264.34,223532 
 20101222,a1109,20101222,4447,4436,4460,4463,4412,4414,4435,-22,-1,139922,620623.6,221128 
 20101223,a1109,20101223,4414,4435,4427,4452,4416,4452,4437,17,2,181946,807425.61,204246 
 20101224,a1109,20101224,4452,4437,4470,4550,4465,4536,4521,99,84,401108,1813803.6,230372 
 20101227,a1109,20101227,4536,4521,4511,4560,4510,4554,4542,33,21,318200,1445488.14,229940 
 20101228,a1109,20101228,4554,4542,4590,4625,4572,4581,4600,39,58,302054,1389470.38,236576 
 20101229,a1109,20101229,4581,4600,4575,4588,4506,4519,4538,-81,-62,235104,1066987.89,229750 
 20101230,a1109,20101230,4519,4538,4506,4549,4491,4546,4521,8,-17,164628,744351.79,217914 
 20101231,a1109,20101231,4546,4521,4523,4547,4517,4528,4531,7,10,129558,587073.66,207086 
 20110104,a1109,20110104,4528,4531,4528,4545,4520,4537,4535,6,4,110524,5012343740,206650 
 20110105,a1109,20110105,4537,4535,4498,4500,4471,4477,4485,-58,-50,99710,4472004160,200044 
 20110106,a1201,20110106,4475,4480,4500,4545,4500,4540,4529,60,49,112312,5086758140,237712 
 20110107,a1201,20110107,4540,4529,4500,4510,4423,4439,4475,-90,-54,138008,6175951640,242780 
 20110110,a1201,20110110,4439,4475,4452,4470,4432,4445,4456,-30,-19,85642,3816310840,243922 
 20110111,a1201,20110111,4445,4456,4471,4479,4443,4459,4459,3,3,84768,3780131120,236842 
 20110112,a1201,20110112,4459,4459,4448,4472,4435,4450,4454,-9,-5,125408,5585877320,238136 
 20110113,a1201,20110113,4450,4454,4550,4566,4502,4503,4519,49,65,124344,5620335440,230016 
 20110114,a1201,20110114,4503,4519,4501,4536,4493,4531,4519,12,0,105114,4750631700,231832 
 20110117,a1201,20110117,4531,4519,4530,4555,4518,4546,4538,27,19,155782,7070809380,243754 
 20110118,a1201,20110118,4546,4538,4540,4604,4529,4601,4565,63,27,263230,12018632140,265312 
 20110119,a1201,20110119,4601,4565,4601,4624,4588,4609,4609,44,44,241638,11137223260,284234 
 20110120,a1201,20110120,4609,4609,4590,4597,4558,4565,4575,-44,-34,163760,7492157440,283130 
 20110121,a1201,20110121,4565,4575,4550,4570,4519,4541,4551,-34,-24,111902,5093250540,276698 
 20110124,a1201,20110124,4541,4551,4554,4603,4548,4580,4582,29,31,165042,7563521860,278062 
 20110125,a1201,20110125,4580,4582,4555,4576,4525,4526,4547,-56,-35,98358,4472590700,277200 
 20110126,a1201,20110126,4526,4547,4496,4496,4402,4443,4440,-104,-107,134668,5980605560,272598 
 20110127,a1201,20110127,4443,4440,4474,4475,4438,4453,4454,13,14,70682,3148605080,269286 
 20110128,a1201,20110128,4453,4454,4450,4470,4438,4450,4454,-4,0,63512,2829388660,268180 
 20110131,a1201,20110131,4450,4454,4455,4498,4451,4489,4479,35,25,70966,3179260620,265128 
 20110201,a1201,20110201,4489,4479,4508,4517,4490,4516,4502,37,23,57864,2605421260,265718 
 20110209,a1201,20110209,4516,4502,4531,4598,4516,4591,4574,89,72,147266,6737100800,260242 
 20110210,a1201,20110210,4591,4574,4610,4681,4600,4646,4653,72,79,209642,9756605420,272682 
 20110211,a1201,20110211,4646,4653,4632,4692,4622,4669,4662,16,9,216196,10079294880,270754 
 20110214,a1201,20110214,4669,4662,4671,4706,4656,4682,4681,20,19,151160,7077107180,278920 
 20110215,a1201,20110215,4682,4681,4652,4665,4622,4633,4645,-48,-36,148576,6901796180,287692 
 20110216,a1201,20110216,4633,4645,4581,4615,4572,4614,4595,-31,-50,133734,6145932880,297958 
 20110217,a1201,20110217,4614,4595,4615,4635,4574,4576,4608,-19,13,132204,6092721440,295662 
 20110218,a1201,20110218,4576,4608,4623,4630,4581,4583,4608,-25,0,123416,5687670820,290840 
 20110221,a1201,20110221,4583,4608,4560,4580,4550,4553,4562,-55,-46,94268,4301421060,291002 
 20110222,a1201,20110222,4553,4562,4572,4597,4511,4575,4558,13,-4,129234,5890978240,287872 
 20110223,a1201,20110223,4575,4558,4440,4449,4400,4425,4430,-133,-128,136488,6047457400,287764 
 20110224,a1201,20110224,4425,4430,4445,4447,4361,4368,4404,-62,-26,127166,5601208020,287190 
 20110225,a1201,20110225,4368,4404,4383,4418,4378,4414,4400,10,-4,94384,4153061260,276856 
 20110228,a1201,20110228,4414,4400,4451,4463,4432,4450,4445,50,45,83708,3720880000,271956 
 20110301,a1201,20110301,4450,4445,4445,4464,4432,4453,4446,8,1,61416,2731131760,273276 
 20110302,a1201,20110302,4453,4446,4450,4575,4442,4553,4525,107,79,289912,13120798140,290962 
 20110303,a1201,20110303,4553,4525,4555,4555,4501,4506,4528,-19,3,156890,7104556580,286940 
 20110304,a1201,20110304,4506,4528,4550,4593,4521,4545,4549,17,21,220484,10030976720,285242 
 20110307,a1201,20110307,4545,4549,4531,4543,4508,4536,4529,-13,-20,84960,3848227360,285042 
 20110308,a1201,20110308,4536,4529,4500,4508,4441,4453,4475,-76,-54,117096,5241033500,284766 
 20110309,a1201,20110309,4453,4475,4463,4468,4438,4453,4454,-22,-21,76580,3411195180,279168 
 20110310,a1201,20110310,4453,4454,4425,4435,4402,4408,4419,-46,-35,81412,3598280720,278682 
 20110311,a1201,20110311,4408,4419,4416,4432,4392,4399,4413,-20,-6,68820,3037385640,277548 
 20110314,a1201,20110314,4399,4413,4390,4445,4370,4392,4401,-21,-12,145374,6398041120,278316 
 20110315,a1201,20110315,4392,4401,4403,4467,4384,4456,4435,55,34,250716,11120449440,301918 
 20110316,a1201,20110316,4456,4435,4380,4440,4380,4429,4411,-6,-24,233620,10306803880,305424 
 20110317,a1201,20110317,4429,4411,4429,4477,4408,4466,4448,55,37,201944,8982527840,311918 
 20110318,a1201,20110318,4466,4448,4496,4497,4459,4466,4474,18,26,152268,6812567160,304110 
 20110321,a1201,20110321,4466,4474,4480,4518,4461,4500,4494,26,20,229348,10307701480,309020 
 20110322,a1201,20110322,4500,4494,4494,4527,4485,4508,4512,14,18,192612,8691634480,314016 
 20110323,a1201,20110323,4508,4512,4513,4554,4507,4552,4537,40,25,197034,8941327620,317466 
 20110324,a1201,20110324,4552,4537,4541,4550,4501,4514,4526,-23,-11,151062,6838208640,310266 
 20110325,a1201,20110325,4514,4526,4527,4612,4526,4609,4584,83,58,330448,15149767520,337118 
 20110328,a1201,20110328,4609,4584,4604,4660,4574,4639,4625,55,41,651610,30142136420,380680 
 20110329,a1201,20110329,4639,4625,4619,4659,4603,4651,4633,26,8,560460,25970678080,410378 
 20110330,a1201,20110330,4651,4633,4660,4669,4610,4625,4635,-8,2,402524,18659325480,381244 
 20110331,a1201,20110331,4625,4635,4633,4650,4588,4610,4618,-25,-17,326380,15073594980,370812 
 20110401,a1201,20110401,4610,4618,4650,4659,4620,4635,4640,17,22,294540,13667499180,351632 
 20110406,a1201,20110406,4635,4640,4616,4674,4613,4670,4644,30,4,292128,13568489280,369762 
 20110407,a1201,20110407,4670,4644,4652,4666,4641,4649,4653,5,9,184194,8572087380,361580 
 20110408,a1201,20110408,4649,4653,4636,4656,4606,4654,4631,1,-22,292424,13542166780,359458 
 20110411,a1201,20110411,4654,4631,4684,4744,4674,4679,4705,48,74,542036,25507478560,430008 
 20110412,a1201,20110412,4679,4705,4632,4654,4613,4616,4632,-89,-73,312148,14460681500,393734 
 20110413,a1201,20110413,4616,4632,4575,4605,4575,4600,4590,-32,-42,284598,13065413200,392654 
 20110414,a1201,20110414,4600,4590,4584,4590,4531,4534,4562,-56,-28,264396,12064044520,384272 
 20110415,a1201,20110415,4534,4562,4556,4565,4525,4529,4547,-33,-15,219042,9961855760,359352 
 20110418,a1201,20110418,4529,4547,4520,4568,4505,4562,4548,15,1,262108,11922546120,378234 
 20110419,a1201,20110419,4562,4548,4565,4575,4540,4545,4554,-3,6,213548,9725746400,367640 
 20110420,a1201,20110420,4545,4554,4561,4582,4560,4579,4572,25,18,244278,11170448180,405398 
 20110421,a1201,20110421,4579,4572,4577,4580,4557,4563,4568,-9,-4,178426,8151692840,380266 
 20110422,a1201,20110422,4563,4568,4590,4593,4555,4573,4574,5,6,171572,7848315320,379768 
 20110425,a1201,20110425,4573,4574,4589,4590,4543,4553,4564,-21,-10,146452,6684953120,382010 
 20110426,a1201,20110426,4553,4564,4527,4541,4517,4517,4528,-47,-36,119958,5432593280,371606 
 20110427,a1201,20110427,4517,4528,4528,4543,4507,4516,4525,-12,-3,145702,6594054800,370974 
 20110428,a1201,20110428,4516,4525,4522,4548,4522,4544,4536,19,11,130726,5930005760,374842 
 20110429,a1201,20110429,4544,4536,4505,4508,4451,4458,4475,-78,-61,171006,7652666560,372664 
 20110503,a1201,20110503,4458,4475,4490,4494,4464,4475,4474,0,-1,84900,3799273760,370578 
 20110504,a1201,20110504,4475,4474,4453,4461,4419,4424,4434,-50,-40,135020,5987721400,382388 
 20110505,a1201,20110505,4424,4434,4412,4447,4396,4433,4428,-1,-6,188568,8350198700,395130 
 20110506,a1201,20110506,4433,4428,4390,4395,4350,4357,4370,-71,-58,213106,9313513400,386878 
 20110509,a1201,20110509,4357,4370,4380,4382,4366,4380,4374,10,4,92834,4061322680,383622 
 20110510,a1201,20110510,4380,4374,4378,4405,4375,4403,4391,29,17,132522,5819101520,382192 
 20110511,a1201,20110511,4403,4391,4408,4420,4394,4396,4405,5,14,130770,5760782280,384072 
 20110512,a1201,20110512,4396,4405,4397,4422,4360,4366,4397,-39,-8,211358,9295144980,388658 
 20110513,a1201,20110513,4366,4397,4396,4414,4382,4412,4397,15,0,168030,7389056820,389330 
 20110516,a1201,20110516,4412,4397,4400,4405,4386,4387,4393,-10,-4,107164,4708565220,383436 
 20110517,a1201,20110517,4387,4393,4381,4389,4326,4355,4355,-38,-38,178486,7774563040,393884 
 20110518,a1201,20110518,4355,4355,4380,4388,4364,4371,4376,16,21,124430,5445429420,400234 
 20110519,a1201,20110519,4371,4376,4405,4415,4389,4390,4400,14,24,134956,5938536260,401510 
 20110520,a1201,20110520,4390,4400,4395,4415,4389,4413,4404,13,4,146124,6435922620,401716 
 20110523,a1201,20110523,4413,4404,4425,4448,4407,4413,4427,9,23,168280,7451434260,382504 
 20110524,a1201,20110524,4413,4427,4420,4440,4413,4437,4424,10,-3,120116,5314008280,383772 
 20110525,a1201,20110525,4437,4424,4430,4449,4428,4436,4436,12,12,116152,5153632640,384612 
 20110526,a1201,20110526,4436,4436,4448,4465,4445,4462,4457,26,21,108412,4831993180,379774 
 20110527,a1201,20110527,4462,4457,4470,4473,4441,4454,4456,-3,-1,115210,5134436780,373342 
 20110530,a1201,20110530,4454,4456,4450,4472,4436,4460,4455,4,-1,178260,7942526520,375028 
 20110531,a1201,20110531,4460,4455,4465,4475,4446,4454,4458,-1,3,105376,4698558000,377928 
 20110601,a1201,20110601,4454,4458,4460,4464,4443,4448,4454,-10,-4,75168,3348310820,382446 
 20110602,a1201,20110602,4448,4454,4450,4479,4449,4478,4466,24,12,167340,7473956800,384834 
 20110603,a1201,20110603,4478,4466,4493,4519,4486,4518,4499,52,33,145932,6566231620,377990 
 20110607,a1201,20110607,4518,4499,4489,4489,4466,4475,4477,-24,-22,110540,4949538160,348222 
 20110608,a1201,20110608,4475,4477,4488,4490,4460,4473,4476,-4,-1,92072,4121598700,346642 
 20110609,a1201,20110609,4473,4476,4486,4493,4471,4472,4483,-4,7,90492,4057565980,335136 
 20110610,a1201,20110610,4472,4483,4475,4479,4447,4459,4464,-24,-19,85372,3811419740,325930 
 20110613,a1201,20110613,4459,4464,4451,4468,4448,4463,4459,-1,-5,73118,3260863500,330906 
 20110614,a1201,20110614,4463,4459,4454,4470,4454,4469,4463,10,4,59878,2672849880,326426 
 20110615,a1201,20110615,4469,4463,4469,4469,4446,4458,4458,-5,-5,69470,3097592880,321806 
 20110616,a1201,20110616,4458,4458,4451,4460,4434,4437,4446,-21,-12,70578,3138265660,321362 
 20110617,a1201,20110617,4437,4446,4432,4432,4400,4407,4413,-39,-33,101962,4500365260,312964 
 20110620,a1201,20110620,4407,4413,4400,4406,4390,4394,4397,-19,-16,52748,2319805680,311832 
 20110621,a1201,20110621,4394,4397,4405,4419,4403,4417,4410,20,13,42842,1889446400,308600 
 20110622,a1201,20110622,4417,4410,4420,4430,4412,4418,4419,8,9,51544,2278182080,310652 
 20110623,a1201,20110623,4418,4419,4414,4414,4379,4396,4391,-23,-28,54738,2403966940,307070 
 20110624,a1201,20110624,4396,4391,4388,4423,4376,4416,4407,25,16,78042,3439580800,311360 
 20110627,a1201,20110627,4416,4407,4403,4414,4380,4391,4395,-16,-12,106434,4678621900,320604 
 20110628,a1201,20110628,4391,4395,4410,4430,4404,4414,4416,19,21,107512,4748720460,335036 
 20110629,a1201,20110629,4414,4416,4430,4430,4418,4421,4424,5,8,54054,2391411860,334814 
 20110630,a1201,20110630,4421,4424,4420,4435,4418,4432,4428,8,4,71644,3172840160,331286 
 20110701,a1201,20110701,4432,4428,4398,4409,4392,4404,4402,-24,-26,60458,2661493760,321244 
 20110704,a1201,20110704,4404,4402,4413,4440,4412,4434,4427,32,25,89452,3960447260,307340 
 20110705,a1201,20110705,4434,4427,4437,4452,4427,4440,4439,13,12,85984,3816948100,292034 
 20110706,a1205,20110706,4539,4549,4541,4565,4527,4531,4541,-18,-8,64324,2921470840,227284 
 20110707,a1201,20110707,4423,4430,4419,4433,4419,4428,4427,-2,-3,36552,1618266660,279220 
 20110708,a1201,20110708,4428,4427,4443,4460,4441,4460,4451,33,24,85366,3799864120,266156 
 20110711,a1205,20110711,4588,4579,4589,4602,4584,4596,4594,17,15,55198,2536145560,243102 
 20110712,a1201,20110712,4456,4460,4457,4458,4410,4440,4440,-20,-20,52296,2322154860,247160 
 20110713,a1205,20110713,4577,4577,4603,4644,4600,4638,4623,61,46,94802,4382811760,244294 
 20110714,a1205,20110714,4638,4623,4658,4676,4651,4670,4664,47,41,78032,3639866120,239910 
 20110715,a1205,20110715,4670,4664,4621,4669,4621,4660,4661,-4,-3,65242,3041433700,235152 
 20110718,a1205,20110718,4660,4661,4660,4678,4638,4640,4664,-21,3,83280,3884415520,239280 
 20110719,a1205,20110719,4640,4664,4646,4655,4622,4650,4640,-14,-24,65124,3022354820,233342 
 20110720,a1205,20110720,4650,4640,4651,4660,4633,4652,4648,12,8,88032,4092419520,216838 
 20110721,a1205,20110721,4652,4648,4646,4675,4640,4659,4660,11,12,100770,4695949720,211636 
 20110722,a1205,20110722,4659,4660,4662,4668,4655,4660,4660,0,0,34476,1606858820,211630 
 20110725,a1205,20110725,4660,4660,4638,4646,4607,4611,4626,-49,-34,66186,3062070220,203190 
 20110726,a1205,20110726,4611,4626,4607,4634,4607,4634,4624,8,-2,37976,1756323560,206934 
 20110727,a1205,20110727,4634,4624,4648,4682,4641,4669,4667,45,43,72766,3396213320,212950 
 20110728,a1205,20110728,4669,4667,4647,4658,4642,4646,4650,-21,-17,33548,1560183340,208982 
 20110729,a1205,20110729,4646,4650,4638,4670,4631,4635,4652,-15,2,87904,4089844320,206776 
 20110801,a1205,20110801,4635,4652,4632,4712,4632,4706,4678,54,26,140534,6575300040,240872 
 20110802,a1205,20110802,4706,4678,4701,4725,4683,4703,4703,25,25,241146,11342034560,259328 
 20110803,a1205,20110803,4703,4703,4729,4745,4705,4707,4724,4,21,200582,9477372000,272022 
 20110804,a1205,20110804,4707,4724,4690,4716,4656,4659,4688,-65,-36,279316,13096223960,280034 
 20110805,a1205,20110805,4659,4688,4601,4602,4472,4562,4554,-126,-134,288654,13147148880,222988 
 20110808,a1205,20110808,4562,4554,4480,4575,4480,4532,4541,-22,-13,176198,8001802640,240450 
 20110809,a1205,20110809,4532,4541,4468,4498,4428,4485,4461,-56,-80,236700,10560716960,256344 
 20110810,a1205,20110810,4485,4461,4511,4529,4504,4517,4517,56,56,127178,5744635460,255420 
 20110811,a1205,20110811,4517,4517,4510,4561,4490,4555,4529,38,12,179968,8151921800,267292 
 20110812,a1205,20110812,4555,4529,4597,4598,4556,4558,4575,29,46,136690,6254488800,269000 
 20110815,a1205,20110815,4558,4575,4584,4642,4580,4620,4620,45,45,294026,13586611940,319206 
 20110816,a1205,20110816,4620,4620,4630,4630,4575,4578,4604,-42,-16,197484,9093028080,304878 
 20110817,a1205,20110817,4578,4604,4599,4615,4590,4606,4604,2,0,155702,7169999620,312668 
 20110818,a1205,20110818,4606,4604,4624,4625,4598,4602,4611,-2,7,116696,5381218440,317834 
 20110819,a1205,20110819,4602,4611,4572,4597,4563,4585,4581,-26,-30,155022,7102661360,306516 
 20110822,a1205,20110822,4585,4581,4600,4629,4600,4602,4615,21,34,276608,12766639080,328514 
 20110823,a1205,20110823,4602,4615,4631,4650,4625,4649,4638,34,23,214084,9930517220,344150 
 20110824,a1205,20110824,4649,4638,4646,4653,4631,4636,4638,-2,0,140196,6503457880,332516 
 20110825,a1205,20110825,4636,4638,4632,4632,4611,4623,4620,-15,-18,126946,5865101660,324994 
 20110826,a1205,20110826,4623,4620,4635,4640,4606,4613,4620,-7,0,126976,5866749140,319578 
 20110829,a1205,20110829,4613,4620,4680,4761,4668,4747,4716,127,96,557444,26294301400,442772 
 20110830,a1205,20110830,4747,4716,4748,4770,4719,4732,4746,16,30,625266,29680082240,496698 
 20110831,a1205,20110831,4732,4746,4740,4767,4736,4748,4753,2,7,455168,21636295460,454794 
 20110901,a1205,20110901,4748,4753,4750,4768,4728,4735,4747,-18,-6,331396,15731613640,445016 
 20110902,a1205,20110902,4735,4747,4726,4750,4720,4743,4737,-4,-10,232882,11033343300,431092 
 20110905,a1205,20110905,4743,4737,4742,4828,4720,4726,4772,-11,35,1104936,52729682980,483762 
 20110906,a1205,20110906,4726,4772,4718,4727,4671,4712,4698,-60,-74,538862,25317288820,443596 
 20110907,a1205,20110907,4712,4698,4725,4767,4718,4762,4736,64,38,343058,16248556980,463208 
 20110908,a1205,20110908,4762,4736,4750,4755,4721,4737,4738,1,2,351744,16666886420,474892 
 20110909,a1205,20110909,4737,4738,4733,4770,4729,4769,4750,31,12,465906,22130721560,524796 
 20110913,a1205,20110913,4769,4750,4700,4714,4655,4665,4677,-85,-73,494558,23132015200,471920 
 20110914,a1205,20110914,4665,4677,4676,4687,4615,4620,4647,-57,-30,420442,19540643160,443922 
 20110915,a1205,20110915,4620,4647,4633,4641,4606,4624,4628,-23,-19,246288,11399932320,430004 
 20110916,a1205,20110916,4624,4628,4594,4622,4580,4620,4600,-8,-28,299914,13798907180,441270 
 20110919,a1205,20110919,4620,4600,4600,4603,4539,4542,4569,-58,-31,261558,11951426900,428936 
 20110920,a1205,20110920,4542,4569,4560,4580,4542,4567,4569,-2,0,222402,10162565460,436170 
 20110921,a1205,20110921,4567,4569,4550,4580,4522,4565,4556,-4,-13,265022,12074604700,440348 
 20110922,a1205,20110922,4565,4556,4499,4522,4458,4488,4499,-68,-57,342774,15424005020,425102 
 20110923,a1205,20110923,4488,4499,4431,4465,4277,4340,4376,-159,-123,556602,24359517960,392344 
 20110926,a1205,20110926,4340,4376,4321,4356,4203,4219,4295,-157,-81,417808,17946545720,353990 
 20110927,a1205,20110927,4219,4295,4299,4348,4282,4333,4315,38,20,287028,12385854340,341242 
 20110928,a1205,20110928,4333,4315,4281,4299,4258,4280,4278,-35,-37,220922,9452835380,327402 
 20110929,a1205,20110929,4280,4278,4151,4232,4134,4209,4185,-69,-93,286494,11990980200,316172 
 20110930,a1205,20110930,4209,4185,4248,4285,4230,4279,4262,94,77,163582,6973263700,313510 
 20111010,a1205,20111010,4279,4262,4200,4295,4189,4241,4248,-21,-14,316468,13446618880,345812 
 20111011,a1205,20111011,4241,4248,4253,4293,4235,4244,4268,-4,20,339850,14507512600,360860 
 20111012,a1205,20111012,4244,4268,4317,4341,4285,4330,4317,62,49,409674,17687563040,360480 
 20111013,a1205,20111013,4330,4317,4330,4355,4324,4351,4338,34,21,227232,9859351500,359590 
 20111014,a1205,20111014,4351,4338,4376,4376,4354,4360,4363,22,25,190330,8305395520,341562 
 20111017,a1205,20111017,4360,4363,4375,4376,4331,4333,4348,-30,-15,200620,8724861600,338370 
 20111018,a1205,20111018,4333,4348,4320,4320,4242,4256,4278,-92,-70,171358,7332146980,326082 
 20111019,a1205,20111019,4256,4278,4280,4315,4260,4282,4289,4,11,157462,6754806580,318826 
 20111020,a1205,20111020,4282,4289,4220,4222,4161,4212,4198,-77,-91,302140,12684433980,295674 
 20111021,a1205,20111021,4212,4198,4242,4259,4216,4258,4249,60,51,146764,6236993420,288914 
 20111024,a1205,20111024,4258,4249,4288,4347,4228,4318,4285,69,36,219120,9389406960,286072 
 20111025,a1205,20111025,4318,4285,4318,4345,4299,4323,4323,38,38,166060,7180360280,294100 
 20111026,a1205,20111026,4323,4323,4307,4333,4292,4315,4315,-8,-8,121550,5244938060,280094 
 20111027,a1209,20111027,4419,4411,4408,4477,4401,4471,4454,60,43,198950,8862489380,320652 
 20111028,a1209,20111028,4471,4454,4495,4498,4436,4440,4463,-14,9,145532,6495713860,311728 
 20111031,a1209,20111031,4440,4463,4440,4443,4376,4386,4405,-77,-58,127318,5609007100,314302 
 20111101,a1209,20111101,4386,4405,4400,4433,4395,4403,4414,-2,9,157494,6952896260,317078 
 20111102,a1209,20111102,4403,4414,4395,4480,4372,4463,4413,49,-1,151122,6670261300,326000 
 20111103,a1209,20111103,4463,4413,4420,4447,4400,4409,4421,-4,8,185122,8185559180,333928 
 20111104,a1209,20111104,4409,4421,4481,4481,4430,4437,4445,16,24,144930,6443030080,331344 
 20111107,a1209,20111107,4437,4445,4428,4440,4383,4394,4405,-51,-40,109080,4805283140,331354 
 20111108,a1209,20111108,4394,4405,4388,4402,4358,4383,4379,-22,-26,140372,6147768820,327128 
 20111109,a1209,20111109,4383,4379,4404,4406,4368,4379,4382,0,3,123738,5423159780,317036 
 20111110,a1209,20111110,4379,4382,4329,4329,4271,4298,4298,-84,-84,183148,7872790600,302538 
 20111111,a1209,20111111,4298,4298,4300,4324,4290,4313,4307,15,9,94784,4082970860,297582 
 20111114,a1209,20111114,4313,4307,4338,4367,4326,4363,4346,56,39,124364,5405272020,301302 
 20111115,a1209,20111115,4363,4346,4344,4392,4329,4385,4368,39,22,174736,7633003120,309968 
 20111116,a1209,20111116,4385,4368,4398,4404,4340,4345,4368,-23,0,138432,6047503240,301144 
 20111117,a1209,20111117,4345,4368,4349,4374,4325,4360,4353,-8,-15,95602,4162139460,300658 
 20111118,a1209,20111118,4360,4353,4311,4332,4305,4332,4322,-21,-31,96714,4180132720,302310 
 20111121,a1209,20111121,4332,4322,4326,4365,4320,4346,4344,24,22,131962,5732795520,305322 
 20111122,a1209,20111122,4346,4344,4300,4324,4297,4308,4314,-36,-30,129044,5567582620,313150 
 20111123,a1209,20111123,4308,4314,4321,4322,4253,4259,4277,-55,-37,214704,9183324900,325824 
 20111124,a1209,20111124,4259,4277,4220,4270,4207,4245,4238,-32,-39,190812,8088159340,318886 
 20111125,a1209,20111125,4245,4238,4222,4257,4201,4209,4226,-29,-12,157882,6673418140,326136 
 20111128,a1209,20111128,4209,4226,4232,4249,4217,4227,4230,1,4,124098,5250570080,327990 
 20111129,a1209,20111129,4227,4230,4229,4251,4222,4247,4235,17,5,109030,4617559860,317966 
 20111130,a1209,20111130,4247,4235,4248,4250,4204,4210,4225,-25,-10,88578,3743202000,321948 
 20111201,a1209,20111201,4210,4225,4285,4298,4263,4284,4280,59,55,132690,5679170520,298658 
 20111202,a1209,20111202,4284,4280,4268,4279,4261,4272,4270,-8,-10,64070,2736268100,297228 
 20111205,a1209,20111205,4272,4270,4281,4289,4275,4285,4282,15,12,55734,2386648640,303542 
 20111206,a1209,20111206,4285,4282,4265,4271,4258,4269,4266,-13,-16,34494,1471564440,304498 
 20111207,a1209,20111207,4269,4266,4281,4285,4270,4278,4276,12,10,33566,1435585600,303782 
 20111208,a1209,20111208,4278,4276,4272,4273,4239,4250,4252,-26,-24,66124,2811698980,307344 
 20111209,a1209,20111209,4250,4252,4241,4263,4236,4253,4253,1,1,51288,2181536300,306528 
 20111212,a1209,20111212,4253,4253,4230,4247,4225,4227,4234,-26,-19,66172,2801998580,314780 
 20111213,a1209,20111213,4227,4234,4229,4259,4229,4249,4248,15,14,107292,4558573380,315164 
 20111214,a1209,20111214,4249,4248,4253,4269,4245,4259,4253,11,5,64994,2764291160,306128 
 20111215,a1209,20111215,4259,4253,4230,4307,4230,4298,4278,45,25,236210,10106070260,310070 
 20111216,a1209,20111216,4298,4278,4302,4320,4293,4319,4305,41,27,137498,5920051080,303470 
 20111219,a1209,20111219,4319,4305,4323,4347,4314,4331,4332,26,27,175102,7586059820,304398 
 20111220,a1209,20111220,4331,4332,4339,4339,4312,4319,4324,-13,-8,104414,4515709060,307198 
 20111221,a1209,20111221,4319,4324,4330,4336,4301,4303,4317,-21,-7,94936,4099323940,309408 
 20111222,a1209,20111222,4303,4317,4316,4319,4297,4311,4309,-6,-8,88326,3806461700,308604 
 20111223,a1209,20111223,4311,4309,4329,4329,4312,4315,4319,6,10,82262,3552899360,298246 
 20111226,a1209,20111226,4315,4319,4320,4347,4310,4319,4332,0,13,171720,7439388260,296730 
 20111227,a1209,20111227,4319,4332,4319,4329,4298,4301,4313,-31,-19,78932,3405077820,293464 
 20111228,a1209,20111228,4301,4313,4340,4343,4326,4337,4334,24,21,117180,5079376620,288828 
 20111229,a1209,20111229,4337,4334,4320,4357,4319,4337,4344,3,10,154342,6704938160,286672 
 20111230,a1209,20111230,4337,4344,4337,4349,4330,4340,4339,-4,-5,73914,3207155540,279024 
 20120104,a1209,20120104,4340,4339,4366,4378,4351,4360,4362,21,23,81194,3541777920,258880 
 20120105,a1209,20120105,4360,4362,4363,4385,4352,4362,4367,0,5,102942,4495907160,256006 
 20120106,a1209,20120106,4362,4367,4340,4351,4336,4350,4345,-17,-22,44164,1918959020,254186 
 20120109,a1209,20120109,4350,4345,4343,4356,4341,4352,4348,7,3,57390,2495441720,249660 
 20120110,a1209,20120110,4352,4348,4378,4382,4366,4372,4374,24,26,79246,3466703260,243702 
 20120111,a1209,20120111,4372,4374,4374,4378,4361,4370,4369,-4,-5,42354,1850669060,244410 
 20120112,a1209,20120112,4370,4369,4351,4359,4345,4355,4352,-14,-17,40536,1764140580,238346 
 20120113,a1209,20120113,4355,4352,4343,4344,4312,4318,4327,-34,-25,48252,2087864240,237046 
 20120116,a1209,20120116,4318,4327,4299,4299,4253,4259,4268,-68,-59,70846,3024116140,234346 
 20120117,a1209,20120117,4259,4268,4270,4290,4258,4284,4273,16,5,84468,3610002500,235982 
 20120118,a1209,20120118,4284,4273,4282,4298,4270,4271,4283,-2,10,48448,2075375740,229352 
 20120119,a1209,20120119,4271,4283,4288,4299,4281,4289,4287,6,4,43876,1881085420,217314 
 20120120,a1209,20120120,4289,4287,4300,4329,4299,4327,4313,40,26,33152,1429854360,209336 
 20120130,a1209,20120130,4327,4313,4330,4337,4311,4312,4326,-1,13,47938,2074103020,210466 
 20120131,a1209,20120131,4312,4326,4299,4322,4294,4321,4306,-5,-20,42810,1843700300,211870 
 20120201,a1209,20120201,4321,4306,4329,4395,4326,4384,4376,78,70,259330,11349024460,251946 
 20120202,a1209,20120202,4384,4376,4390,4420,4386,4408,4405,32,29,181984,8016931520,258334 
 20120203,a1209,20120203,4408,4405,4416,4425,4376,4385,4397,-20,-8,129918,5712921040,247182 
 20120206,a1209,20120206,4385,4397,4410,4428,4401,4424,4418,27,21,121954,5388019680,246930 
 20120207,a1209,20120207,4424,4418,4420,4446,4397,4406,4420,-12,2,142950,6318476840,245418 
 20120208,a1209,20120208,4406,4420,4416,4433,4398,4433,4416,13,-4,107480,4747217360,248976 
 20120209,a1209,20120209,4433,4416,4420,4441,4410,4419,4425,3,9,130128,5758249180,249200 
 20120210,a1209,20120210,4419,4425,4415,4415,4381,4390,4395,-35,-30,80376,3532961360,245240 
 20120213,a1209,20120213,4390,4395,4409,4426,4402,4420,4416,25,21,92896,4102694660,255088 
 20120214,a1209,20120214,4420,4416,4435,4448,4416,4419,4433,3,17,123198,5461550080,258298 
 20120215,a1209,20120215,4419,4433,4428,4433,4409,4414,4418,-19,-15,74700,3300297580,256444 
 20120216,a1209,20120216,4414,4418,4418,4425,4386,4395,4399,-23,-19,108144,4758187560,247314 
 20120217,a1209,20120217,4395,4399,4405,4426,4398,4420,4417,21,18,123994,5476838580,265524 
 20120220,a1209,20120220,4420,4417,4441,4443,4424,4427,4431,10,14,112024,4964260020,246090 
 20120221,a1209,20120221,4427,4431,4432,4462,4419,4452,4446,21,15,229808,10219316520,283982 
 20120222,a1209,20120222,4452,4446,4450,4451,4431,4433,4441,-13,-5,137908,6125500060,286898 
 20120223,a1209,20120223,4433,4441,4418,4438,4415,4434,4424,-7,-17,100984,4467743920,277950 
 20120224,a1209,20120224,4434,4424,4432,4442,4430,4438,4436,14,12,82472,3658792680,262024 
 20120227,a1209,20120227,4438,4436,4443,4461,4440,4448,4452,12,16,100846,4489920680,244116 
 20120228,a1209,20120228,4448,4452,4464,4475,4458,4475,4466,23,14,99062,4424931960,233616 
 20120229,a1209,20120229,4475,4466,4480,4480,4460,4463,4465,-3,-1,71394,3188334660,226104 
 20120301,a1209,20120301,4463,4465,4450,4480,4435,4437,4457,-28,-8,137132,6112257940,210628 
 20120302,a1209,20120302,4437,4457,4450,4468,4449,4463,4458,6,1,86474,3855364680,207900 
 20120305,a1209,20120305,4463,4458,4478,4485,4453,4463,4469,5,11,139034,6213803840,209436 
 20120306,a1209,20120306,4463,4469,4453,4459,4444,4447,4451,-22,-18,68276,3039129280,205808 
 20120307,a1209,20120307,4447,4451,4448,4462,4427,4436,4445,-15,-6,93986,4178278280,209954 
 20120308,a1209,20120308,4436,4445,4438,4457,4435,4446,4446,1,1,92716,4122671200,200518 
 20120309,a1209,20120309,4446,4446,4456,4514,4456,4505,4489,59,43,197774,8879959820,232370 
 20120312,a1209,20120312,4505,4489,4484,4498,4469,4482,4480,-7,-9,99280,4448066560,234504 
 20120313,a1209,20120313,4482,4480,4480,4507,4473,4502,4494,22,14,101600,4566875360,238792 
 20120314,a1209,20120314,4502,4494,4520,4544,4487,4502,4518,8,24,165488,7478035640,234278 
 20120315,a1209,20120315,4502,4518,4512,4522,4474,4509,4506,-9,-12,136272,6140591620,221890 
 20120316,a1209,20120316,4509,4506,4525,4527,4492,4503,4513,-3,7,92752,4185931660,220532 
 20120319,a1209,20120319,4503,4513,4520,4536,4514,4525,4524,12,11,124740,5644406880,218458 
 20120320,a1209,20120320,4525,4524,4517,4522,4466,4468,4490,-56,-34,107036,4806191000,198342 
 20120321,a1209,20120321,4468,4490,4460,4481,4452,4480,4468,-10,-22,58784,2626894640,187506 
 20120322,a1209,20120322,4480,4468,4485,4497,4476,4483,4486,15,18,51274,2300573080,182820 
 20120323,a1209,20120323,4483,4486,4488,4517,4488,4515,4503,29,17,80606,3629899380,179168 
 20120326,a1209,20120326,4515,4503,4527,4572,4522,4561,4551,58,48,181702,8270889520,196752 
 20120327,a1209,20120327,4561,4551,4561,4567,4547,4562,4558,11,7,77814,3546782080,185808 
 20120328,a1209,20120328,4562,4558,4547,4571,4539,4546,4555,-12,-3,99102,4514876280,173878 
 20120329,a1209,20120329,4546,4555,4546,4577,4531,4537,4551,-18,-4,166880,7595460620,169312 
 20120330,a1209,20120330,4537,4551,4527,4530,4503,4509,4513,-42,-38,55196,2491374880,159670 
 20120405,a1209,20120405,4509,4513,4531,4618,4531,4608,4591,95,78,117926,5414502120,148310 
 20120406,a1301,20120406,4654,4627,4654,4745,4654,4723,4720,96,93,337402,15927331020,245086 
 20120409,a1301,20120409,4723,4720,4747,4747,4711,4733,4731,13,11,148104,7007667680,234758 
 20120410,a1301,20120410,4733,4731,4725,4774,4724,4764,4752,33,21,291184,13838092840,254610 
 20120411,a1301,20120411,4764,4752,4720,4720,4562,4673,4690,-79,-62,175442,8229469080,236344 
 20120412,a1301,20120412,4673,4690,4677,4690,4661,4680,4676,-10,-14,118748,5553523100,234446 
 20120413,a1301,20120413,4680,4676,4720,4727,4681,4682,4700,6,24,145894,6858055300,223988 
 20120416,a1301,20120416,4682,4700,4632,4672,4632,4663,4653,-37,-47,148072,6890686840,234124 
 20120417,a1301,20120417,4663,4653,4661,4672,4651,4660,4663,7,10,99958,4661117400,237552 
 20120418,a1301,20120418,4660,4663,4677,4678,4617,4635,4644,-28,-19,150798,7004282680,237826 
 20120419,a1301,20120419,4635,4644,4629,4648,4622,4640,4636,-4,-8,95454,4425631920,238604 
 20120420,a1301,20120420,4640,4636,4640,4647,4624,4638,4636,2,0,92630,4295248680,241194 
 20120423,a1301,20120423,4638,4636,4697,4697,4658,4662,4675,26,39,109094,5100277540,251142 
 20120424,a1301,20120424,4662,4675,4648,4669,4637,4641,4652,-34,-23,108690,5056313580,251908 
 20120425,a1301,20120425,4641,4652,4682,4705,4658,4659,4679,7,27,209810,9817743160,260080 
 20120426,a1301,20120426,4659,4679,4658,4658,4637,4642,4646,-37,-33,98618,4582214500,262708 
 20120427,a1301,20120427,4642,4646,4655,4666,4642,4654,4654,8,8,116830,5438156500,261086 
 20120502,a1301,20120502,4654,4654,4670,4673,4632,4632,4646,-22,-8,108550,5043746820,269932 
 20120503,a1301,20120503,4632,4646,4633,4633,4598,4601,4615,-45,-31,170226,7856190040,279584 
 20120504,a1301,20120504,4601,4615,4604,4620,4586,4619,4600,4,-15,120818,5557788400,275336 
 20120507,a1301,20120507,4619,4600,4610,4610,4553,4566,4571,-34,-29,134862,6165221480,275842 
 20120508,a1301,20120508,4566,4571,4566,4582,4559,4562,4572,-9,1,83698,3827099480,275244 
 20120509,a1301,20120509,4562,4572,4530,4545,4504,4513,4519,-59,-53,152706,6901123580,271096 
 20120510,a1301,20120510,4513,4519,4522,4546,4507,4539,4524,20,5,105674,4781410060,271896 
 20120511,a1301,20120511,4539,4524,4545,4550,4466,4476,4502,-48,-22,199736,8993319600,285602 
 20120514,a1301,20120514,4476,4502,4450,4457,4355,4382,4397,-120,-105,281926,12396779980,260922 
 20120515,a1301,20120515,4382,4397,4360,4388,4342,4379,4366,-18,-31,163838,7153936020,245474 
 20120516,a1301,20120516,4379,4366,4338,4393,4293,4297,4342,-69,-24,165566,7189143600,253918 
 20120517,a1301,20120517,4297,4342,4339,4350,4308,4334,4329,-8,-13,196198,8494709620,261662 
 20120518,a1301,20120518,4334,4329,4314,4333,4281,4307,4310,-22,-19,227676,9813375720,272658 
 20120521,a1301,20120521,4307,4310,4316,4361,4316,4347,4339,37,29,172028,7464777500,256232 
 20120522,a1301,20120522,4347,4339,4340,4345,4324,4332,4334,-7,-5,85190,3692539220,257338 
 20120523,a1301,20120523,4332,4334,4290,4290,4259,4274,4272,-60,-62,117508,5020823800,252260 
 20120524,a1301,20120524,4274,4272,4285,4310,4282,4310,4297,38,25,108264,4652474420,246978 
 20120525,a1301,20120525,4310,4297,4309,4311,4284,4302,4297,5,0,67906,2918134660,244950 
 20120528,a1301,20120528,4302,4297,4313,4333,4304,4328,4320,31,23,97300,4203761940,245628 
 20120529,a1301,20120529,4328,4320,4319,4343,4310,4340,4326,20,6,96180,4161245480,238748 
 20120530,a1301,20120530,4340,4326,4330,4357,4324,4331,4341,5,15,133856,5811326500,246792 
 20120531,a1301,20120531,4331,4341,4316,4340,4307,4317,4327,-24,-14,94382,4084492080,254414 
 20120601,a1301,20120601,4317,4327,4296,4308,4279,4297,4296,-30,-31,124236,5337678900,268480 
 20120604,a1301,20120604,4297,4296,4297,4305,4259,4280,4280,-16,-16,161154,6897543140,262998 
 20120605,a1301,20120605,4280,4280,4299,4349,4288,4325,4321,45,41,163460,7063361760,267980 
 20120606,a1301,20120606,4325,4321,4329,4379,4323,4341,4352,20,31,164962,7180155120,261024 
 20120607,a1301,20120607,4341,4352,4369,4384,4334,4347,4365,-5,13,153852,6717129740,237796 
 20120608,a1301,20120608,4347,4365,4383,4384,4321,4344,4352,-21,-13,142036,6182336740,236280 
 20120611,a1301,20120611,4344,4352,4360,4413,4360,4411,4390,59,38,179782,7893524160,231896 
 20120612,a1301,20120612,4411,4390,4380,4432,4379,4425,4410,35,20,315956,13933798920,265230 
 20120613,a1301,20120613,4425,4410,4417,4423,4392,4393,4402,-17,-8,173352,7632623600,258358 
 20120614,a1301,20120614,4393,4402,4371,4374,4339,4340,4354,-62,-48,141986,6182548560,264344 
 20120615,a1301,20120615,4340,4354,4346,4370,4341,4368,4360,14,6,119956,5230197040,246902 
 20120618,a1301,20120618,4368,4360,4388,4395,4364,4378,4376,18,16,114712,5020452180,246202 
 20120619,a1301,20120619,4378,4376,4420,4456,4405,4444,4438,68,62,188746,8376560260,231888 
 20120620,a1301,20120620,4444,4438,4478,4488,4461,4475,4471,37,33,129760,5802619520,233380 
 20120621,a1301,20120621,4475,4471,4451,4469,4424,4461,4451,-10,-20,163128,7261910480,206244 
 20120625,a1301,20120625,4461,4451,4506,4560,4502,4511,4534,60,83,235314,10670800860,219036 
 20120626,a1301,20120626,4511,4534,4523,4534,4499,4515,4516,-19,-18,166830,7534238160,212594 
 20120627,a1301,20120627,4515,4516,4510,4529,4497,4505,4510,-11,-6,111226,5017069120,209352 
 20120628,a1301,20120628,4505,4510,4460,4515,4460,4469,4484,-41,-26,130214,5838814280,202888 
 20120629,a1301,20120629,4469,4484,4478,4495,4448,4495,4474,11,-10,106786,4778427700,202590 
 20120702,a1301,20120702,4495,4474,4550,4551,4487,4502,4509,28,35,116592,5257889140,206770 
 20120703,a1301,20120703,4502,4509,4506,4535,4498,4532,4515,23,6,122064,5511863200,207888 
 20120704,a1305,20120704,4642,4615,4615,4717,4615,4710,4682,95,67,198752,9306529260,206042 
 20120705,a1305,20120705,4710,4682,4700,4744,4700,4729,4725,47,43,177168,8371470400,196624 
 20120706,a1305,20120706,4729,4725,4730,4745,4536,4677,4692,-48,-33,196248,9208570780,166294 
 20120709,a1301,20120709,4561,4582,4572,4765,4572,4765,4720,183,138,806586,38070950180,368616 
 20120710,a1301,20120710,4765,4720,4736,4749,4666,4679,4696,-41,-24,936882,44004413220,292116 
 20120711,a1301,20120711,4679,4696,4696,4805,4644,4660,4722,-36,26,1258492,59434426440,303104 
 20120712,a1301,20120712,4660,4722,4638,4660,4597,4604,4626,-118,-96,481206,22262865460,296440 
 20120713,a1301,20120713,4604,4626,4644,4698,4626,4695,4669,69,43,699822,32675523000,350862 
 20120716,a1301,20120716,4695,4669,4766,4850,4766,4839,4818,170,149,1012182,48774917460,414044 
 20120717,a1301,20120717,4839,4818,4850,4858,4650,4745,4757,-73,-61,936734,44561109280,384398 
 20120718,a1301,20120718,4745,4757,4760,4786,4709,4726,4742,-31,-15,640844,30393398540,391166 
 20120719,a1301,20120719,4726,4742,4797,4797,4738,4772,4769,30,27,705478,33647854780,405152 
 20120720,a1301,20120720,4772,4769,4772,4837,4747,4815,4803,46,34,759378,36477617240,393522 
 20120723,a1301,20120723,4815,4803,4750,4904,4730,4835,4825,32,22,1939770,93598106560,498266 
 20120724,a1301,20120724,4835,4825,4632,4692,4632,4642,4660,-183,-165,855248,39854808680,342596 
 20120725,a1301,20120725,4642,4660,4598,4666,4577,4608,4635,-52,-25,567560,26311192640,271644 
 20120726,a1301,20120726,4608,4635,4633,4652,4600,4612,4622,-23,-13,366386,16934578600,247262 
 20120727,a1301,20120727,4612,4622,4602,4645,4566,4643,4607,21,-15,632032,29119716140,234078 
 20120730,a1301,20120730,4643,4607,4730,4785,4693,4775,4752,168,145,659326,31332878180,258332 
 20120731,a1301,20120731,4775,4752,4735,4775,4715,4769,4751,17,-1,415866,19758272200,251010 
 20120801,a1301,20120801,4769,4751,4780,4800,4730,4731,4771,-20,20,419650,20023143700,250510 
 20120802,a1301,20120802,4731,4771,4713,4752,4713,4744,4734,-27,-37,339726,16085730020,241486 
 20120803,a1301,20120803,4744,4734,4730,4840,4723,4756,4784,22,50,1442274,69007826780,268532 
 20120806,a1301,20120806,4756,4784,4728,4747,4694,4736,4725,-48,-59,553558,26159466160,240872 
 20120807,a1301,20120807,4736,4725,4742,4759,4717,4756,4736,31,11,448128,21224927160,233194 
 20120808,a1301,20120808,4756,4736,4725,4730,4667,4671,4699,-65,-37,468632,22024759980,235758 
 20120809,a1301,20120809,4671,4699,4700,4724,4694,4714,4710,15,11,309010,14557275860,230670 
 20120810,a1301,20120810,4714,4710,4770,4775,4735,4743,4750,33,40,310708,14760780140,225936 
 20120813,a1301,20120813,4743,4750,4733,4738,4707,4709,4725,-41,-25,180618,8535765000,222904 
 20120814,a1301,20120814,4709,4725,4685,4707,4651,4705,4681,-20,-44,234156,10961659280,214846 
 20120815,a1301,20120815,4705,4681,4698,4768,4686,4750,4734,69,53,451494,21376538800,231404 
 20120816,a1301,20120816,4750,4734,4753,4772,4720,4725,4738,-9,4,258840,12265772740,233416 
 20120817,a1301,20120817,4725,4738,4738,4742,4717,4731,4730,-7,-8,142364,6734134720,229236 
 20120820,a1301,20120820,4731,4730,4742,4779,4735,4759,4762,29,32,208808,9945127540,227342 
 20120821,a1301,20120821,4759,4762,4800,4848,4789,4846,4828,84,66,313954,15159596260,221966 
 20120822,a1301,20120822,4846,4828,4876,4896,4863,4870,4877,42,49,255640,12467749480,218398 
 20120823,a1301,20120823,4870,4877,4900,4945,4853,4873,4896,-4,19,493324,24157975980,217328 
 20120824,a1301,20120824,4873,4896,4860,4919,4852,4918,4891,22,-5,205390,10046538440,219932 
 20120827,a1301,20120827,4918,4891,4969,4999,4937,4954,4965,63,74,248368,12331537480,218680 
 20120828,a1301,20120828,4954,4965,4905,4927,4882,4885,4905,-80,-60,217338,10662349840,205166 
 20120829,a1301,20120829,4885,4905,4898,4923,4861,4920,4897,15,-8,213226,10442494840,201450 
 20120830,a1301,20120830,4920,4897,4936,4955,4907,4942,4930,45,33,182214,8983826740,211318 
 20120831,a1301,20120831,4942,4930,4930,4930,4905,4911,4914,-19,-16,122482,6019854540,199672 
 20120903,a1301,20120903,4911,4914,4909,5008,4909,4975,4966,61,52,243244,12081889420,192222 
 20120904,a1305,20120904,4997,4975,5000,5065,4985,5046,5035,71,60,355686,17912328580,265830 
 20120905,a1305,20120905,5046,5035,5001,5040,5001,5018,5023,-17,-12,207524,10425861000,277102 
 20120906,a1305,20120906,5018,5023,4950,4965,4895,4921,4931,-102,-92,259688,12807323700,268758 
 20120907,a1305,20120907,4921,4931,4929,4954,4898,4899,4927,-32,-4,170690,8411414540,267408 
 20120910,a1305,20120910,4899,4927,4885,4962,4885,4943,4932,16,5,236914,11685169820,285862 
 20120911,a1305,20120911,4943,4932,4918,4952,4871,4886,4906,-46,-26,270350,13265287620,270708 
 20120912,a1305,20120912,4886,4906,4885,4920,4876,4910,4899,4,-7,182528,8942342960,266426 
 20120913,a1305,20120913,4910,4899,4958,4959,4919,4922,4941,23,42,169840,8392518740,257578 
 20120914,a1305,20120914,4922,4941,4958,4997,4933,4954,4969,13,28,184336,9159870360,250982 
 20120917,a1305,20120917,4954,4969,4912,4934,4863,4868,4904,-101,-65,284544,13954227180,256526 
 20120918,a1305,20120918,4868,4904,4806,4853,4795,4809,4826,-95,-78,306950,14816457800,239634 
 20120919,a1305,20120919,4809,4826,4837,4856,4830,4848,4842,22,16,152056,7363977740,247162 
 20120920,a1305,20120920,4848,4842,4850,4864,4821,4840,4845,-2,3,169136,8196100900,242112 
 20120921,a1305,20120921,4840,4845,4807,4885,4807,4880,4859,35,14,407950,19823817180,267288 
 20120924,a1305,20120924,4880,4859,4848,4883,4801,4868,4844,9,-15,562558,27252397900,290678 
 20120925,a1305,20120925,4868,4844,4888,4954,4865,4948,4927,104,83,471788,23249295740,314948 
 20120926,a1305,20120926,4948,4927,4931,4973,4887,4898,4930,-29,3,493912,24354033420,297132 
 20120927,a1305,20120927,4898,4930,4882,4908,4852,4877,4880,-53,-50,390664,19066965380,263296 
 20120928,a1305,20120928,4877,4880,4893,4918,4847,4884,4879,4,-1,242754,11846334680,240388 
 20121008,a1305,20121008,4884,4879,4853,4879,4738,4739,4789,-140,-90,397936,19058393480,254472 
 20121009,a1305,20121009,4739,4789,4760,4779,4727,4765,4757,-24,-32,480194,22843668720,284756 
 20121010,a1305,20121010,4765,4757,4732,4760,4694,4748,4723,-9,-34,420672,19868679020,304196 
 20121011,a1305,20121011,4748,4723,4715,4795,4715,4767,4769,44,46,413068,19701548380,307030 
 20121012,a1305,20121012,4767,4769,4785,4819,4729,4735,4773,-34,4,479582,22891520140,313060 
 20121015,a1305,20121015,4735,4773,4700,4751,4690,4735,4724,-38,-49,377424,17833140100,313330 
 20121016,a1305,20121016,4735,4724,4748,4768,4726,4730,4744,6,20,261884,12424554920,298680 
 20121017,a1305,20121017,4730,4744,4710,4744,4706,4734,4725,-10,-19,267268,12630983200,280932 
 20121018,a1305,20121018,4734,4725,4749,4788,4740,4770,4763,45,38,209336,9971629780,282998 
 20121019,a1305,20121019,4770,4763,4790,4794,4761,4771,4770,8,7,149598,7136078700,269114 
 20121022,a1305,20121022,4771,4770,4772,4819,4762,4813,4788,43,18,211454,10124840400,274844 
 20121023,a1305,20121023,4813,4788,4810,4814,4765,4767,4787,-21,-1,196532,9408336400,263146 
 20121024,a1305,20121024,4767,4787,4786,4867,4781,4859,4837,72,50,531772,25725888440,311776 
 20121025,a1305,20121025,4859,4837,4859,4872,4834,4852,4852,15,15,349082,16937704320,305874 
 20121026,a1305,20121026,4852,4852,4850,4881,4833,4869,4858,17,6,523310,25423211440,314926 
 20121029,a1305,20121029,4869,4858,4851,4873,4808,4815,4832,-43,-26,437080,21123722700,300306 
 20121030,a1305,20121030,4815,4832,4801,4812,4778,4804,4793,-28,-39,334166,16017754340,296366 
 20121031,a1305,20121031,4804,4793,4801,4839,4789,4838,4812,45,19,312092,15020118040,295100 
 20121101,a1305,20121101,4838,4812,4838,4962,4836,4940,4918,128,106,996072,48990224500,397592 
 20121102,a1305,20121102,4940,4918,4921,4964,4902,4945,4934,27,16,1185640,58504923860,486930 
 20121105,a1305,20121105,4945,4934,4894,4959,4860,4889,4906,-45,-28,1487456,72980570480,468350 
 20121106,a1305,20121106,4889,4906,4906,4933,4898,4909,4916,3,10,868606,42704207220,483400 
 20121107,a1305,20121107,4909,4916,4916,4919,4855,4866,4880,-50,-36,967670,47224796680,411644 
 20121108,a1305,20121108,4866,4880,4850,4877,4840,4860,4862,-20,-18,441834,21482138660,399574 
 20121109,a1305,20121109,4860,4862,4850,4874,4776,4780,4816,-82,-46,886392,42695450740,396614 
 20121112,a1305,20121112,4780,4816,4720,4734,4634,4733,4698,-83,-118,2197402,1.03238E+11,550212 
 20121113,a1305,20121113,4733,4698,4719,4761,4715,4757,4734,59,36,1170320,55414191840,576164 
 20121114,a1305,20121114,4757,4734,4765,4784,4744,4760,4759,26,25,892732,42490272020,533442 
 20121115,a1305,20121115,4760,4759,4759,4759,4714,4717,4739,-42,-20,817196,38727899220,531486 
 20121116,a1305,20121116,4717,4739,4711,4754,4711,4748,4738,9,-1,713092,33786851300,518526 
 20121119,a1305,20121119,4748,4738,4760,4777,4729,4747,4750,9,12,608070,28887099320,485336 
 20121120,a1305,20121120,4747,4750,4750,4755,4722,4741,4737,-9,-13,567730,26896501720,480288 
 20121121,a1305,20121121,4741,4737,4759,4772,4744,4759,4757,22,20,463778,22065272960,461658 
 20121122,a1305,20121122,4759,4757,4760,4762,4736,4753,4746,-4,-11,406558,19295785340,435694 
 20121123,a1305,20121123,4753,4746,4749,4787,4744,4773,4766,27,20,405486,19327309560,412388 
 20121126,a1305,20121126,4773,4766,4780,4782,4756,4762,4766,-4,0,230432,10982410580,410718 
 20121127,a1305,20121127,4762,4766,4768,4773,4740,4741,4757,-25,-9,315810,15025923140,411532 
 20121128,a1305,20121128,4741,4757,4760,4770,4736,4746,4753,-11,-4,305474,14521148580,407698 
 20121129,a1305,20121129,4746,4753,4752,4770,4733,4769,4755,16,2,367958,17499275140,390870 
 20121130,a1305,20121130,4769,4755,4762,4773,4752,4767,4763,12,8,264316,12589992160,376878 
 20121203,a1305,20121203,4767,4763,4773,4800,4768,4778,4784,15,21,346412,16572433280,355534 
 20121204,a1305,20121204,4778,4784,4762,4775,4731,4753,4745,-31,-39,472250,22412642720,376484 
 20121205,a1305,20121205,4753,4745,4763,4770,4748,4765,4759,20,14,268146,12762885600,359524 
 20121206,a1305,20121206,4765,4759,4786,4789,4759,4765,4775,6,16,264684,12640338260,326732 
 20121207,a1305,20121207,4765,4775,4750,4784,4742,4782,4768,7,-7,314372,14991449720,310106 
 20121210,a1305,20121210,4782,4768,4757,4775,4752,4768,4765,0,-3,184854,8809860000,301270 
 20121211,a1305,20121211,4768,4765,4770,4789,4761,4761,4774,-4,9,182308,8703846080,292652 
 20121212,a1305,20121212,4761,4774,4754,4767,4743,4749,4751,-25,-23,192796,9161113400,298810 
 20121213,a1305,20121213,4749,4751,4753,4776,4752,4763,4764,12,13,146486,6979556100,289256 
 20121214,a1305,20121214,4763,4764,4766,4781,4760,4776,4772,12,8,159140,7595365900,273688 
 20121217,a1305,20121217,4776,4772,4795,4852,4790,4846,4826,74,54,342392,16525302240,276990 
 20121218,a1305,20121218,4846,4826,4837,4873,4821,4822,4845,-4,19,299004,14487481700,280234 
 20121219,a1305,20121219,4822,4845,4802,4817,4776,4791,4795,-54,-50,240974,11555595060,267974 
 20121220,a1305,20121220,4791,4795,4768,4768,4734,4752,4749,-43,-46,186832,8872895560,247302 
 20121221,a1305,20121221,4752,4749,4743,4776,4743,4766,4762,17,13,167848,7993537460,249004 
 20121224,a1305,20121224,4766,4762,4775,4782,4753,4753,4770,-9,8,94850,4525026020,253974 
 20121225,a1305,20121225,4753,4770,4762,4770,4746,4755,4757,-15,-13,111116,5286373540,254110 
 20121226,a1305,20121226,4755,4757,4754,4766,4750,4762,4758,5,1,78908,3754608180,247926 
 20121227,a1305,20121227,4762,4758,4750,4772,4745,4768,4763,10,5,88348,4208373220,235972 
 20121228,a1305,20121228,4768,4763,4766,4775,4742,4743,4755,-20,-8,100584,4783059180,240452 
 20121231,a1305,20121231,4743,4755,4740,4758,4724,4743,4742,-12,-13,107338,5090522460,227030 
 20130104,a1305,20130104,4743,4742,4720,4752,4682,4740,4730,-2,-12,83298,3940172660,227566 
 20130107,a1305,20130107,4740,4730,4721,4765,4718,4731,4741,1,11,105872,5019553820,223224 
 20130108,a1305,20130108,4731,4741,4753,4753,4706,4739,4729,-2,-12,106642,5043233120,222558 
 20130109,a1305,20130109,4739,4729,4739,4754,4734,4737,4743,8,14,44018,2088194960,219828 
 20130110,a1305,20130110,4737,4743,4740,4751,4735,4750,4744,7,1,35326,1676032900,214416 
 20130111,a1305,20130111,4750,4744,4749,4793,4743,4755,4764,11,20,144948,6905729580,216392 
 20130114,a1305,20130114,4755,4764,4784,4812,4776,4806,4797,42,33,113530,5446703360,216238 
 20130115,a1305,20130115,4806,4797,4830,4839,4785,4798,4800,1,3,78972,3791336800,208246 
 20130116,a1305,20130116,4798,4800,4807,4816,4794,4813,4807,13,7,53430,2568650880,209528 
 20130117,a1305,20130117,4813,4807,4838,4838,4790,4791,4810,-16,3,44234,2127680600,204504 
 20130118,a1305,20130118,4791,4810,4799,4819,4787,4816,4805,6,-5,58576,2815133040,197668 
 20130121,a1305,20130121,4816,4805,4816,4859,4813,4827,4834,22,29,56158,2715118440,195736 
 20130122,a1305,20130122,4827,4834,4836,4846,4822,4844,4835,10,1,44440,2148836420,190730 
 20130123,a1305,20130123,4844,4835,4848,4848,4829,4835,4836,0,1,28486,1377741680,184456 
 20130124,a1305,20130124,4835,4836,4816,4827,4804,4819,4817,-17,-19,43014,2072390100,179290 
 20130125,a1305,20130125,4819,4817,4830,4854,4827,4832,4840,15,23,58236,2819139720,172606 
 20130128,a1305,20130128,4832,4840,4848,4855,4827,4851,4847,11,7,33410,1619462960,162716 
 20130129,a1305,20130129,4851,4847,4847,4860,4841,4847,4848,0,1,22650,1098126140,161704 
 20130130,a1305,20130130,4847,4848,4848,4875,4836,4862,4861,14,13,38098,1852174400,158402 
 20130131,a1305,20130131,4862,4861,4876,4891,4847,4855,4862,-6,1,39410,1916447560,150030 
 20130201,a1309,20130201,4838,4847,4837,4857,4828,4854,4844,7,-3,39942,1934832860,157210 
 20130204,a1309,20130204,4854,4844,4857,4865,4837,4841,4847,-3,3,35242,1708386200,153612 
 20130205,a1309,20130205,4841,4847,4848,4848,4829,4833,4839,-14,-8,30106,1456852940,149398 
 20130206,a1309,20130206,4833,4839,4835,4846,4833,4835,4838,-4,-1,16170,782384540,145372 
 20130207,a1309,20130207,4835,4838,4828,4837,4812,4816,4818,-22,-20,22716,1094560320,136500 
 20130208,a1309,20130208,4816,4818,4825,4856,4824,4828,4834,10,16,21334,1031358500,131968 
 20130218,a1309,20130218,4828,4834,4800,4800,4753,4782,4778,-52,-56,40458,1933291900,130006 
 20130219,a1309,20130219,4782,4778,4780,4794,4777,4783,4783,5,5,34880,1668640100,132440 
 20130220,a1309,20130220,4783,4783,4803,4821,4791,4815,4809,32,26,41952,2017873220,132944 
 20130221,a1309,20130221,4815,4809,4818,4818,4778,4794,4792,-15,-17,56046,2686121720,137126 
 20130222,a1309,20130222,4794,4792,4795,4918,4788,4857,4862,65,70,221904,10790157680,148264 
 20130225,a1309,20130225,4857,4862,4808,4829,4769,4797,4800,-65,-62,126796,6087292180,138000 
 20130226,a1309,20130226,4797,4800,4790,4835,4738,4739,4785,-61,-15,125062,5985044900,153356 
 20130227,a1309,20130227,4739,4785,4752,4785,4715,4725,4739,-60,-46,128232,6077341520,166916 
 20130228,a1309,20130228,4725,4739,4756,4757,4724,4724,4738,-15,-1,92528,4384431420,172368 
 20130301,a1309,20130301,4724,4738,4734,4755,4721,4748,4740,10,2,82160,3895099780,164032 
 20130304,a1309,20130304,4748,4740,4741,4751,4733,4739,4742,-1,2,52156,2473572000,164316 
 20130305,a1309,20130305,4739,4742,4758,4781,4755,4765,4768,23,26,56206,2680385180,154762 
 20130306,a1309,20130306,4765,4768,4767,4769,4748,4762,4757,-6,-11,41858,1991199240,156206 
 20130307,a1309,20130307,4762,4757,4760,4773,4753,4765,4763,8,6,37720,1796847640,157502 
 20130308,a1309,20130308,4765,4763,4779,4786,4767,4779,4778,16,15,34334,1640557760,153008 
 20130311,a1309,20130311,4779,4778,4780,4783,4757,4758,4767,-20,-11,34140,1627617700,154292 
 20130312,a1309,20130312,4758,4767,4766,4769,4722,4724,4735,-43,-32,66554,3151815940,171278 
 20130313,a1309,20130313,4724,4735,4728,4740,4689,4733,4715,-2,-20,114716,5409078280,175512 
 20130314,a1309,20130314,4733,4715,4701,4721,4690,4716,4706,1,-9,114278,5378740480,186554 
 20130315,a1309,20130315,4716,4706,4720,4780,4720,4768,4758,62,52,115142,5479274080,180682 
 20130318,a1309,20130318,4768,4758,4730,4738,4711,4730,4727,-28,-31,88988,4207166800,183930 
 20130319,a1309,20130319,4730,4727,4748,4748,4719,4735,4728,8,1,66924,3164832540,178598 
 20130320,a1309,20130320,4735,4728,4729,4748,4726,4736,4739,8,11,54648,2589834900,165410 
 20130321,a1309,20130321,4736,4739,4748,4785,4740,4779,4766,40,27,78274,3730715880,169422 
 20130322,a1309,20130322,4779,4766,4790,4820,4767,4806,4798,40,32,139262,6682152980,194292 
 20130325,a1309,20130325,4806,4798,4800,4860,4799,4839,4840,41,42,203842,9866218600,222344 
 20130326,a1309,20130326,4839,4840,4838,4852,4828,4844,4840,4,0,108360,5245505360,221396 
 20130327,a1309,20130327,4844,4840,4850,4851,4805,4820,4823,-20,-17,130156,6278185600,204834 
 20130328,a1309,20130328,4820,4823,4826,4850,4805,4817,4826,-6,3,140714,6790857880,201474 
 20130329,a1309,20130329,4817,4826,4783,4806,4746,4801,4785,-25,-41,144732,6925903840,194694 
 20130401,a1309,20130401,4801,4785,4795,4818,4767,4778,4791,-7,6,120974,5795891720,200624 
 20130402,a1309,20130402,4778,4791,4783,4796,4756,4779,4777,-12,-14,82962,3963497300,196614 
 20130403,a1309,20130403,4779,4777,4760,4772,4741,4758,4755,-19,-22,90306,4294447720,196434 
 20130408,a1309,20130408,4758,4755,4731,4782,4731,4782,4755,27,0,104082,4950052860,205174 
 20130409,a1309,20130409,4782,4755,4782,4797,4770,4780,4783,25,28,68790,3290579860,209890 
 20130410,a1309,20130410,4780,4783,4790,4817,4783,4814,4799,31,16,89534,4297518020,212822 
 20130411,a1309,20130411,4814,4799,4802,4824,4802,4813,4811,14,12,93290,4488592180,224366 
 20130412,a1309,20130412,4813,4811,4819,4823,4797,4817,4809,6,-2,65084,3130335740,213208 
 20130415,a1309,20130415,4817,4809,4806,4807,4774,4795,4790,-14,-19,94890,4545408280,220582 
 20130416,a1309,20130416,4795,4790,4765,4818,4761,4801,4793,11,3,144506,6926682800,229842 
 20130417,a1309,20130417,4801,4793,4805,4822,4794,4803,4808,10,15,105134,5055206820,217382 
 20130418,a1309,20130418,4803,4808,4793,4818,4785,4808,4803,0,-5,81650,3921920020,216504 
 20130419,a1309,20130419,4808,4803,4815,4830,4794,4796,4812,-7,9,80360,3867435700,215208 
 20130422,a1309,20130422,4796,4812,4780,4796,4770,4779,4782,-33,-30,101228,4840916760,227746 
 20130423,a1309,20130423,4779,4782,4780,4795,4770,4794,4786,12,4,113908,5452475620,231544 
 20130424,a1309,20130424,4794,4786,4790,4793,4741,4748,4761,-38,-25,222762,10605699780,254398 
 20130425,a1309,20130425,4748,4761,4740,4765,4732,4741,4748,-20,-13,130796,6210447100,249480 
 20130426,a1309,20130426,4741,4748,4778,4778,4750,4767,4765,19,17,117592,5603726240,223664 
 20130502,a1309,20130502,4767,4765,4749,4770,4735,4768,4756,3,-9,76140,3621841300,224066 
 20130503,a1309,20130503,4768,4756,4768,4780,4763,4777,4772,21,16,46058,2198092780,220530 
 20130506,a1309,20130506,4777,4772,4775,4799,4771,4798,4787,26,15,75162,3598667860,219724 
 20130507,a1309,20130507,4798,4787,4780,4788,4775,4776,4782,-11,-5,45546,2178379380,217936 
 20130508,a1309,20130508,4776,4782,4780,4796,4778,4790,4789,8,7,40162,1923757160,212642 
 20130509,a1309,20130509,4790,4789,4785,4794,4779,4781,4786,-8,-3,32162,1539304540,209440 
 20130510,a1309,20130510,4781,4786,4786,4808,4782,4794,4790,8,4,48996,2347285920,202796 
 20130513,a1309,20130513,4794,4790,4785,4795,4766,4767,4779,-23,-11,42914,2051026120,205806 
 20130514,a1309,20130514,4767,4779,4780,4787,4769,4774,4778,-5,-1,45204,2160144480,204906 
 20130515,a1309,20130515,4774,4778,4775,4777,4761,4774,4770,-4,-8,32130,1532759480,206658 
 20130516,a1309,20130516,4774,4770,4770,4790,4765,4789,4781,19,11,64780,3097634640,197282 
 20130517,a1309,20130517,4789,4781,4799,4800,4787,4798,4795,17,14,47510,2278458260,186294 
 20130520,a1309,20130520,4798,4795,4801,4830,4801,4815,4818,20,23,52596,2534141860,183494 
 20130521,a1309,20130521,4815,4818,4816,4830,4802,4816,4818,-2,0,30584,1473592540,183814 
 20130522,a1309,20130522,4816,4818,4816,4827,4812,4826,4820,8,2,20998,1012272380,181086 
 20130523,a1309,20130523,4826,4820,4840,4840,4801,4807,4823,-13,3,36382,1754877720,176510 
 20130524,a1401,20130524,4674,4691,4680,4680,4654,4654,4660,-37,-31,39594,1845399520,134746 
 20130527,a1401,20130527,4654,4660,4644,4665,4633,4663,4655,3,-5,20274,943896880,132268 
 20130528,a1401,20130528,4663,4655,4665,4679,4662,4679,4669,24,14,13318,621854040,131336 
 20130529,a1401,20130529,4679,4669,4703,4715,4685,4699,4703,30,34,47764,2246791320,136102 
 20130530,a1309,20130530,4808,4819,4819,4819,4795,4799,4800,-20,-19,32732,1571282700,148450 
 20130531,a1401,20130531,4681,4686,4686,4696,4674,4681,4681,-5,-5,35906,1680795220,126756 
 20130603,a1401,20130603,4681,4681,4690,4732,4682,4722,4711,41,30,53518,2521744500,127688 
 20130604,a1401,20130604,4722,4711,4726,4729,4702,4708,4713,-3,2,30826,1453093640,124714 
 20130605,a1309,20130605,4828,4827,4837,4849,4829,4830,4836,3,9,25144,1215969560,126312 
 20130606,a1401,20130606,4717,4715,4700,4718,4697,4713,4709,-2,-6,18950,892544300,122674 
 20130607,a1401,20130607,4713,4709,4716,4725,4693,4699,4703,-10,-6,24724,1162839240,119428 
 20130613,a1401,20130613,4699,4703,4699,4707,4674,4685,4685,-18,-18,21960,1028857160,119686 
 20130614,a1401,20130614,4685,4685,4680,4687,4670,4687,4679,2,-6,16640,778632420,120284 
 20130617,a1401,20130617,4687,4679,4680,4684,4660,4674,4672,-5,-7,23628,1103982260,121400 
 20130618,a1401,20130618,4674,4672,4675,4690,4675,4679,4683,7,11,14434,676035580,120512 
 20130619,a1401,20130619,4679,4683,4672,4682,4662,4668,4672,-15,-11,14998,700794760,122764 
 20130620,a1401,20130620,4668,4672,4675,4684,4652,4656,4666,-16,-6,26086,1217393360,124670 
 20130621,a1401,20130621,4656,4666,4650,4659,4622,4629,4636,-37,-30,52132,2416972080,129734 
 20130624,a1401,20130624,4629,4636,4604,4635,4604,4610,4617,-26,-19,23690,1093816860,131306 
 20130625,a1401,20130625,4610,4617,4629,4645,4620,4639,4631,22,14,29596,1370757400,129192 
 20130626,a1401,20130626,4639,4631,4635,4646,4626,4632,4634,1,3,17960,832359360,128476 
 20130627,a1401,20130627,4632,4634,4623,4635,4605,4628,4620,-6,-14,29040,1341816120,131108 
 20130628,a1401,20130628,4628,4620,4623,4635,4613,4617,4621,-3,1,13014,601462760,131876 
 20130701,a1401,20130701,4617,4621,4596,4602,4556,4587,4586,-34,-35,42576,1952790560,147476 
 20130702,a1401,20130702,4587,4586,4580,4608,4571,4608,4597,22,11,25722,1182687220,145894 
 20130703,a1401,20130703,4608,4597,4606,4617,4598,4609,4606,12,9,17672,814122240,146046 
 20130704,a1401,20130704,4609,4606,4610,4629,4609,4625,4621,19,15,20076,927855760,142172 
 20130705,a1401,20130705,4625,4621,4630,4636,4621,4626,4627,5,6,10912,504932420,142170 
 20130708,a1401,20130708,4626,4627,4615,4616,4600,4606,4607,-21,-20,15494,713868780,145236 
 20130709,a1401,20130709,4606,4607,4619,4642,4618,4634,4634,27,27,29152,1350907220,142162 
 20130710,a1401,20130710,4634,4634,4645,4657,4635,4646,4643,12,9,18088,839982960,139592 
 20130711,a1401,20130711,4646,4643,4653,4663,4643,4658,4652,15,9,22570,1050024540,134780 
 20130712,a1401,20130712,4658,4652,4663,4673,4643,4644,4657,-8,5,18808,875957320,134006 
 20130715,a1401,20130715,4644,4657,4629,4632,4616,4624,4625,-33,-32,17770,821897840,136550 
 20130716,a1401,20130716,4624,4625,4630,4653,4630,4646,4639,21,14,12310,571123960,136808 
 20130717,a1401,20130717,4646,4639,4655,4658,4644,4651,4652,12,13,16344,760348540,135542 
 20130718,a1401,20130718,4651,4652,4645,4645,4625,4634,4632,-18,-20,22648,1049104840,134714 
 20130719,a1401,20130719,4634,4632,4625,4632,4613,4614,4621,-18,-11,31624,1461513440,129990 
 20130722,a1401,20130722,4614,4621,4621,4636,4617,4631,4627,10,6,23992,1110147540,128684 
 20130723,a1401,20130723,4631,4627,4638,4651,4629,4651,4640,24,13,23834,1105953060,125340 
 20130724,a1401,20130724,4651,4640,4620,4632,4601,4606,4613,-34,-27,44166,2037537200,130250 
 20130725,a1401,20130725,4606,4613,4592,4592,4526,4533,4550,-80,-63,122936,5594280140,149042 
 20130726,a1401,20130726,4533,4550,4495,4495,4368,4368,4434,-182,-116,240514,10665110840,186306 
 20130729,a1401,20130729,4368,4434,4351,4362,4305,4345,4333,-89,-101,320586,13892427760,199734 
 20130730,a1401,20130730,4345,4333,4343,4350,4303,4320,4322,-13,-11,221912,9591208520,212000 
 20130731,a1401,20130731,4320,4322,4285,4412,4263,4409,4360,87,38,495190,21591970840,216912 
 20130801,a1401,20130801,4409,4360,4400,4435,4376,4419,4407,59,47,391838,17270925580,210608 
 20130802,a1401,20130802,4419,4407,4402,4424,4382,4423,4404,16,-3,323784,14261263080,211166 
 20130805,a1401,20130805,4423,4404,4403,4413,4366,4404,4392,0,-12,263664,11582500380,212426 
 20130806,a1401,20130806,4404,4392,4391,4411,4386,4410,4401,18,9,106994,4709524100,206160 
 20130807,a1401,20130807,4410,4401,4380,4390,4310,4320,4332,-81,-69,355760,15411698560,236118 
 20130808,a1401,20130808,4320,4332,4323,4378,4323,4354,4351,22,19,181370,7892290120,208318 
 20130809,a1401,20130809,4354,4351,4375,4392,4352,4357,4371,6,20,127928,5592409260,206796 
 20130812,a1401,20130812,4357,4371,4371,4405,4361,4401,4385,30,14,97716,4285772660,192312 
 20130813,a1401,20130813,4401,4385,4450,4468,4433,4450,4451,65,66,103724,4617336980,183250 
 20130814,a1401,20130814,4450,4451,4435,4445,4408,4408,4424,-43,-27,101822,4505575760,189670 
 20130815,a1401,20130815,4408,4424,4450,4455,4419,4421,4439,-3,15,88374,3923080660,182358 
 20130816,a1401,20130816,4421,4439,4452,4485,4430,4435,4455,-4,16,85132,3792813640,176978 
 20130819,a1401,20130819,4435,4455,4490,4490,4448,4450,4460,-5,5,66306,2957550800,177664 
 20130820,a1401,20130820,4450,4460,4480,4480,4442,4453,4455,-7,-5,109200,4865948880,179004 
 20130821,a1401,20130821,4453,4455,4447,4474,4440,4455,4454,0,-1,86148,3837748040,178682 
 20130822,a1401,20130822,4455,4454,4451,4473,4451,4467,4463,13,9,66016,2946518280,181154 
 20130823,a1401,20130823,4467,4463,4463,4476,4449,4464,4461,1,-2,89926,4011848720,183786 
 20130826,a1401,20130826,4464,4461,4528,4639,4520,4623,4599,162,138,575450,26468710140,202420 
 20130827,a1401,20130827,4623,4599,4630,4630,4553,4569,4575,-30,-24,239768,10971411860,171344 
 20130828,a1401,20130828,4569,4575,4569,4569,4530,4535,4552,-40,-23,73964,3367580480,167500 
 20130829,a1401,20130829,4535,4552,4550,4583,4488,4532,4543,-20,-9,134390,6105689000,161364 
 20130830,a1401,20130830,4532,4543,4501,4523,4490,4512,4509,-31,-34,50726,2287565960,158240 
 20130902,a1401,20130902,4512,4509,4508,4547,4506,4545,4538,36,29,44454,2017373640,156688 
 20130903,a1401,20130903,4545,4538,4560,4560,4522,4548,4540,10,2,58506,2656422060,151404 
 20130904,a1401,20130904,4548,4540,4530,4535,4513,4529,4523,-11,-17,29692,1343099720,149116 
 20130905,a1401,20130905,4529,4523,4513,4545,4508,4533,4533,10,10,47790,2166624100,143762 
 20130906,a1401,20130906,4533,4533,4540,4563,4536,4558,4550,25,17,38534,1753554620,137818 
 20130909,a1401,20130909,4558,4550,4558,4569,4545,4560,4556,10,6,22470,1023753880,135294 
 20130910,a1401,20130910,4560,4556,4531,4560,4524,4557,4543,1,-13,33138,1505590680,135278 
 20130911,a1401,20130911,4557,4543,4560,4603,4560,4593,4584,50,41,108012,4951853600,144376 
 20130912,a1401,20130912,4593,4584,4586,4603,4576,4590,4589,6,5,67454,3095625380,138858 
 20130913,a1401,20130913,4590,4589,4628,4638,4590,4591,4603,2,14,78056,3593084200,113854 
 20130916,a1401,20130916,4591,4603,4562,4577,4541,4542,4560,-61,-43,51068,2329114940,107108 
 20130917,a1401,20130917,4542,4560,4530,4560,4523,4560,4546,0,-14,40622,1846877960,103444 
 20130918,a1401,20130918,4560,4546,4550,4591,4548,4589,4569,43,23,35528,1623578880,100720 
 20130923,a1401,20130923,4589,4569,4568,4587,4549,4574,4570,5,1,31546,1441963300,104790 
 20130924,a1401,20130924,4574,4570,4571,4604,4571,4600,4591,30,21,44448,2040683680,101912 
 20130925,a1401,20130925,4600,4591,4598,4610,4586,4593,4598,2,7,23458,1078644140,96812 
 20130926,a1401,20130926,4593,4598,4593,4607,4583,4592,4593,-6,-5,17834,819206820,91064 
 20130927,a1401,20130927,4592,4593,4592,4600,4580,4593,4590,0,-3,24954,1145515140,84166 
 20130930,a1401,20130930,4593,4590,4586,4645,4586,4616,4622,26,32,40678,1880139440,84022 
 20131008,a1401,20131008,4616,4622,4622,4674,4622,4661,4652,39,30,32894,1530541160,84578 
 20131009,a1401,20131009,4661,4652,4660,4660,4640,4648,4648,-4,-4,15232,708098140,84868 
 20131010,a1401,20131010,4648,4648,4652,4689,4652,4681,4675,33,27,41620,1946084160,87104 
 20131011,a1401,20131011,4681,4675,4675,4698,4658,4658,4675,-17,0,26700,1248381440,85944 
 20131014,a1401,20131014,4658,4675,4640,4684,4635,4662,4659,-13,-16,42660,1987654280,84946 
 20131015,a1401,20131015,4662,4659,4666,4687,4645,4655,4660,-4,1,39724,1851526280,71314 
 20131016,a1405,20131016,4556,4558,4553,4593,4553,4574,4576,16,18,54206,2480520120,88786 
 20131017,a1405,20131017,4574,4576,4573,4589,4546,4559,4562,-17,-14,33462,1526648420,86776 
 20131018,a1405,20131018,4559,4562,4579,4587,4559,4574,4572,12,10,17838,815607120,87364 
 20131021,a1405,20131021,4574,4572,4585,4589,4566,4585,4578,13,6,19932,912648120,83196 
 20131022,a1405,20131022,4585,4578,4584,4589,4547,4548,4564,-30,-14,32876,1500565020,91442 
 20131023,a1405,20131023,4548,4564,4545,4564,4516,4539,4543,-25,-21,40412,1835981920,95990 
 20131024,a1405,20131024,4539,4543,4550,4550,4506,4509,4518,-34,-25,37282,1684641140,97072 
 20131025,a1405,20131025,4509,4518,4489,4522,4488,4491,4504,-27,-14,32512,1464453820,100700 
 20131028,a1405,20131028,4491,4504,4502,4502,4465,4481,4482,-23,-22,26332,1180313840,104160 
 20131029,a1405,20131029,4481,4482,4460,4476,4436,4446,4452,-36,-30,30084,1339361420,105824 
 20131030,a1405,20131030,4446,4452,4449,4472,4445,4448,4457,-4,5,22020,981581780,104856 
 20131031,a1405,20131031,4448,4457,4448,4482,4436,4476,4467,19,10,39232,1752685920,109620 
 20131101,a1405,20131101,4476,4467,4465,4505,4459,4481,4489,14,22,48212,2164293680,114642 
 20131104,a1405,20131104,4481,4489,4465,4479,4460,4475,4470,-14,-19,19872,888328980,115006 
 20131105,a1405,20131105,4475,4470,4473,4496,4462,4480,4481,10,11,28204,1263887560,114520 
 20131106,a1405,20131106,4480,4481,4472,4485,4456,4458,4470,-23,-11,34358,1535808700,117216 
 20131107,a1405,20131107,4458,4470,4455,4488,4453,4488,4473,18,3,39942,1786952520,121850 
 20131108,a1405,20131108,4488,4473,4490,4504,4474,4487,4491,14,18,54970,2468739340,121742 
 20131111,a1405,20131111,4487,4491,4501,4563,4493,4514,4516,23,25,57752,2608558000,123800 
 20131112,a1405,20131112,4514,4516,4521,4527,4496,4504,4507,-12,-9,38472,1734086720,126072 
 20131113,a1405,20131113,4504,4507,4506,4518,4503,4508,4507,1,0,27392,1234615740,120442 
 20131114,a1405,20131114,4508,4507,4510,4519,4498,4519,4511,12,4,21482,969242400,118554 
 20131115,a1405,20131115,4519,4511,4520,4525,4504,4508,4512,-3,1,28980,1307851120,120528 
 20131118,a1405,20131118,4508,4512,4515,4515,4477,4489,4488,-23,-24,45118,2025006700,116812 
 20131119,a1405,20131119,4489,4488,4492,4500,4457,4457,4472,-31,-16,41610,1860898840,119168 
 20131120,a1405,20131120,4457,4472,4452,4459,4430,4445,4441,-27,-31,51906,2305203900,119540 
 20131121,a1405,20131121,4445,4441,4441,4448,4420,4427,4432,-14,-9,41918,1857926360,122042 
 20131122,a1405,20131122,4427,4432,4443,4448,4431,4440,4439,8,7,29032,1288912240,119896 
 20131125,a1405,20131125,4440,4439,4460,4460,4430,4431,4444,-8,5,32766,1456247040,114670 
 20131126,a1405,20131126,4431,4444,4440,4444,4403,4410,4417,-34,-27,43146,1906064840,112240 
 20131127,a1405,20131127,4410,4417,4419,4438,4408,4432,4428,15,11,32718,1448777580,106504 
 20131128,a1405,20131128,4432,4428,4424,4425,4384,4386,4396,-42,-32,54652,2402706180,113014 
 20131129,a1405,20131129,4386,4396,4386,4402,4380,4395,4392,-1,-4,30894,1357144420,111972 
 20131202,a1405,20131202,4395,4392,4400,4434,4396,4429,4421,37,29,45970,2032448500,104184 
 20131203,a1405,20131203,4429,4421,4420,4447,4406,4438,4431,17,10,51786,2294640260,96768 
 20131204,a1405,20131204,4438,4431,4435,4457,4435,4455,4448,24,17,33616,1495446240,97052 
 20131205,a1405,20131205,4455,4448,4459,4473,4445,4460,4462,12,14,25786,1150712460,95190 
 20131206,a1405,20131206,4460,4462,4469,4469,4434,4444,4447,-18,-15,27152,1207651920,95538 
 20131209,a1405,20131209,4444,4447,4446,4469,4439,4467,4452,20,5,27602,1229007340,90286 
 20131210,a1405,20131210,4467,4452,4473,4490,4458,4465,4469,13,17,18410,822842660,89382 
 20131211,a1405,20131211,4465,4469,4473,4474,4456,4473,4462,4,-7,13242,590941280,88930 
 20131212,a1405,20131212,4473,4462,4476,4479,4452,4466,4463,4,1,17708,790483280,88084 
 20131213,a1405,20131213,4466,4463,4456,4476,4453,4463,4464,0,1,29272,1306949340,85744 
 20131216,a1405,20131216,4463,4464,4457,4514,4457,4492,4492,28,28,54988,2470109620,80730 
 20131217,a1405,20131217,4492,4492,4502,4519,4491,4506,4506,14,14,38330,1727295380,80338 
 20131218,a1405,20131218,4506,4506,4516,4517,4483,4492,4494,-14,-12,26290,1181489480,78812 
 20131219,a1405,20131219,4492,4494,4480,4496,4471,4490,4488,-4,-6,17554,787866780,78460 
 20131220,a1405,20131220,4490,4488,4495,4500,4475,4499,4489,11,1,15416,692095620,77334 
 20131223,a1405,20131223,4499,4489,4504,4515,4498,4511,4506,22,17,18086,815065300,76508 
 20131224,a1405,20131224,4511,4506,4501,4506,4468,4486,4486,-20,-20,27342,1226665540,75288 
 20131225,a1405,20131225,4486,4486,4489,4495,4474,4487,4485,1,-1,18404,825498140,74636 
 20131226,a1405,20131226,4487,4485,4490,4497,4476,4476,4484,-9,-1,10338,463657900,74378 
 20131227,a1405,20131227,4476,4484,4465,4492,4457,4488,4479,4,-5,19268,863124140,73522 
 20131230,a1405,20131230,4488,4479,4460,4480,4358,4411,4412,-68,-67,215014,9488153860,70770 
 20131231,a1405,20131231,4411,4412,4411,4450,4405,4441,4434,29,22,60974,2704131920,66464 
 20140102,a1405,20140102,4441,4434,4411,4451,4411,4449,4436,15,2,35988,1596541120,64992 
 20140103,a1405,20140103,4449,4436,4436,4468,4423,4466,4451,30,15,46246,2058686900,65966 
 20140106,a1405,20140106,4466,4451,4470,4510,4455,4500,4489,49,38,60590,2719930800,75614 
 20140107,a1405,20140107,4500,4489,4505,4561,4500,4557,4531,68,42,72068,3265948180,75546 
 20140108,a1405,20140108,4557,4531,4560,4589,4518,4563,4555,32,24,101974,4645895420,78432 
 20140109,a1405,20140109,4563,4555,4555,4586,4547,4578,4565,23,10,48910,2233223960,81594 
 20140110,a1405,20140110,4578,4565,4588,4640,4573,4627,4605,62,40,134708,6203909760,94694 
 20140113,a1405,20140113,4627,4605,4628,4629,4593,4599,4605,-6,0,61132,2815394640,85452 
 20140114,a1405,20140114,4599,4605,4610,4620,4601,4617,4611,12,6,30578,1410059200,83712 
 20140115,a1405,20140115,4617,4611,4620,4661,4614,4659,4644,48,33,76460,3551460760,90568 
 20140116,a1405,20140116,4659,4644,4665,4685,4646,4683,4667,39,23,49890,2328717220,89446 
 20140117,a1405,20140117,4683,4667,4675,4703,4652,4690,4681,23,14,65296,3056675900,94304 
 20140120,a1405,20140120,4690,4681,4700,4746,4681,4733,4722,52,41,88478,4178242940,100942 
 20140121,a1405,20140121,4733,4722,4730,4738,4695,4713,4713,-9,-9,83232,3922889220,93470 
 20140122,a1405,20140122,4713,4713,4690,4699,4666,4685,4683,-28,-30,70446,3299416260,98990 
 20140123,a1405,20140123,4685,4683,4700,4725,4689,4701,4709,18,26,81532,3840043980,102484 
 20140124,a1405,20140124,4701,4709,4693,4705,4681,4699,4692,-10,-17,64392,3021517800,105970 
 20140127,a1405,20140127,4699,4692,4702,4717,4700,4712,4709,20,17,32136,1513520740,104026 
 20140128,a1405,20140128,4712,4709,4713,4717,4687,4696,4694,-13,-15,28968,1359929840,101792 
 20140129,a1405,20140129,4696,4694,4694,4711,4688,4693,4697,-1,3,28472,1337580780,96380 
 20140130,a1405,20140130,4693,4697,4684,4696,4672,4691,4685,-6,-12,28188,1320885060,88860 
 20140207,a1405,20140207,4691,4685,4730,4766,4709,4712,4722,27,37,34650,1636282000,81838 
 20140210,a1409,20140210,4462,4463,4462,4525,4459,4519,4498,56,35,65302,2937502100,103744 
 20140211,a1409,20140211,4519,4498,4527,4555,4500,4519,4532,21,34,87674,3973818080,122190 
 20140212,a1409,20140212,4519,4532,4530,4560,4523,4547,4546,15,14,42450,1930074780,132898 
 20140213,a1409,20140213,4547,4546,4535,4565,4531,4564,4550,18,4,34664,1577411260,137238 
 20140214,a1409,20140214,4564,4550,4580,4584,4547,4558,4562,8,12,26202,1195372320,137314 
 20140217,a1409,20140217,4558,4562,4558,4562,4524,4540,4542,-22,-20,30726,1395847800,137362 
 20140218,a1409,20140218,4540,4542,4543,4553,4511,4512,4528,-30,-14,31340,1419291100,135608 
 20140219,a1409,20140219,4512,4528,4530,4539,4477,4499,4503,-29,-25,52336,2356888980,133362 
 20140220,a1409,20140220,4499,4503,4496,4518,4493,4510,4507,7,4,36282,1635390000,127620 
 20140221,a1409,20140221,4510,4507,4515,4524,4484,4514,4509,7,2,67258,3032733560,140296 
 20140224,a1409,20140224,4514,4509,4519,4557,4505,4544,4534,35,25,67604,3065510700,147572 
 20140225,a1409,20140225,4544,4534,4544,4553,4524,4525,4537,-9,3,37648,1708309680,147326 
 20140226,a1409,20140226,4525,4537,4535,4544,4515,4520,4527,-17,-10,30500,1381024440,146876 
 20140227,a1409,20140227,4520,4527,4524,4534,4498,4505,4513,-22,-14,39176,1768221840,147090 
 20140228,a1409,20140228,4505,4513,4490,4490,4452,4453,4468,-60,-45,56384,2519758400,147658 
 20140303,a1409,20140303,4453,4468,4458,4484,4458,4470,4472,2,4,34982,1564641680,149666 
 20140304,a1409,20140304,4470,4472,4467,4470,4441,4456,4453,-16,-19,44604,1986216880,147746 
 20140305,a1409,20140305,4456,4453,4460,4488,4454,4482,4472,29,19,41364,1850077000,149210 
 20140306,a1409,20140306,4482,4472,4475,4485,4471,4474,4478,2,6,17794,796815640,149142 
 20140307,a1409,20140307,4474,4478,4483,4488,4453,4454,4468,-24,-10,44666,1995928060,146216 
 20140310,a1409,20140310,4454,4468,4451,4451,4319,4336,4367,-132,-101,143864,6283341740,126596 
 20140311,a1409,20140311,4336,4367,4314,4403,4300,4398,4374,31,7,67762,2964264400,106786 
 20140312,a1409,20140312,4398,4374,4374,4393,4369,4379,4380,5,6,33716,1476908700,104896 
 20140313,a1409,20140313,4379,4380,4377,4377,4345,4368,4354,-12,-26,45570,1984482200,103528 
 20140314,a1409,20140314,4368,4354,4367,4381,4356,4364,4369,10,15,30792,1345431340,102108 
 20140317,a1409,20140317,4364,4369,4360,4362,4340,4361,4351,-8,-18,26322,1145427200,97640 
 20140318,a1409,20140318,4361,4351,4362,4378,4345,4363,4360,12,9,30882,1346734280,91658 
 20140319,a1409,20140319,4363,4360,4373,4375,4359,4362,4367,2,7,20834,910018320,90950 
 20140320,a1409,20140320,4362,4367,4360,4362,4317,4341,4338,-26,-29,50208,2178417220,90328 
 20140321,a1409,20140321,4341,4338,4331,4351,4331,4340,4341,2,3,17018,738881320,89044 
 20140324,a1409,20140324,4340,4341,4340,4349,4324,4331,4334,-10,-7,13054,565869220,87668 
 20140325,a1409,20140325,4331,4334,4330,4353,4330,4336,4343,2,9,22702,986058480,82794 
 20140326,a1409,20140326,4336,4343,4335,4347,4311,4323,4324,-20,-19,33734,1458906140,88152 
 20140327,a1409,20140327,4323,4324,4325,4346,4304,4308,4322,-16,-2,39332,1700290980,93632 
 20140328,a1409,20140328,4308,4322,4304,4316,4284,4288,4300,-34,-22,34008,1462469480,95248 
 20140331,a1409,20140331,4288,4300,4277,4295,4257,4269,4274,-31,-26,34554,1477171240,98798 
 20140401,a1409,20140401,4269,4274,4278,4335,4278,4308,4310,34,36,61356,2644653620,97212 
 20140402,a1409,20140402,4308,4310,4310,4330,4267,4267,4293,-43,-17,56410,2421758780,104238 
 20140403,a1409,20140403,4267,4293,4266,4280,4241,4261,4261,-32,-32,48574,2070039400,108792 
 20140404,a1409,20140404,4261,4261,4266,4308,4252,4291,4288,30,27,76098,3263166900,116646 
 20140408,a1409,20140408,4291,4288,4280,4298,4275,4291,4287,3,-1,34696,1487657660,115082 
 20140409,a1409,20140409,4291,4287,4300,4326,4292,4297,4312,10,25,45548,1964367000,115352 
 20140410,a1409,20140410,4297,4312,4298,4316,4298,4299,4306,-13,-6,30730,1323526180,115710 
 20140411,a1409,20140411,4299,4306,4294,4302,4280,4288,4289,-18,-17,24574,1054211540,120182 
 20140414,a1409,20140414,4288,4289,4286,4369,4286,4358,4338,69,49,113064,4904767120,132282 
 20140415,a1501,20140415,4269,4243,4280,4332,4276,4329,4304,86,61,107622,4632790300,143086 
 20140416,a1501,20140416,4329,4304,4341,4357,4317,4339,4332,35,28,59564,2580397860,152388 
 20140417,a1501,20140417,4339,4332,4345,4364,4326,4343,4342,11,10,49580,2153180360,153998 
 20140418,a1409,20140418,4391,4377,4385,4421,4380,4396,4401,19,24,98294,4326113200,174144 
 20140421,a1501,20140421,4348,4359,4348,4355,4288,4299,4315,-60,-44,85310,3681181660,167282 
 20140422,a1409,20140422,4351,4372,4350,4371,4331,4363,4354,-9,-18,52470,2285025740,180624 
 20140423,a1501,20140423,4316,4306,4303,4340,4298,4314,4320,8,14,55238,2386742100,170568 
 20140424,a1501,20140424,4314,4320,4326,4340,4312,4340,4326,20,6,28420,1229508180,175790 
 20140425,a1409,20140425,4391,4371,4388,4462,4386,4445,4439,74,68,186828,8294301820,202882 
 20140428,a1409,20140428,4445,4439,4468,4481,4451,4471,4468,32,29,91282,4078802600,216714 
 20140429,a1409,20140429,4471,4468,4459,4508,4444,4499,4485,31,17,121262,5439345980,239672 
 20140430,a1409,20140430,4499,4485,4507,4522,4481,4485,4497,0,12,82214,3697977040,240380 
 20140505,a1409,20140505,4485,4497,4454,4488,4449,4472,4472,-25,-25,52362,2341724840,240348 
 20140506,a1409,20140506,4472,4472,4470,4470,4374,4377,4418,-95,-54,232432,10270185620,276826 
 20140507,a1409,20140507,4377,4418,4369,4387,4353,4359,4366,-59,-52,120258,5251561420,282706 
 20140508,a1409,20140508,4359,4366,4356,4405,4351,4381,4384,15,18,157604,6910663660,284566 
 20140509,a1409,20140509,4381,4384,4400,4402,4373,4376,4384,-8,0,61304,2687978820,274376 
 20140512,a1409,20140512,4376,4384,4385,4400,4371,4382,4385,-2,1,74774,3279519620,262468 
 20140513,a1409,20140513,4382,4385,4386,4450,4374,4448,4420,63,35,180466,7976669020,273440 
 20140514,a1409,20140514,4448,4420,4457,4515,4456,4510,4497,90,77,178446,8024991620,299358 
 20140515,a1501,20140515,4394,4378,4388,4484,4376,4469,4445,91,67,240218,10678796720,254890 
 20140516,a1501,20140516,4469,4445,4460,4497,4440,4483,4471,38,26,216220,9668361400,264284 
 20140519,a1501,20140519,4483,4471,4492,4535,4458,4523,4509,52,38,272160,12272237040,289846 
 20140520,a1501,20140520,4523,4509,4550,4600,4498,4589,4557,80,48,328350,14965608240,287678 
 20140521,a1501,20140521,4589,4557,4575,4658,4561,4590,4610,33,53,566686,26125616860,337464 
 20140522,a1501,20140522,4590,4610,4629,4643,4590,4602,4616,-8,6,320738,14806779620,341760 
 20140523,a1501,20140523,4602,4616,4597,4608,4562,4572,4584,-44,-32,239014,10957935880,335674 
 20140526,a1501,20140526,4572,4584,4573,4599,4561,4574,4580,-10,-4,198946,9113354280,344086 
 20140527,a1501,20140527,4574,4580,4570,4585,4536,4552,4555,-28,-25,227804,10377775780,328662 
 20140528,a1501,20140528,4552,4555,4549,4674,4538,4651,4636,96,81,709724,32908458060,441394 
 20140529,a1501,20140529,4651,4636,4652,4670,4623,4628,4641,-8,5,341274,15840552120,432594 
 20140530,a1501,20140530,4628,4641,4630,4653,4518,4555,4589,-86,-52,495148,22725982460,382130 
 20140603,a1501,20140603,4555,4589,4547,4570,4532,4559,4556,-30,-33,162322,7396029380,381960 
 20140604,a1501,20140604,4559,4556,4535,4592,4535,4554,4564,-2,8,276968,12641605740,383672 
 20140605,a1501,20140605,4554,4564,4561,4571,4501,4501,4527,-63,-37,251012,11365475540,353108 
 20140606,a1501,20140606,4501,4527,4482,4501,4452,4466,4475,-61,-52,239258,10707417120,320906 
 20140609,a1501,20140609,4466,4475,4468,4529,4463,4507,4502,32,27,192518,8668829960,325336 
 20140610,a1501,20140610,4507,4502,4505,4517,4464,4465,4491,-37,-11,191802,8613966280,317108 
 20140611,a1501,20140611,4465,4491,4478,4497,4463,4477,4481,-14,-10,111632,5002923340,309148 
 20140612,a1501,20140612,4477,4481,4456,4512,4444,4485,4487,4,6,190554,8551479680,321720 
 20140613,a1501,20140613,4485,4487,4471,4490,4459,4477,4473,-10,-14,103704,4639180320,311800 
 20140616,a1501,20140616,4477,4473,4488,4533,4476,4516,4511,43,38,212962,9607450560,330588 
 20140617,a1501,20140617,4516,4511,4521,4521,4476,4486,4492,-25,-19,167948,7544243600,320894 
 20140618,a1501,20140618,4486,4492,4468,4507,4464,4489,4488,-3,-4,141568,6354947400,324074 
 20140619,a1501,20140619,4489,4488,4491,4510,4490,4491,4499,3,11,93252,4195731240,320924 
 20140620,a1501,20140620,4491,4499,4503,4514,4487,4499,4501,0,2,99610,4483904300,317140 
 20140623,a1501,20140623,4499,4501,4506,4550,4504,4526,4529,25,28,180324,8167868140,315262 
 20140624,a1501,20140624,4526,4529,4516,4520,4497,4504,4505,-25,-24,101040,4552274380,303704 
 20140625,a1501,20140625,4504,4505,4501,4515,4477,4490,4496,-15,-9,99544,4476195160,301126 
 20140626,a1501,20140626,4490,4496,4485,4494,4479,4484,4485,-12,-11,42378,1900928500,299478 
 20140627,a1501,20140627,4484,4485,4496,4510,4473,4476,4487,-9,2,88406,3967617580,295652 
 20140630,a1501,20140630,4476,4487,4463,4482,4451,4452,4465,-35,-22,62762,2802402700,294504 
 20140701,a1501,20140701,4452,4465,4310,4386,4309,4355,4347,-110,-118,254722,11074080320,244828 
 20140702,a1501,20140702,4355,4347,4376,4381,4337,4363,4361,16,14,91562,3993674920,245554 
 20140703,a1501,20140703,4363,4361,4331,4365,4331,4355,4353,-6,-8,57364,2497314880,246846 
 20140704,a1501,20140704,4355,4353,4344,4354,4323,4323,4336,-30,-17,47514,2060282940,243884 
 20140707,a1501,20140707,4323,4336,4327,4333,4300,4314,4311,-22,-25,60892,2625501040,243604 
 20140708,a1501,20140708,4314,4311,4315,4397,4310,4361,4367,50,56,213486,9324399840,253456 
 20140709,a1501,20140709,4361,4367,4352,4372,4320,4329,4347,-38,-20,89698,3899231600,245380 
 20140710,a1501,20140710,4329,4347,4320,4335,4312,4328,4325,-19,-22,57846,2502215420,242026 
 20140711,a1501,20140711,4328,4325,4324,4345,4297,4331,4321,6,-4,80790,3491259860,238530 
 20140714,a1501,20140714,4331,4321,4300,4344,4267,4343,4315,22,-6,106172,4582264600,240818 
 20140715,a1501,20140715,4343,4315,4343,4354,4323,4333,4337,18,22,47922,2078742580,233892 
 20140716,a1501,20140716,4333,4337,4341,4351,4335,4340,4342,3,5,54076,2348204880,230072 
 20140717,a1501,20140717,4340,4342,4340,4348,4328,4329,4336,-13,-6,39370,1707200300,226600 
 20140718,a1501,20140718,4329,4336,4330,4347,4312,4323,4328,-13,-8,65052,2815556840,226880 
 20140721,a1501,20140721,4323,4328,4316,4339,4301,4316,4322,-12,-6,66478,2873224020,232196 
 20140722,a1501,20140722,4316,4322,4316,4361,4303,4358,4336,36,14,112618,4883180920,238494 
 20140723,a1501,20140723,4358,4336,4345,4388,4338,4338,4361,2,25,148686,6484378720,223866 
 20140724,a1501,20140724,4338,4361,4362,4369,4334,4349,4352,-12,-9,67942,2957455300,222326 
 20140725,a1501,20140725,4349,4352,4348,4361,4333,4343,4346,-9,-6,50262,2184634020,219758 
 20140728,a1501,20140728,4343,4346,4360,4405,4353,4399,4379,53,33,96442,4223524940,218642 
 20140729,a1501,20140729,4399,4379,4415,4449,4410,4422,4428,43,49,121862,5396348680,213612 
 20140730,a1501,20140730,4422,4428,4406,4420,4374,4419,4399,-9,-29,59920,2636152380,212502 
 20140731,a1501,20140731,4419,4399,4410,4454,4403,4442,4428,43,29,74146,3283378560,215400 
 20140801,a1501,20140801,4442,4428,4440,4474,4424,4470,4451,42,23,138422,6161212260,231502 
 20140804,a1501,20140804,4470,4451,4467,4531,4463,4527,4497,76,46,314108,14128007380,286782 
 20140805,a1501,20140805,4527,4497,4523,4557,4515,4551,4539,54,42,204292,9273118700,293956 
 20140806,a1501,20140806,4551,4539,4544,4547,4525,4532,4533,-7,-6,111270,5044505300,299114 
 20140807,a1501,20140807,4532,4533,4546,4555,4512,4522,4527,-11,-6,131870,5970709860,302094 
 20140808,a1501,20140808,4522,4527,4512,4555,4512,4547,4539,20,12,128248,5821439580,314566 
 20140811,a1501,20140811,4547,4539,4547,4584,4547,4579,4571,40,32,143236,6548356620,321090 
 20140812,a1501,20140812,4579,4571,4577,4592,4558,4568,4573,-3,2,162298,7422354040,311636 
 20140813,a1501,20140813,4568,4573,4565,4637,4562,4633,4610,60,37,281030,12957259940,337070 
 20140814,a1501,20140814,4633,4610,4630,4652,4523,4576,4593,-34,-17,602736,27689316800,324224 
 20140815,a1501,20140815,4576,4593,4585,4608,4568,4607,4592,14,-1,259398,11913039800,351936 
 20140818,a1501,20140818,4607,4592,4609,4610,4572,4598,4588,6,-4,160944,7384279300,353538 
 20140819,a1501,20140819,4598,4588,4597,4601,4539,4558,4560,-30,-28,280634,12797041100,351764 
 20140820,a1501,20140820,4558,4560,4560,4565,4514,4533,4530,-27,-30,237926,10779815540,358274 
 20140821,a1501,20140821,4533,4530,4523,4537,4480,4490,4497,-40,-33,242250,10895013640,363910 
 20140822,a1501,20140822,4490,4497,4491,4533,4476,4512,4514,15,17,197850,8932563460,368816 
 20140825,a1501,20140825,4512,4514,4515,4520,4488,4520,4502,6,-12,117524,5291683940,369242 
 20140826,a1501,20140826,4520,4502,4513,4606,4503,4601,4554,99,52,335972,15301819640,413680 
 20140827,a1501,20140827,4601,4554,4605,4620,4582,4614,4601,60,47,397860,18306565240,434776 
 20140828,a1501,20140828,4614,4601,4610,4619,4571,4586,4593,-15,-8,442312,20315774980,421648 
 20140829,a1501,20140829,4586,4593,4592,4610,4575,4583,4591,-10,-2,316458,14529840960,419718 
 20140901,a1501,20140901,4583,4591,4585,4604,4580,4597,4591,6,0,219006,10054600620,420648 
 20140902,a1501,20140902,4597,4591,4596,4646,4595,4624,4627,33,36,453346,20979620280,439828 
 20140903,a1501,20140903,4624,4627,4624,4638,4607,4612,4621,-15,-6,225026,10398567660,443136 
 20140904,a1501,20140904,4612,4621,4603,4605,4562,4564,4584,-57,-37,251980,11550955700,432488 
 20140905,a1501,20140905,4564,4584,4564,4590,4547,4581,4568,-3,-16,279380,12764101460,425016 
 20140909,a1501,20140909,4581,4568,4566,4606,4530,4538,4567,-30,-1,298960,13655103560,417466 
 20140910,a1501,20140910,4538,4567,4521,4555,4508,4554,4532,-13,-35,211294,9576131960,418302 
 20140911,a1501,20140911,4554,4532,4547,4560,4515,4533,4531,1,-1,201686,9140200040,415928 
 20140912,a1501,20140912,4533,4531,4525,4624,4518,4619,4585,88,54,495514,22722907740,474342 
 20140915,a1501,20140915,4619,4585,4605,4641,4588,4614,4617,29,32,519754,23999301340,522906 
 20140916,a1501,20140916,4614,4617,4617,4799,4593,4623,4649,6,32,899650,41825212700,484712 
 20140917,a1501,20140917,4623,4649,4616,4646,4604,4640,4627,-9,-22,320854,14847716360,490440 
 20140918,a1501,20140918,4640,4627,4645,4666,4605,4624,4620,-3,-7,260914,12056446360,482470 
 20140919,a1501,20140919,4624,4620,4605,4626,4574,4581,4598,-39,-22,348968,16047669900,457328 
 20140922,a1501,20140922,4581,4598,4563,4578,4512,4551,4550,-47,-48,520754,23694827800,421810 
 20140923,a1501,20140923,4551,4550,4535,4550,4503,4520,4532,-30,-18,357652,16210970720,387130 
 20140924,a1501,20140924,4520,4532,4530,4576,4508,4543,4546,11,14,311020,14141687540,397468 
 20140925,a1501,20140925,4543,4546,4554,4604,4552,4579,4578,33,32,278708,12760699260,383828 
 20140926,a1501,20140926,4579,4578,4565,4622,4553,4592,4582,14,4,318316,14586768760,381754 
 20140929,a1501,20140929,4592,4582,4598,4647,4574,4588,4600,6,18,211150,9714661420,360030 
 20140930,a1501,20140930,4588,4600,4610,4616,4567,4574,4589,-26,-11,155444,7133629120,330918 
 20141008,a1501,20141008,4574,4589,4599,4600,4528,4542,4547,-47,-42,198398,9021778000,325256 
 20141009,a1501,20141009,4542,4547,4548,4564,4523,4530,4543,-17,-4,218458,9926224020,339376 
 20141010,a1501,20141010,4530,4543,4518,4542,4398,4410,4457,-133,-86,611918,27273995120,365902 
 20141013,a1501,20141013,4410,4457,4410,4444,4353,4389,4394,-68,-63,559030,24569040700,416864 
 20141014,a1501,20141014,4389,4394,4425,4458,4395,4415,4422,21,28,520802,23031781780,371782 
 20141015,a1501,20141015,4415,4422,4423,4450,4384,4439,4427,17,5,245714,10878017820,368204 
 20141016,a1501,20141016,4439,4427,4420,4455,4398,4435,4428,8,1,264886,11731212080,376164 
 20141017,a1501,20141017,4435,4428,4454,4480,4437,4456,4453,28,25,184252,8206282400,371984 
 20141020,a1501,20141020,4456,4453,4446,4449,4377,4437,4412,-16,-41,335924,14821512280,374856 
 20141021,a1501,20141021,4437,4412,4448,4498,4437,4477,4476,65,64,276024,12355536520,367810 
 20141022,a1501,20141022,4477,4476,4492,4511,4462,4481,4480,5,4,163544,7327777280,369036 
 20141023,a1501,20141023,4481,4480,4466,4490,4445,4485,4472,5,-8,163670,7319459120,372776 
 20141024,a1501,20141024,4485,4472,4510,4550,4498,4500,4520,28,48,252084,11395214940,357020 
 20141027,a1501,20141027,4500,4520,4474,4495,4464,4490,4481,-30,-39,123708,5543631580,366066 
 20141028,a1501,20141028,4490,4481,4530,4535,4462,4465,4495,-16,14,174932,7863693120,363268 
 20141029,a1501,20141029,4465,4495,4468,4498,4462,4485,4478,-10,-17,134674,6031748940,358524 
 20141030,a1501,20141030,4485,4478,4521,4526,4486,4509,4507,31,29,174892,7883017160,354020 
 20141031,a1501,20141031,4509,4507,4499,4610,4495,4604,4572,97,65,341324,15608120520,362796 
 20141103,a1501,20141103,4604,4572,4600,4620,4568,4568,4591,-4,19,180384,8281992460,345060 
 20141104,a1501,20141104,4568,4591,4562,4590,4553,4569,4573,-22,-18,141306,6463331780,336454 
 20141105,a1501,20141105,4569,4573,4560,4596,4557,4574,4581,1,8,164244,7524275700,342778 
 20141106,a1501,20141106,4574,4581,4587,4609,4483,4533,4529,-48,-52,425150,19257875540,352450 
 20141107,a1501,20141107,4533,4529,4548,4585,4547,4578,4571,49,42,185108,8462762960,359548 
 20141110,a1501,20141110,4578,4571,4592,4594,4552,4571,4566,0,-5,147712,6745838960,366154 
 20141111,a1505,20141111,4343,4339,4322,4336,4270,4290,4302,-49,-37,177476,7635497160,292422 
 20141112,a1501,20141112,4557,4555,4592,4592,4485,4499,4549,-56,-6,237954,10825625280,331882 
 20141113,a1501,20141113,4499,4549,4493,4538,4480,4519,4510,-30,-39,175070,7897236320,330000 
 20141114,a1505,20141114,4317,4298,4305,4348,4302,4338,4328,40,30,171154,7408554980,276604 
 20141117,a1501,20141117,4521,4513,4510,4531,4503,4520,4520,7,7,86710,3919839840,307794 
 20141118,a1505,20141118,4328,4331,4335,4344,4294,4318,4310,-13,-21,106410,4586713200,267938 
 20141119,a1505,20141119,4318,4310,4306,4315,4283,4290,4295,-20,-15,88184,3787969260,271866 
 20141120,a1505,20141120,4290,4295,4221,4314,4221,4304,4284,9,-11,124474,5333530560,271416 
 20141121,a1505,20141121,4304,4284,4311,4328,4303,4319,4314,35,30,77886,3360612180,269294 
 20141124,a1501,20141124,4529,4528,4539,4541,4456,4465,4488,-63,-40,171752,7708386480,282434 
 20141125,a1505,20141125,4274,4294,4273,4281,4236,4266,4259,-28,-35,149010,6346383180,299232 
 20141126,a1505,20141126,4266,4259,4270,4270,4241,4250,4254,-9,-5,117092,4981684700,308486 
 20141127,a1505,20141127,4250,4254,4250,4316,4243,4306,4280,52,26,160860,6886374160,299938 
 20141128,a1505,20141128,4306,4280,4296,4324,4286,4318,4309,38,29,133104,5735777900,291262 
 20141201,a1505,20141201,4318,4309,4284,4311,4268,4303,4296,-6,-13,97256,4179074000,292962 
 20141202,a1505,20141202,4303,4296,4315,4350,4288,4300,4311,4,15,108916,4695727920,292774 
 20141203,a1505,20141203,4300,4311,4272,4306,4270,4299,4290,-12,-21,143294,6148597720,312348 
 20141204,a1505,20141204,4299,4290,4301,4334,4295,4314,4317,24,27,143682,6203267740,315880 
 20141205,a1505,20141205,4314,4317,4319,4403,4315,4392,4373,75,56,282552,12358377920,326132 
 20141208,a1505,20141208,4392,4373,4405,4410,4361,4382,4382,9,9,129220,5663398380,322080 
 20141209,a1505,20141209,4382,4382,4390,4390,4347,4350,4360,-32,-22,111014,4840602840,308612 
 20141210,a1505,20141210,4350,4360,4359,4394,4340,4381,4375,21,15,125172,5477440420,297768 
 20141211,a1505,20141211,4381,4375,4362,4383,4346,4368,4367,-7,-8,92628,4045865120,284794 
 20141212,a1505,20141212,4368,4367,4371,4387,4358,4364,4371,-3,4,65790,2876013900,278470 
 20141215,a1505,20141215,4364,4371,4361,4375,4350,4361,4364,-10,-7,57276,2500073900,272014 
 20141216,a1505,20141216,4361,4364,4350,4357,4311,4322,4324,-42,-40,109512,4735697040,265180 
 20141217,a1505,20141217,4322,4324,4317,4339,4305,4310,4317,-14,-7,64892,2801756560,261686 
 20141218,a1505,20141218,4310,4317,4313,4326,4287,4313,4309,-4,-8,82930,3573516860,256616 
 20141219,a1505,20141219,4313,4309,4320,4343,4306,4336,4328,27,19,84034,3637254700,249500 
 20141222,a1505,20141222,4336,4328,4335,4339,4317,4322,4326,-6,-2,58574,2534080300,249476 
 20141223,a1505,20141223,4322,4326,4332,4369,4308,4326,4345,0,19,111794,4858398020,244120 
 20141224,a1505,20141224,4326,4345,4327,4395,4309,4388,4346,43,1,193040,8389666060,254934 
 20141225,a1505,20141225,4388,4346,4390,4440,4380,4434,4408,88,62,208920,9211197620,272536 
 20141226,a1505,20141226,4434,4408,4435,4457,4423,4453,4441,45,33,124316,5521019000,270598 
 20141229,a1505,20141229,4453,4441,4449,4534,4437,4527,4504,86,63,408206,18386613580,279082 
 20141230,a1505,20141230,4527,4504,4518,4538,4501,4515,4517,11,13,161422,7292021060,271798 
 20141231,a1505,20141231,4515,4517,4510,4527,4486,4510,4505,-7,-12,133694,6023239840,258734 
 20150105,a1505,20150105,4510,4505,4488,4504,4446,4497,4486,-8,-19,72400,3248361220,257298 
 20150106,a1505,20150106,4497,4486,4500,4548,4486,4503,4514,17,28,176706,7977943480,257146 
 20150107,a1505,20150107,4503,4514,4514,4528,4480,4505,4503,-9,-11,102236,4604083940,259540 
 20150108,a1505,20150108,4505,4503,4510,4524,4490,4503,4508,0,5,93610,4220490960,258778 
 20150109,a1505,20150109,4503,4508,4508,4519,4486,4509,4502,1,-6,106146,4779244560,257520 
 20150112,a1505,20150112,4509,4502,4511,4538,4497,4510,4521,8,19,134590,6084913440,256854 
 20150113,a1505,20150113,4510,4521,4501,4504,4465,4483,4482,-38,-39,116956,5242181380,246092 
 20150114,a1505,20150114,4483,4482,4485,4487,4452,4467,4469,-15,-13,96432,4310197200,246202 
 20150115,a1505,20150115,4467,4469,4456,4504,4456,4497,4482,28,13,96184,4311249760,247480 
 20150116,a1505,20150116,4497,4482,4495,4522,4470,4506,4494,24,12,115612,5195739760,242850 
 20150119,a1505,20150119,4506,4494,4514,4518,4475,4496,4497,2,3,105682,4753200120,239272 
 20150120,a1505,20150120,4496,4497,4500,4515,4457,4458,4478,-39,-19,88182,3949372360,233202 
 20150121,a1505,20150121,4458,4478,4457,4496,4408,4460,4456,-18,-22,155502,6929374760,219656 
 20150122,a1505,20150122,4460,4456,4452,4472,4434,4441,4453,-15,-3,71814,3198444140,215952 
 20150123,a1505,20150123,4441,4453,4445,4454,4416,4426,4432,-27,-21,56848,2519627520,210796 
 20150126,a1505,20150126,4426,4432,4421,4445,4391,4391,4414,-41,-18,82258,3630911060,209592 
 20150127,a1505,20150127,4391,4414,4395,4465,4393,4440,4429,26,15,65310,2892932700,203284 
 20150128,a1505,20150128,4440,4429,4440,4450,4412,4418,4430,-11,1,49192,2179404040,203628 
 20150129,a1505,20150129,4418,4430,4415,4421,4350,4364,4371,-66,-59,212272,9279981680,209296 
 20150130,a1505,20150130,4364,4371,4355,4386,4340,4349,4366,-22,-5,97866,4273338120,203100 
 20150202,a1505,20150202,4349,4366,4350,4408,4349,4403,4382,37,16,112488,4929467000,194300 
 20150203,a1505,20150203,4403,4382,4403,4436,4403,4433,4421,51,39,90338,3994318620,184900 
 20150204,a1505,20150204,4433,4421,4438,4455,4409,4413,4431,-8,10,72228,3200637660,179178 
 20150205,a1505,20150205,4413,4431,4411,4425,4380,4417,4406,-14,-25,67152,2958896400,175700 
 20150206,a1505,20150206,4417,4406,4426,4436,4412,4433,4423,27,17,43952,1944338660,178198 
 20150209,a1505,20150209,4433,4423,4437,4440,4384,4415,4405,-8,-18,75788,3338863760,175166 
 20150210,a1505,20150210,4415,4405,4403,4427,4398,4404,4411,-1,6,37656,1661164560,175410 
 20150211,a1505,20150211,4404,4411,4402,4413,4394,4406,4403,-5,-8,27402,1206588300,174202 
 20150212,a1505,20150212,4406,4403,4411,4431,4395,4412,4416,9,13,42358,1870620180,172010 
 20150213,a1505,20150213,4412,4416,4404,4433,4402,4409,4418,-7,2,55144,2436523200,166090 
 20150216,a1505,20150216,4409,4418,4414,4415,4356,4367,4377,-51,-41,86658,3793866460,151852 
 20150217,a1505,20150217,4367,4377,4361,4377,4361,4367,4369,-10,-8,24642,1076837680,149446 
 20150225,a1505,20150225,4367,4369,4381,4388,4284,4287,4321,-82,-48,72532,3134379160,153108 
 20150226,a1505,20150226,4287,4321,4286,4290,4230,4284,4268,-37,-53,122612,5233807500,162036 
 20150227,a1505,20150227,4284,4268,4285,4339,4251,4317,4302,49,34,107898,4642308580,155760 
 20150302,a1505,20150302,4317,4302,4322,4330,4265,4272,4292,-30,-10,102046,4380122820,172618 
 20150303,a1505,20150303,4272,4292,4253,4292,4250,4280,4275,-12,-17,86130,3682768900,170542 
 20150304,a1505,20150304,4280,4275,4273,4287,4263,4280,4274,5,-1,43144,1844343200,169030 
 20150305,a1505,20150305,4280,4274,4273,4279,4171,4179,4216,-95,-58,153078,6454254960,197828 
 20150306,a1505,20150306,4179,4216,4178,4194,4161,4172,4179,-44,-37,70410,2943059280,193814 
 20150309,a1505,20150309,4172,4179,4180,4218,4154,4193,4188,14,9,82488,3455033180,184668 
 20150310,a1505,20150310,4193,4188,4188,4205,4115,4119,4152,-69,-36,105646,4386803560,204018 
 20150311,a1505,20150311,4119,4152,4129,4200,4106,4184,4169,32,17,148358,6186247140,183226 
 20150312,a1505,20150312,4184,4169,4190,4190,4157,4170,4173,1,4,40778,1701917000,181136 
 20150313,a1505,20150313,4170,4173,4166,4185,4152,4154,4169,-19,-4,42586,1775554040,179448 
 20150316,a1505,20150316,4154,4169,4155,4183,4141,4180,4162,11,-7,47218,1965363800,175256 
 20150317,a1505,20150317,4180,4162,4177,4228,4166,4169,4192,7,30,67066,2811474940,172268 
 20150318,a1505,20150318,4169,4192,4161,4192,4161,4170,4173,-22,-19,70052,2923756800,168440 
 20150319,a1505,20150319,4170,4173,4181,4189,4151,4177,4173,4,0,72930,3043376420,163540 
 20150320,a1505,20150320,4177,4173,4175,4194,4148,4174,4168,1,-5,74576,3108439140,166846 
 20150323,a1505,20150323,4174,4168,4175,4197,4160,4164,4179,-4,11,55042,2300727440,174834 
 20150324,a1505,20150324,4164,4179,4166,4191,4111,4161,4151,-18,-28,134338,5576885080,173996 
 20150325,a1505,20150325,4161,4151,4161,4161,4070,4074,4109,-77,-42,139516,5733284520,180834 
 20150326,a1505,20150326,4074,4109,4074,4090,4004,4060,4044,-49,-65,219736,8887018760,187800 
 20150327,a1505,20150327,4060,4044,4053,4058,4027,4032,4043,-12,-1,71974,2910423160,184748 
 20150330,a1505,20150330,4032,4043,4031,4043,3985,4028,4005,-15,-38,100360,4019740540,186212 
 20150331,a1505,20150331,4028,4005,4020,4031,4008,4016,4019,11,14,45186,1816067140,177466 
 20150401,a1505,20150401,4016,4019,4010,4058,4005,4035,4034,16,15,103478,4174550680,167666 
 20150402,a1509,20150402,4132,4134,4139,4152,4102,4102,4126,-32,-8,47784,1971941840,124314 
 20150403,a1505,20150403,4019,4033,4001,4019,3959,3998,3995,-35,-38,97128,3880768920,153460 
 20150407,a1509,20150407,4084,4081,4078,4092,4041,4043,4058,-38,-23,46884,1902902000,147266 
 20150408,a1509,20150408,4043,4058,4020,4043,4011,4027,4026,-31,-32,69238,2787807700,154046 
 20150409,a1509,20150409,4027,4026,4030,4035,3991,3995,4009,-31,-17,72656,2913117920,161072 
 20150410,a1509,20150410,3995,4009,3992,4038,3992,4006,4010,-3,1,61318,2459252360,155070 
 20150413,a1509,20150413,4006,4010,4014,4057,4005,4048,4032,38,22,101382,4088592800,145654 
 20150414,a1509,20150414,4048,4032,4045,4096,4040,4085,4069,53,37,141336,5751788700,165560 
 20150415,a1509,20150415,4085,4069,4089,4131,4078,4098,4102,29,33,138756,5692921680,153606 
 20150416,a1505,20150416,4220,4216,4222,4261,4198,4210,4226,-6,10,72658,3070810920,139332 
 20150417,a1509,20150417,4092,4099,4099,4099,4038,4040,4065,-59,-34,171152,6958920580,184052 
 20150420,a1509,20150420,4040,4065,4038,4059,3966,4000,4005,-65,-60,387608,15525899800,194694 
 20150421,a1509,20150421,4000,4005,3996,4069,3983,4060,4037,55,32,177818,7180137140,197532 
 20150422,a1509,20150422,4060,4037,4060,4181,4054,4160,4108,123,71,290722,11945633700,197214 
 20150423,a1509,20150423,4160,4108,4152,4179,4124,4154,4151,46,43,177206,7356350100,197462 
 20150424,a1509,20150424,4154,4151,4168,4218,4152,4217,4191,66,40,229592,9622915680,205414 
 20150427,a1509,20150427,4217,4191,4217,4250,4194,4226,4221,35,30,205434,8673090140,195272 
 20150428,a1509,20150428,4226,4221,4226,4235,4190,4220,4218,-1,-3,115740,4882635260,189742 
 20150429,a1509,20150429,4220,4218,4228,4238,4209,4225,4222,7,4,91586,3867487320,185758 
 20150430,a1509,20150430,4225,4222,4223,4335,4221,4320,4296,98,74,257472,11062435060,189604 
 20150504,a1509,20150504,4320,4296,4302,4308,4256,4272,4272,-24,-24,123328,5269786400,170686 
 20150505,a1509,20150505,4272,4272,4272,4296,4232,4272,4273,0,1,105224,4496442380,161102 
 20150506,a1509,20150506,4272,4273,4277,4331,4261,4306,4296,33,23,127526,5479352740,158448 
 20150507,a1509,20150507,4306,4296,4307,4315,4265,4293,4291,-3,-5,86592,3716475740,157760 
 20150508,a1509,20150508,4293,4291,4293,4298,4243,4280,4268,-11,-23,104380,4455877220,157466 
 20150511,a1509,20150511,4280,4268,4287,4365,4272,4362,4330,94,62,209584,9075482940,175828 
 20150512,a1509,20150512,4362,4330,4352,4386,4343,4361,4360,31,30,157564,6870039380,175470 
 20150513,a1509,20150513,4361,4360,4366,4377,4344,4367,4362,7,2,129932,5667963600,172936 
 20150514,a1509,20150514,4367,4362,4375,4382,4321,4359,4351,-3,-11,114750,4993419360,165500 
 20150515,a1509,20150515,4359,4351,4360,4374,4351,4362,4359,11,8,70112,3056848300,163424 
 20150518,a1509,20150518,4362,4359,4361,4369,4335,4358,4352,-1,-7,78180,3402702680,160410 
 20150519,a1509,20150519,4358,4352,4367,4367,4321,4322,4342,-30,-10,70084,3043075480,157178 
 20150520,a1509,20150520,4322,4342,4320,4329,4270,4295,4295,-47,-47,139968,6012170540,147242 
 20150521,a1509,20150521,4295,4295,4295,4328,4275,4295,4305,0,10,100330,4319777720,140030 
 20150522,a1509,20150522,4295,4305,4295,4475,4289,4447,4393,142,88,339348,14909064640,169896 
 20150525,a1509,20150525,4447,4393,4447,4463,4402,4416,4431,23,38,236628,10486847920,160274 
 20150526,a1509,20150526,4416,4431,4426,4450,4406,4415,4424,-16,-7,117050,5179161320,158210 
 20150527,a1509,20150527,4415,4424,4406,4424,4371,4388,4395,-36,-29,121044,5320807480,147186 
 20150528,a1509,20150528,4388,4395,4392,4440,4377,4393,4411,-2,16,137656,6072178420,145280 
 20150529,a1509,20150529,4393,4411,4400,4412,4372,4409,4390,-2,-21,83516,3666602720,142738 
 20150601,a1509,20150601,4409,4390,4412,4419,4308,4323,4370,-67,-20,129076,5641852420,140206 
 20150602,a1509,20150602,4323,4370,4325,4370,4321,4351,4344,-19,-26,87606,3805608560,132726 
 20150603,a1509,20150603,4351,4344,4359,4387,4349,4360,4366,16,22,77534,3385903160,130696 
 20150604,a1509,20150604,4360,4366,4357,4365,4302,4327,4329,-39,-37,90724,3928068500,124978 
 20150605,a1509,20150605,4327,4329,4322,4337,4252,4256,4293,-73,-36,92178,3957368000,122172 
 20150608,a1509,20150608,4256,4293,4251,4284,4240,4248,4263,-45,-30,76236,3250578880,119098 
 20150609,a1509,20150609,4248,4263,4251,4295,4244,4246,4272,-17,9,85082,3634933860,116982 
 20150610,a1509,20150610,4246,4272,4250,4272,4240,4262,4257,-10,-15,68302,2907873320,113828 
 20150611,a1509,20150611,4262,4257,4275,4284,4245,4256,4264,-1,7,61360,2616977080,114468 
 20150612,a1509,20150612,4256,4264,4245,4260,4147,4162,4190,-102,-74,169804,7115904760,98898 
 20150615,a1509,20150615,4162,4190,4176,4190,4141,4148,4165,-42,-25,72524,3021142780,90668 
 20150616,a1509,20150616,4148,4165,4145,4218,4135,4193,4184,28,19,93544,3914474660,75454 
 20150617,a1509,20150617,4193,4184,4195,4255,4164,4244,4221,60,37,98140,4143280160,71322 
 20150618,a1509,20150618,4244,4221,4238,4295,4236,4250,4263,29,42,101838,4341486940,65562 
 20150619,a1509,20150619,4250,4263,4250,4260,4206,4237,4231,-26,-32,75214,3183013520,66814 
 20150623,a1509,20150623,4237,4231,4250,4290,4249,4264,4265,33,34,58438,2492752600,70724 
 20150624,a1509,20150624,4264,4265,4252,4262,4208,4226,4230,-39,-35,77402,3274204120,68640 
 20150625,a1509,20150625,4226,4230,4233,4257,4207,4221,4229,-9,-1,55178,2333727580,67324 
 20150626,a1509,20150626,4221,4229,4233,4258,4182,4191,4225,-38,-4,94360,3986762560,64146 
 20150629,a1509,20150629,4191,4225,4212,4227,4151,4173,4178,-52,-47,87582,3660038220,62754 
 20150630,a1509,20150630,4173,4178,4173,4188,4130,4136,4153,-42,-25,64084,2661810760,57012 
 20150701,a1509,20150701,4136,4153,4137,4244,4106,4174,4179,21,26,112474,4700553500,61480 
 20150702,a1509,20150702,4174,4179,4174,4180,4138,4154,4155,-25,-24,51470,2138754000,51868 
 20150703,a1509,20150703,4154,4155,4151,4163,4125,4131,4146,-24,-9,52506,2177098500,55808 
 20150706,a1509,20150706,4131,4146,4140,4140,4057,4077,4096,-69,-50,68748,2816378480,52860 
 20150707,a1509,20150707,4077,4096,4093,4093,4040,4053,4060,-43,-36,54192,2200579740,50100 
 20150708,a1509,20150708,4053,4060,4053,4053,3898,3910,3943,-150,-117,134730,5312618600,41974 
 20150709,a1509,20150709,3910,3943,3923,4100,3910,4100,4032,157,89,109362,4410319660,36840 
 20150710,a1509,20150710,4100,4032,4116,4240,4115,4198,4196,166,164,146080,6130215400,42724 
 20150713,a1601,20150713,4265,4251,4269,4290,4222,4261,4253,10,2,81614,3471441760,112206 
 20150714,a1601,20150714,4261,4253,4253,4294,4236,4269,4269,16,16,88602,3782884140,114890 
 20150715,a1601,20150715,4269,4269,4267,4275,4214,4230,4247,-39,-22,53104,2255795380,115898 
 20150716,a1601,20150716,4230,4247,4225,4236,4142,4206,4189,-41,-58,84654,3546258260,116106 
 20150717,a1601,20150717,4206,4189,4208,4243,4174,4202,4207,13,18,72928,3068513640,117994 
 20150720,a1601,20150720,4202,4207,4191,4214,4124,4147,4168,-60,-39,58284,2429730860,116700 
 20150721,a1601,20150721,4147,4168,4141,4178,4136,4147,4154,-21,-14,47456,1971714300,118158 
 20150722,a1601,20150722,4147,4154,4146,4156,4101,4141,4130,-13,-24,73762,3046641220,123154 
 20150723,a1601,20150723,4141,4130,4129,4164,4105,4150,4133,20,3,103328,4271276360,126258 
 20150724,a1601,20150724,4150,4133,4151,4187,4137,4163,4162,30,29,94288,3924709460,127696 
 20150727,a1601,20150727,4163,4162,4158,4177,4119,4127,4146,-35,-16,83930,3480349380,135142 
 20150728,a1601,20150728,4127,4146,4121,4173,4074,4170,4124,24,-22,139216,5741975440,129064 
 20150729,a1601,20150729,4170,4124,4179,4238,4170,4234,4212,110,88,153390,6461039860,125886 
 20150730,a1601,20150730,4234,4212,4234,4278,4220,4232,4249,20,37,170986,7266010400,125398 
 20150731,a1601,20150731,4232,4249,4245,4260,4227,4248,4243,-1,-6,128384,5448229180,127492 
 20150803,a1601,20150803,4248,4243,4255,4267,4186,4222,4230,-21,-13,122470,5180560260,127732 
 20150804,a1601,20150804,4222,4230,4225,4257,4201,4255,4241,25,11,125318,5315009900,132580 
 20150805,a1601,20150805,4255,4241,4260,4270,4231,4249,4251,8,10,91916,3907597980,133980 
 20150806,a1601,20150806,4249,4251,4265,4345,4252,4331,4300,80,49,246188,10586400300,153382 
 20150807,a1601,20150807,4331,4300,4330,4347,4283,4325,4313,25,13,187696,8097113060,154042 
 20150810,a1601,20150810,4325,4313,4313,4381,4313,4361,4350,48,37,149176,6489405280,161470 
 20150811,a1601,20150811,4361,4350,4355,4396,4351,4379,4379,29,29,139000,6087922100,160636 
 20150812,a1601,20150812,4379,4379,4367,4392,4352,4388,4372,9,-7,99746,4361866620,155758 
 20150813,a1601,20150813,4388,4372,4402,4420,4299,4344,4358,-28,-14,171362,7468624380,146682 
 20150814,a1601,20150814,4344,4358,4337,4375,4333,4359,4354,1,-4,88358,3847642480,148494 
 20150817,a1601,20150817,4359,4354,4355,4396,4347,4372,4372,18,18,86388,3777535400,150500 
 20150818,a1601,20150818,4372,4372,4374,4394,4312,4313,4358,-59,-14,127630,5562340060,149878 
 20150819,a1601,20150819,4313,4358,4316,4343,4292,4325,4315,-33,-43,149810,6465687800,139240 
 20150820,a1601,20150820,4325,4315,4331,4340,4259,4279,4299,-36,-16,131020,5632764300,138608 
 20150821,a1601,20150821,4279,4299,4277,4315,4269,4281,4292,-18,-7,114694,4923281420,132990 
 20150824,a1601,20150824,4281,4292,4278,4284,4172,4197,4225,-95,-67,166944,7054649040,127524 
 20150825,a1601,20150825,4197,4225,4175,4245,4156,4210,4208,-15,-17,135454,5700851440,122334 
 20150826,a1601,20150826,4210,4208,4242,4270,4196,4204,4229,-4,21,102434,4332819640,117352 
 20150827,a1601,20150827,4204,4229,4210,4229,4166,4219,4203,-10,-26,124986,5253409540,115836 
 20150828,a1601,20150828,4219,4203,4218,4265,4141,4156,4195,-47,-8,273034,11454130240,144090 
 20150831,a1601,20150831,4156,4195,4148,4191,4130,4160,4159,-35,-36,180586,7512155160,141276 
 20150901,a1601,20150901,4160,4159,4158,4199,4145,4181,4182,22,23,138606,5796870360,135294 
 20150902,a1601,20150902,4181,4182,4170,4203,4162,4189,4185,7,3,97438,4078467140,132080 
 20150907,a1601,20150907,4189,4185,4180,4188,4125,4128,4144,-57,-41,87746,3636526100,143656 
 20150908,a1601,20150908,4128,4144,4126,4155,4094,4147,4122,3,-22,152362,6281469580,140366 
 20150909,a1601,20150909,4147,4122,4157,4173,4121,4123,4148,1,26,133404,5534819580,143374 
 20150910,a1601,20150910,4123,4148,4120,4165,4111,4158,4138,10,-10,122668,5076785760,138428 
 20150911,a1601,20150911,4158,4138,4142,4198,4133,4170,4170,32,32,116204,4846605800,132208 
 20150914,a1601,20150914,4170,4170,4169,4186,4141,4144,4168,-26,-2,92810,3868890220,132074 
 20150915,a1601,20150915,4144,4168,4143,4175,4134,4139,4158,-29,-10,106860,4444105980,127894 
 20150916,a1601,20150916,4139,4158,4139,4168,4115,4165,4136,7,-22,123058,5089919880,123148 
 20150917,a1601,20150917,4165,4136,4165,4172,4145,4150,4158,14,22,81576,3392169040,121674 
 20150918,a1601,20150918,4150,4158,4142,4169,4122,4128,4146,-30,-12,99056,4107809640,126840 
 20150921,a1601,20150921,4128,4146,4124,4136,4048,4099,4083,-47,-63,173326,7077173520,136054 
 20150922,a1601,20150922,4099,4083,4099,4108,4056,4071,4078,-12,-5,112778,4599762980,137266 
 20150923,a1601,20150923,4071,4078,4057,4074,4032,4064,4053,-14,-25,100340,4067465480,135406 
 20150924,a1601,20150924,4064,4053,4065,4083,4037,4045,4056,-8,3,99952,4054741420,136174 
 20150925,a1601,20150925,4045,4056,4039,4065,3997,4027,4035,-29,-21,208118,8399300520,131620 
 20150928,a1601,20150928,4027,4035,4047,4055,4007,4014,4024,-21,-11,51964,2091177300,132856 
 20150929,a1601,20150929,4014,4024,4014,4075,3982,4073,4034,49,10,167052,6740081240,126916 
 20150930,a1601,20150930,4073,4034,4079,4097,4041,4047,4066,13,32,134822,5482954100,115326 
 20151008,a1601,20151008,4047,4066,4056,4064,3870,3903,3946,-163,-120,289110,11408552880,153154 
 20151009,a1601,20151009,3903,3946,3898,3945,3842,3888,3889,-58,-57,572602,22271424280,154898 
 20151012,a1601,20151012,3888,3889,3897,3962,3870,3956,3916,67,27,374446,14664159800,147646 
 20151013,a1601,20151013,3956,3916,3949,3963,3923,3952,3942,36,26,281438,11094762720,148050 
 20151014,a1601,20151014,3952,3942,3952,3999,3944,3984,3973,42,31,278330,11060125360,133608 
 20151015,a1601,20151015,3984,3973,3988,3999,3962,3971,3978,-2,5,168512,6703455300,134480 
 20151016,a1601,20151016,3971,3978,3966,3969,3926,3945,3944,-33,-34,226762,8945085640,146902 
 20151019,a1601,20151019,3945,3944,3936,3954,3916,3939,3936,-5,-8,154736,6091732900,145770 
 20151020,a1601,20151020,3939,3936,3926,3951,3903,3930,3928,-6,-8,176582,6936273400,149322 
 20151021,a1601,20151021,3930,3928,3930,3946,3907,3910,3925,-18,-3,115160,4520203000,148996 
 20151022,a1601,20151022,3910,3925,3911,3983,3898,3969,3940,44,15,212442,8370864700,134004 
 20151023,a1601,20151023,3969,3940,3976,3985,3930,3965,3951,25,11,169676,6704227500,120346 
 20151026,a1601,20151026,3965,3951,3969,3975,3866,3905,3910,-46,-41,267988,10478440440,132390 
 20151027,a1601,20151027,3905,3910,3905,3913,3869,3912,3890,2,-20,167042,6498855740,128074 
 20151028,a1601,20151028,3912,3890,3908,3918,3875,3879,3894,-11,4,114280,4450839200,132162 
 20151029,a1601,20151029,3879,3894,3880,3908,3870,3885,3888,-9,-6,118276,4599361640,132096 
 20151030,a1601,20151030,3885,3888,3880,3892,3855,3881,3876,-7,-12,145762,5650110900,131102 
 20151102,a1601,20151102,3881,3876,3884,3892,3870,3875,3878,-1,2,86936,3372240940,128404 
 20151103,a1601,20151103,3875,3878,3870,3887,3860,3878,3873,0,-5,82820,3207654980,125600 
 20151104,a1601,20151104,3878,3873,3875,3898,3865,3887,3881,14,8,136458,5296052520,111242 
 20151105,a1601,20151105,3887,3881,3882,3889,3836,3876,3873,-5,-8,93480,3620831280,113132 
 20151106,a1601,20151106,3876,3873,3875,3885,3844,3884,3867,11,-6,112198,4339298800,112500 
 20151109,a1601,20151109,3884,3867,3877,3898,3850,3861,3870,-6,3,98762,3822928220,114844 
 20151110,a1601,20151110,3861,3870,3863,3867,3838,3853,3853,-17,-17,71340,2748832620,114966 
 20151111,a1601,20151111,3853,3853,3847,3879,3813,3867,3845,14,-8,108122,4157618460,109802 
 20151112,a1601,20151112,3867,3845,3867,3894,3860,3887,3876,42,31,85736,3323291580,97092 
 20151113,a1605,20151113,3861,3854,3851,3894,3850,3873,3874,19,20,71120,2755760900,139138 
 20151116,a1605,20151116,3873,3874,3854,3883,3766,3767,3817,-107,-57,119724,4570519220,162382 
 20151117,a1601,20151117,3766,3810,3780,3780,3707,3770,3745,-40,-65,158962,5954063280,80864 
 20151118,a1605,20151118,3754,3759,3756,3790,3750,3766,3770,7,11,98602,3717969160,198544 
 20151119,a1605,20151119,3766,3770,3767,3771,3670,3678,3714,-92,-56,190854,7090082760,211938 
 20151120,a1605,20151120,3678,3714,3675,3696,3650,3653,3674,-61,-40,121378,4460600920,212408 
 20151123,a1605,20151123,3653,3674,3650,3722,3642,3692,3690,18,16,189190,6982901500,220588 
 20151124,a1605,20151124,3692,3690,3696,3753,3675,3745,3722,55,32,139250,5184018120,219458 
 20151125,a1605,20151125,3745,3722,3745,3758,3703,3718,3729,-4,7,152714,5695652520,216906 
 20151126,a1605,20151126,3718,3729,3710,3775,3704,3757,3749,28,20,115274,4322138500,207178 
 20151127,a1605,20151127,3757,3749,3750,3765,3709,3727,3734,-22,-15,97476,3640260100,210150 
 20151130,a1605,20151130,3727,3734,3727,3768,3703,3758,3735,24,1,117168,4376670260,209228 
 20151201,a1605,20151201,3758,3735,3756,3782,3747,3768,3763,33,28,109872,4135238340,204566 
 20151202,a1605,20151202,3768,3763,3776,3820,3730,3744,3776,-19,13,226670,8559466740,195926 
 20151203,a1605,20151203,3744,3776,3743,3793,3717,3787,3755,11,-21,173874,6530036020,187054 
 20151204,a1605,20151204,3787,3755,3788,3808,3772,3780,3789,25,34,123458,4678477740,180952 
 20151207,a1605,20151207,3780,3789,3784,3815,3762,3799,3792,10,3,89570,3396978120,181308 
 20151208,a1605,20151208,3799,3792,3803,3803,3737,3747,3763,-45,-29,147062,5533981420,187380 
 20151209,a1605,20151209,3747,3763,3750,3755,3728,3739,3742,-24,-21,97774,3659491380,183660 
 20151210,a1605,20151210,3739,3742,3743,3749,3712,3730,3731,-12,-11,106738,3983091620,179902 
 20151211,a1605,20151211,3730,3731,3727,3738,3696,3730,3714,-1,-17,117402,4361118880,177732 
 20151214,a1605,20151214,3730,3714,3725,3743,3674,3677,3701,-37,-13,145634,5390824880,196244 
 20151215,a1605,20151215,3677,3701,3668,3689,3646,3651,3667,-50,-34,166030,6089578940,228172 
 20151216,a1605,20151216,3651,3667,3646,3695,3644,3681,3670,14,3,122280,4488771060,208500 
 20151217,a1605,20151217,3681,3670,3680,3720,3673,3700,3699,30,29,138740,5132335200,183156 
 20151218,a1605,20151218,3700,3699,3700,3730,3684,3726,3705,27,6,85408,3164592920,176864 
 20151221,a1605,20151221,3726,3705,3726,3757,3725,3749,3742,44,37,90036,3369355140,167264 
 20151222,a1605,20151222,3749,3742,3749,3763,3705,3706,3738,-36,-4,92394,3454142560,170598 
 20151223,a1605,20151223,3706,3738,3708,3720,3689,3713,3703,-25,-35,113010,4185263240,171656 
 20151224,a1605,20151224,3713,3703,3713,3719,3692,3701,3706,-2,3,64164,2378354160,169784 
 20151225,a1605,20151225,3701,3706,3697,3733,3661,3668,3697,-38,-9,134840,4985238940,185548 
 20151228,a1605,20151228,3668,3697,3668,3676,3580,3599,3619,-98,-78,256660,9290125080,217654 
 20151229,a1605,20151229,3599,3619,3609,3635,3589,3622,3610,3,-9,192072,6934563280,209538 
 20151230,a1605,20151230,3622,3610,3620,3658,3612,3631,3633,21,23,147836,5371991880,197838 
 20151231,a1605,20151231,3631,3633,3626,3632,3602,3620,3615,-13,-18,174314,6301764800,197982 
