   ,合约,日期,前收盘价,前结算价,开盘价,最高价,最低价,收盘价,结算价,涨跌1,涨跌2,成交量,成交金额,持仓量
1,a1001,20100104,4075,4069,4107,4108,4107,4108,4107,39,38,10,41.08,26
2,a1001,20100105,4108,4107,0,0,0,4107,4107,0,0,0,0,26
3,a1001,20100106,4107,4107,0,0,0,4107,4107,0,0,0,0,26
4,a1001,20100107,4107,4107,0,0,0,4107,4107,0,0,0,0,26
5,a1001,20100108,4107,4107,0,0,0,4107,4107,0,0,0,0,26
6,a1001,20100111,4107,4107,0,0,0,4107,4107,0,0,0,0,26
7,a1001,20100112,4107,4107,0,0,0,4107,4107,0,0,0,0,26
8,a1001,20100113,4107,4107,0,0,0,4107,4107,0,0,0,0,26
9,a1001,20100114,4107,4107,0,0,0,4107,4107,0,0,0,0,26
10,a1001,20100115,4107,4107,0,0,0,4107,4107,0,0,0,0,0
11,a1003,20100104,4110,4105,4080,4155,4080,4150,4128,45,23,90,371.6,134
12,a1003,20100105,4150,4128,0,0,0,4128,4128,0,0,0,0,134
13,a1003,20100106,4128,4128,4153,4175,4144,4175,4167,47,39,14,58.34,132
14,a1003,20100107,4175,4167,4193,4200,4120,4165,4155,-2,-12,24,99.74,128
15,a1003,20100108,4165,4155,4165,4165,4080,4110,4102,-45,-53,134,549.76,124
16,a1003,20100111,4110,4102,4150,4167,4150,4156,4162,54,60,72,299.7,108
17,a1003,20100112,4156,4162,4111,4129,4090,4107,4115,-55,-47,24,98.77,100
18,a1003,20100113,4107,4115,4097,4100,4069,4069,4084,-46,-31,46,187.89,68
19,a1003,20100114,4069,4084,4109,4109,4060,4060,4090,-24,6,12,49.08,74
20,a1003,20100115,4060,4090,4074,4074,4074,4074,4074,-16,-16,2,8.15,74
21,a1003,20100118,4074,4074,4041,4084,4041,4061,4066,-13,-8,24,97.6,74
22,a1003,20100119,4061,4066,4110,4110,4078,4090,4087,24,21,20,81.76,80
23,a1003,20100120,4090,4087,4050,4068,4040,4040,4053,-47,-34,20,81.06,68
24,a1003,20100121,4040,4053,4055,4065,4040,4040,4045,-13,-8,70,283.16,32
25,a1003,20100122,4040,4045,4058,4065,4020,4020,4047,-25,2,6,24.29,30
26,a1003,20100125,4020,4047,4080,4109,4011,4048,4049,1,2,76,307.74,32
27,a1003,20100126,4048,4049,4090,4090,4021,4021,4035,-28,-14,20,80.71,28
28,a1003,20100127,4021,4035,4060,4060,4020,4027,4038,-8,3,18,72.69,28
29,a1003,20100128,4027,4038,4014,4037,3972,3972,4011,-66,-27,26,104.3,20
30,a1003,20100129,3972,4011,0,0,0,4011,4011,0,0,0,0,20
31,a1003,20100201,4011,4011,3959,3959,3900,3955,3938,-56,-73,6,23.63,18
32,a1003,20100202,3955,3938,3910,3969,3910,3969,3939,31,1,4,15.76,16
33,a1003,20100203,3969,3939,3980,3980,3873,3969,3947,30,8,8,31.58,16
34,a1003,20100204,3969,3947,3910,3910,3910,3910,3910,-37,-37,2,7.82,14
35,a1003,20100205,3910,3910,3901,3920,3901,3920,3910,10,0,4,15.64,12
36,a1003,20100208,3920,3910,0,0,0,3910,3910,0,0,0,0,12
37,a1003,20100209,3910,3910,3930,4019,3930,4019,3959,109,49,6,23.76,12
38,a1003,20100210,4019,3959,4105,4105,3802,3859,4036,-100,77,38,153.39,12
39,a1003,20100211,3859,4036,3876,3879,3876,3879,3876,-157,-160,8,31.01,12
40,a1003,20100212,3879,3876,3938,3938,3750,3750,3836,-126,-40,6,23.02,12
41,a1003,20100222,3750,3836,3994,3994,3740,3780,3859,-56,23,12,46.32,12
42,a1003,20100223,3780,3859,3856,3939,3856,3870,3891,11,32,8,31.13,12
43,a1003,20100224,3870,3891,0,0,0,3891,3891,0,0,0,0,12
44,a1003,20100225,3891,3891,3850,3865,3850,3860,3858,-31,-33,8,30.87,12
45,a1003,20100226,3860,3858,3860,3860,3850,3850,3853,-8,-5,6,23.12,12
46,a1003,20100301,3850,3853,0,0,0,3853,3853,0,0,0,0,12
47,a1003,20100302,3853,3853,0,0,0,3853,3853,0,0,0,0,0
48,a1003,20100303,3853,3853,0,0,0,3853,3853,0,0,0,0,0
49,a1003,20100304,3853,3853,0,0,0,3853,3853,0,0,0,0,0
50,a1003,20100305,3853,3853,0,0,0,3853,3853,0,0,0,0,0
51,a1003,20100308,3853,3853,0,0,0,3853,3853,0,0,0,0,0
52,a1003,20100309,3853,3853,0,0,0,3853,3853,0,0,0,0,0
53,a1003,20100310,3853,3853,0,0,0,3853,3853,0,0,0,0,0
54,a1003,20100311,3853,3853,0,0,0,3853,3853,0,0,0,0,0
55,a1003,20100312,3853,3853,0,0,0,3853,3853,0,0,0,0,0
56,a1005,20100104,4148,4131,4177,4186,4160,4165,4171,34,40,3366,14040.68,45274
57,a1005,20100105,4165,4171,4172,4180,4163,4175,4175,4,4,1384,5778.23,45230
58,a1005,20100106,4175,4175,4165,4240,4165,4231,4210,56,35,6356,26758.88,46476
59,a1005,20100107,4231,4210,4230,4244,4085,4144,4171,-66,-39,7200,30037.79,45810
60,a1005,20100108,4144,4171,4139,4147,4093,4095,4112,-76,-59,7712,31712.18,43116
61,a1005,20100111,4095,4112,4104,4161,4104,4130,4133,18,21,1738,7183.28,42524
62,a1005,20100112,4130,4133,4125,4126,4096,4114,4109,-19,-24,2274,9345.77,41928
63,a1005,20100113,4114,4109,4058,4075,4010,4046,4060,-63,-49,2498,10143.17,41764
64,a1005,20100114,4046,4060,4080,4080,4063,4063,4069,3,9,1564,6364.38,41364
65,a1005,20100115,4063,4069,4051,4078,4043,4056,4063,-13,-6,1118,4543.19,41394
66,a1005,20100118,4056,4063,4035,4063,4035,4057,4055,-6,-8,920,3731.15,41222
67,a1005,20100119,4057,4055,4084,4084,4064,4070,4074,15,19,840,3422.19,40978
68,a1005,20100120,4070,4074,4070,4071,4046,4046,4054,-28,-20,3480,14110.34,39956
69,a1005,20100121,4046,4054,4040,4066,4040,4066,4052,12,-2,1098,4449.82,39762
70,a1005,20100122,4066,4052,4046,4065,4025,4065,4052,13,0,1700,6888.5,39616
71,a1005,20100125,4065,4052,4054,4085,4054,4070,4071,18,19,1000,4071.32,39202
72,a1005,20100126,4070,4071,4061,4080,4050,4051,4066,-20,-5,1658,6742.57,38756
73,a1005,20100127,4051,4066,4070,4083,4060,4072,4069,6,3,2926,11907.6,38376
74,a1005,20100128,4072,4069,4051,4054,4028,4030,4036,-39,-33,3828,15451.24,38356
75,a1005,20100129,4030,4036,4042,4046,4021,4022,4033,-14,-3,836,3371.65,38348
76,a1005,20100201,4022,4033,3990,4009,3950,3955,3978,-78,-55,4090,16271.25,38034
77,a1005,20100202,3955,3978,3960,3986,3928,3933,3956,-45,-22,1838,7271.66,37904
78,a1005,20100203,3933,3956,3984,3985,3949,3985,3970,29,14,1230,4884.25,37774
79,a1005,20100204,3985,3970,3955,3959,3921,3953,3941,-17,-29,1708,6732.93,37762
80,a1005,20100205,3953,3941,3948,3993,3938,3987,3976,46,35,2210,8789.06,37910
81,a1005,20100208,3987,3976,3993,4045,3993,4045,4031,69,55,2662,10731.6,37880
82,a1005,20100209,4045,4031,4048,4073,4036,4073,4060,42,29,2000,8120.01,38306
83,a1005,20100210,4073,4060,4222,4222,4053,4070,4084,10,24,2780,11356.2,37292
84,a1005,20100211,4070,4084,4096,4101,4080,4087,4092,3,8,1348,5516.94,36954
85,a1005,20100212,4087,4092,4080,4100,4079,4090,4086,-2,-6,1026,4192.66,36808
86,a1005,20100222,4090,4086,4110,4144,4103,4112,4116,26,30,638,2626.59,36850
87,a1005,20100223,4112,4116,4108,4120,4091,4116,4101,0,-15,3488,14306.98,36862
88,a1005,20100224,4116,4101,4091,4109,4091,4097,4098,-4,-3,1014,4155.75,36732
89,a1005,20100225,4097,4098,4100,4105,4078,4079,4085,-19,-13,978,3995.56,36378
90,a1005,20100226,4079,4085,4065,4081,4063,4071,4074,-14,-11,552,2249.36,36236
91,a1005,20100301,4071,4074,4082,4110,4076,4093,4099,19,25,2268,9297.56,36012
92,a1005,20100302,4093,4099,4089,4102,4086,4093,4095,-6,-4,846,3464.97,35966
93,a1005,20100303,4093,4095,4101,4108,4091,4102,4101,7,6,2092,8580.39,35980
94,a1005,20100304,4102,4101,4102,4104,4082,4085,4095,-16,-6,1262,5168.48,36022
95,a1005,20100305,4085,4095,4080,4095,4066,4092,4082,-3,-13,606,2473.86,35962
96,a1005,20100308,4092,4082,4095,4109,4090,4103,4097,21,15,562,2302.8,36144
97,a1005,20100309,4103,4097,4096,4101,4090,4097,4093,0,-4,702,2873.41,35920
98,a1005,20100310,4097,4093,4090,4101,4090,4096,4098,3,5,1176,4819.75,36072
99,a1005,20100311,4096,4098,4109,4110,4082,4095,4091,-3,-7,2028,8297.93,36136
100,a1005,20100312,4095,4091,4084,4085,4069,4072,4077,-19,-14,1260,5137.82,36760
101,a1005,20100315,4072,4077,4072,4072,4048,4057,4056,-20,-21,454,1841.77,36752
102,a1005,20100316,4057,4056,4063,4077,4056,4077,4067,21,11,460,1870.86,36638
103,a1005,20100317,4077,4067,4077,4090,4067,4087,4085,20,18,1632,6667.57,36570
104,a1005,20100318,4087,4085,4091,4094,4080,4081,4085,-4,0,284,1160.18,36520
105,a1005,20100319,4081,4085,4085,4095,4082,4092,4090,7,5,1840,7526.35,36398
106,a1005,20100322,4092,4090,4083,4094,4081,4089,4088,-1,-2,894,3655.29,36654
107,a1005,20100323,4089,4088,4099,4099,4073,4075,4087,-13,-1,964,3940.59,36670
108,a1005,20100324,4075,4087,4085,4085,4064,4068,4069,-19,-18,344,1400.02,36592
109,a1005,20100325,4068,4069,4062,4070,4062,4063,4065,-6,-4,328,1333.64,36590
110,a1005,20100326,4063,4065,4051,4054,4006,4016,4027,-49,-38,2640,10631.83,34844
111,a1005,20100329,4016,4027,4013,4039,4010,4027,4021,0,-6,712,2863.49,34718
112,a1005,20100330,4027,4021,4035,4043,4020,4029,4029,8,8,1770,7131.91,34400
113,a1005,20100331,4029,4029,4025,4043,4022,4022,4031,-7,2,998,4023.36,34092
114,a1005,20100401,4022,4031,4001,4018,3990,4012,4008,-19,-23,766,3070.65,33668
115,a1005,20100402,4012,4008,3931,4030,3931,4015,4006,7,-2,888,3557.8,33414
116,a1005,20100406,4015,4006,4004,4012,4000,4003,4008,-3,2,1680,6733.54,32668
117,a1005,20100407,4003,4008,4007,4008,4001,4005,4005,-3,-3,7272,29129.8,32110
118,a1005,20100408,4005,4005,4005,4012,3966,3966,4000,-39,-5,3232,12929.95,30520
119,a1005,20100409,3966,4000,3978,3981,3968,3975,3972,-25,-28,750,2979.58,29996
120,a1005,20100412,3975,3972,3984,3986,3968,3973,3974,1,2,1116,4435.28,29738
121,a1005,20100413,3973,3974,3973,3973,3930,3930,3949,-44,-25,1622,6406.46,28658
122,a1005,20100414,3930,3949,3942,3942,3879,3891,3895,-58,-54,3860,15035.74,25788
123,a1005,20100415,3891,3895,3898,3898,3850,3859,3870,-36,-25,1198,4637.35,25160
124,a1005,20100416,3859,3870,3861,3880,3858,3876,3868,6,-2,530,2050.3,24860
125,a1005,20100419,3876,3868,3897,3897,3850,3852,3857,-16,-11,7472,28822.26,23064
126,a1005,20100420,3852,3857,3856,3864,3834,3864,3858,7,1,284,1095.85,22790
127,a1005,20100421,3864,3858,3862,3880,3861,3880,3873,22,15,580,2246.34,22674
128,a1005,20100422,3880,3873,3899,3899,3877,3899,3893,26,20,646,2514.95,22356
129,a1005,20100423,3899,3893,3891,3907,3891,3906,3899,13,6,406,1583.37,22254
130,a1005,20100426,3906,3899,3900,3901,3899,3900,3900,1,1,950,3705.11,21926
131,a1005,20100427,3900,3900,3900,3900,3860,3886,3862,-14,-38,1136,4387.82,21842
132,a1005,20100428,3886,3862,3988,3988,3861,3888,3889,26,27,236,917.96,21688
133,a1005,20100429,3888,3889,3900,3909,3888,3902,3903,13,14,280,1093.07,21556
134,a1005,20100430,3902,3903,3918,3948,3747,3922,3848,19,-55,1996,7680.78,21280
135,a1005,20100504,3922,3848,3900,3900,3810,3810,3825,-38,-23,210,803.29,13416
136,a1005,20100505,3810,3825,0,0,0,3825,3825,0,0,0,0,10874
137,a1005,20100506,3825,3825,3825,3825,3825,3825,3825,0,0,4,15.3,6434
138,a1005,20100507,3825,3825,3885,3885,3845,3845,3866,20,41,20,77.34,5610
139,a1005,20100510,3845,3866,3847,3873,3801,3820,3828,-46,-38,18,68.91,5612
140,a1005,20100511,3820,3828,3830,3840,3790,3830,3822,2,-6,128,489.32,5734
141,a1005,20100512,3830,3822,3800,3800,3800,3800,3800,-22,-22,2,7.6,2990
142,a1005,20100513,3800,3800,0,0,0,3800,3760,0,-40,4,15.04,2456
143,a1005,20100514,3800,3760,0,0,0,3760,3760,0,0,0,0,2376
144,a1005,20100517,3760,3760,0,0,0,3760,3825,0,65,0,0,0
145,a1007,20100104,4180,4172,4202,4228,4191,4203,4208,31,36,82,345.12,1426
146,a1007,20100105,4203,4208,4203,4220,4185,4217,4214,9,6,234,986.13,1410
147,a1007,20100106,4217,4214,4200,4285,4200,4261,4249,47,35,264,1121.85,1414
148,a1007,20100107,4261,4249,4263,4273,4175,4188,4211,-61,-38,452,1903.62,1446
149,a1007,20100108,4188,4211,4192,4192,4131,4157,4157,-54,-54,152,631.91,1442
150,a1007,20100111,4157,4157,4197,4200,4171,4171,4181,14,24,260,1087.16,1280
151,a1007,20100112,4171,4181,4116,4159,4116,4153,4147,-28,-34,28,116.13,1268
152,a1007,20100113,4153,4147,4065,4107,4065,4070,4082,-77,-65,100,408.27,1254
153,a1007,20100114,4070,4082,4070,4091,4070,4091,4079,9,-3,8,32.63,1254
154,a1007,20100115,4091,4079,4085,4097,4070,4070,4083,-9,4,50,204.17,1240
155,a1007,20100118,4070,4083,4063,4071,4062,4070,4069,-13,-14,26,105.8,1228
156,a1007,20100119,4070,4069,4090,4090,4075,4080,4080,11,11,38,155.06,1214
157,a1007,20100120,4080,4080,4054,4066,4045,4048,4056,-32,-24,148,600.29,1216
158,a1007,20100121,4048,4056,4041,4070,4039,4053,4054,-3,-2,146,592,1262
159,a1007,20100122,4053,4054,4057,4057,4030,4054,4040,0,-14,14,56.57,1262
160,a1007,20100125,4054,4040,4040,4081,4040,4066,4066,26,26,34,138.26,1264
161,a1007,20100126,4066,4066,4032,4065,4031,4055,4046,-11,-20,106,428.9,1250
162,a1007,20100127,4055,4046,4070,4071,4056,4068,4063,22,17,96,390.12,1234
163,a1007,20100128,4068,4063,4058,4058,4019,4024,4029,-39,-34,124,499.68,1230
164,a1007,20100129,4024,4029,4030,4041,4015,4015,4031,-14,2,62,249.97,1226
165,a1007,20100201,4015,4031,3988,3988,3942,3948,3968,-83,-63,194,769.85,1276
166,a1007,20100202,3948,3968,3972,3972,3910,3918,3931,-50,-37,72,283.07,1278
167,a1007,20100203,3918,3931,3937,3937,3937,3937,3937,6,6,2,7.87,1278
168,a1007,20100204,3937,3937,3900,3930,3900,3928,3909,-9,-28,14,54.74,1278
169,a1007,20100205,3928,3909,3945,3970,3945,3970,3958,61,49,28,110.84,1266
170,a1007,20100208,3970,3958,3970,4016,3970,4016,4003,58,45,42,168.14,1270
171,a1007,20100209,4016,4003,4047,4047,4005,4022,4017,19,14,74,297.3,1250
172,a1007,20100210,4022,4017,4016,4040,3995,3995,4028,-22,11,140,564.04,1210
173,a1007,20100211,3995,4028,4040,4067,4026,4026,4045,-2,17,52,210.34,1210
174,a1007,20100212,4026,4045,4022,4040,4012,4029,4036,-16,-9,94,379.39,1210
175,a1007,20100222,4029,4036,4031,4031,4031,4031,4031,-5,-5,2,8.06,1212
176,a1007,20100223,4031,4031,4074,4074,4050,4067,4062,36,31,226,918.12,1214
177,a1007,20100224,4067,4062,4050,4067,4050,4065,4063,3,1,22,89.4,1214
178,a1007,20100225,4065,4063,4075,4075,4040,4050,4062,-13,-1,28,113.76,1218
179,a1007,20100226,4050,4062,4035,4054,4032,4045,4040,-17,-22,54,218.2,1218
180,a1007,20100301,4045,4040,4054,4080,4050,4070,4066,30,26,104,422.89,1220
181,a1007,20100302,4070,4066,4060,4070,4055,4056,4060,-10,-6,44,178.67,1216
182,a1007,20100303,4056,4060,4052,4080,4036,4061,4062,1,2,56,227.49,1212
183,a1007,20100304,4061,4062,4063,4064,4039,4039,4045,-23,-17,32,129.46,1212
184,a1007,20100305,4039,4045,4011,4045,4011,4036,4033,-9,-12,52,209.75,1208
185,a1007,20100308,4036,4033,4056,4056,4049,4055,4054,22,21,32,129.74,1210
186,a1007,20100309,4055,4054,4063,4063,4037,4051,4052,-3,-2,62,251.23,1230
187,a1007,20100310,4051,4052,4055,4055,4048,4048,4051,-4,-1,12,48.61,1230
188,a1007,20100311,4048,4051,4066,4066,4038,4041,4044,-10,-7,178,719.83,1230
189,a1007,20100312,4041,4044,4030,4030,4016,4021,4024,-23,-20,48,193.16,1212
190,a1007,20100315,4021,4024,4010,4010,4005,4010,4007,-14,-17,34,136.26,1210
191,a1007,20100316,4010,4007,4048,4048,4015,4030,4030,23,23,118,475.58,1216
192,a1007,20100317,4030,4030,4050,4050,4040,4042,4042,12,12,60,242.52,1216
193,a1007,20100318,4042,4042,4021,4055,4021,4035,4038,-7,-4,124,500.78,1218
194,a1007,20100319,4035,4038,4055,4059,4037,4055,4051,17,13,40,162.08,1220
195,a1007,20100322,4055,4051,4057,4067,4041,4051,4056,0,5,198,803.17,1322
196,a1007,20100323,4051,4056,4058,4062,4043,4049,4055,-7,-1,40,162.22,1320
197,a1007,20100324,4049,4055,4037,4038,4033,4034,4035,-21,-20,42,169.47,1320
198,a1007,20100325,4034,4035,4039,4040,4037,4037,4038,2,3,30,121.16,1314
199,a1007,20100326,4037,4038,4012,4012,3995,4005,4004,-33,-34,144,576.71,1302
200,a1007,20100329,4005,4004,4010,4016,3990,4011,4009,7,5,74,296.73,1276
201,a1007,20100330,4011,4009,4018,4018,4006,4015,4014,6,5,12,48.18,1278
202,a1007,20100331,4015,4014,4017,4022,4012,4012,4017,-2,3,62,249.08,1272
203,a1007,20100401,4012,4017,4000,4002,3991,4002,3996,-15,-21,24,95.92,1268
204,a1007,20100402,4002,3996,4019,4019,4000,4004,4006,8,10,14,56.08,1264
205,a1007,20100406,4004,4006,4002,4012,4001,4002,4005,-4,-1,72,288.42,1240
206,a1007,20100407,4002,4005,4019,4019,3999,4004,4005,-1,0,60,240.33,1212
207,a1007,20100408,4004,4005,4012,4012,3961,3961,3985,-44,-20,218,868.88,1054
208,a1007,20100409,3961,3985,3967,3980,3965,3977,3973,-8,-12,98,389.4,1024
209,a1007,20100412,3977,3973,3988,3988,3962,3977,3972,4,-1,124,492.63,926
210,a1007,20100413,3977,3972,3961,3971,3919,3925,3939,-47,-33,500,1969.62,528
211,a1007,20100414,3925,3939,3927,3928,3880,3887,3906,-52,-33,466,1820.61,426
212,a1007,20100415,3887,3906,3903,3903,3849,3857,3871,-49,-35,324,1254.42,344
213,a1007,20100416,3857,3871,3870,3879,3832,3878,3874,7,3,100,387.41,338
214,a1007,20100419,3878,3874,3872,3947,3842,3853,3865,-21,-9,410,1584.71,324
215,a1007,20100420,3853,3865,3851,3855,3777,3855,3833,-10,-32,86,329.66,310
216,a1007,20100421,3855,3833,3858,3858,3858,3858,3858,25,25,2,7.72,308
217,a1007,20100422,3858,3858,3930,3930,3863,3874,3877,16,19,46,178.35,312
218,a1007,20100423,3874,3877,3872,3893,3872,3884,3886,7,9,64,248.73,312
219,a1007,20100426,3884,3886,3890,3890,3890,3890,3890,4,4,24,93.36,310
220,a1007,20100427,3890,3890,3876,3876,3865,3865,3870,-25,-20,8,30.96,310
221,a1007,20100428,3865,3870,3834,3867,3834,3860,3855,-10,-15,20,77.11,314
222,a1007,20100429,3860,3855,3875,3876,3865,3875,3871,20,16,34,131.64,306
223,a1007,20100430,3875,3871,3886,3886,3866,3874,3871,3,0,36,139.39,298
224,a1007,20100504,3874,3871,3875,3875,3848,3871,3866,0,-5,14,54.13,298
225,a1007,20100505,3871,3866,3876,3895,3857,3895,3884,29,18,44,170.91,290
226,a1007,20100506,3895,3884,3841,3881,3841,3862,3856,-22,-28,22,84.84,282
227,a1007,20100507,3862,3856,3862,3862,3840,3842,3845,-14,-11,58,223.04,276
228,a1007,20100510,3842,3845,3860,3860,3845,3845,3849,0,4,8,30.79,276
229,a1007,20100511,3845,3849,3850,3853,3825,3825,3840,-24,-9,22,84.5,276
230,a1007,20100512,3825,3840,3850,3855,3845,3845,3851,5,11,94,362.05,336
231,a1007,20100513,3845,3851,0,0,0,3851,3851,0,0,0,0,336
232,a1007,20100514,3851,3851,3847,3847,3818,3830,3831,-21,-20,6,22.99,336
233,a1007,20100517,3830,3831,3801,3801,3711,3712,3761,-119,-70,28,105.32,326
234,a1007,20100518,3712,3761,3712,3790,3712,3764,3759,3,-2,58,218.04,322
235,a1007,20100519,3764,3759,3778,3800,3748,3751,3763,-8,4,134,504.34,304
236,a1007,20100520,3751,3763,3790,3790,3750,3765,3765,2,2,88,331.38,310
237,a1007,20100521,3765,3765,3775,3800,3761,3773,3770,8,5,62,233.8,290
238,a1007,20100524,3773,3770,3770,3877,3756,3788,3798,18,28,260,987.52,280
239,a1007,20100525,3788,3798,3771,3788,3771,3775,3776,-23,-22,58,219.05,312
240,a1007,20100526,3775,3776,3798,3798,3770,3788,3778,12,2,46,173.81,302
241,a1007,20100527,3788,3778,3799,3799,3775,3783,3785,5,7,32,121.15,308
242,a1007,20100528,3783,3785,3782,3798,3782,3791,3791,6,6,34,128.9,302
243,a1007,20100531,3791,3791,3790,3790,3765,3765,3777,-26,-14,32,120.88,302
244,a1007,20100601,3765,3777,3787,3860,3751,3770,3799,-7,22,90,341.97,258
245,a1007,20100602,3770,3799,3755,3772,3754,3759,3761,-40,-38,68,255.78,248
246,a1007,20100603,3759,3761,3825,3825,3756,3766,3766,5,5,38,143.12,228
247,a1007,20100604,3766,3766,3767,3777,3766,3766,3772,0,6,18,67.91,224
248,a1007,20100607,3766,3772,3725,3766,3725,3747,3753,-25,-19,30,112.6,218
249,a1007,20100608,3747,3753,3770,3770,3750,3756,3756,3,3,64,240.44,182
250,a1007,20100609,3756,3756,3760,3760,3741,3742,3749,-14,-7,52,194.96,172
251,a1007,20100610,3742,3749,3750,3770,3705,3769,3752,20,3,22,82.55,168
252,a1007,20100611,3769,3752,3750,3756,3731,3731,3746,-21,-6,32,119.88,164
253,a1007,20100617,3731,3746,3751,3755,3740,3751,3749,5,3,22,82.49,150
254,a1007,20100618,3751,3749,3712,3755,3712,3755,3750,6,1,38,142.52,130
255,a1007,20100621,3755,3750,3800,3800,3740,3795,3772,45,22,52,196.16,134
256,a1007,20100622,3795,3772,3764,3774,3750,3764,3764,-8,-8,32,120.45,140
257,a1007,20100623,3764,3764,3765,3765,3722,3722,3746,-42,-18,16,59.94,138
258,a1007,20100624,3722,3746,3748,3748,3736,3742,3741,-4,-5,12,44.9,134
259,a1007,20100625,3742,3741,3656,3768,3656,3735,3701,-6,-40,26,96.24,134
260,a1007,20100628,3735,3701,3680,3702,3680,3702,3698,1,-3,48,177.52,134
261,a1007,20100629,3702,3698,3700,3718,3695,3712,3704,14,6,40,148.17,136
262,a1007,20100630,3712,3704,3702,3720,3629,3715,3701,11,-3,78,288.72,114
263,a1007,20100701,3715,3701,3650,3650,3650,3650,3650,-51,-51,4,14.6,76
264,a1007,20100702,3650,3650,3650,3650,3650,3650,3650,0,0,8,29.2,84
265,a1007,20100705,3650,3650,3740,3740,3645,3646,3723,-4,73,82,305.36,86
266,a1007,20100706,3646,3723,3580,3629,3580,3629,3610,-94,-113,12,43.33,98
267,a1007,20100707,3629,3610,3629,3629,3629,3629,3629,19,19,4,14.52,102
268,a1007,20100708,3629,3629,3634,3634,3629,3629,3629,0,0,74,268.56,78
269,a1007,20100709,3629,3629,0,0,0,3629,3629,0,0,0,0,78
270,a1007,20100712,3629,3629,0,0,0,3629,3629,0,0,0,0,78
271,a1007,20100713,3629,3629,0,0,0,3629,3629,0,0,0,0,78
272,a1007,20100714,3629,3629,0,0,0,3629,3671,0,42,0,0,0
273,a1009,20100104,4038,4026,4080,4090,4049,4057,4069,31,43,321838,1309575.66,284296
274,a1009,20100105,4057,4069,4067,4082,4060,4066,4070,-3,1,253640,1032415.2,283384
275,a1009,20100106,4066,4070,4066,4194,4057,4154,4140,84,70,860812,3564243.02,352830
276,a1009,20100107,4154,4140,4165,4188,3975,4044,4090,-96,-50,705704,2886379.46,297236
277,a1009,20100108,4044,4090,4040,4050,3947,3981,4000,-109,-90,526594,2106492.62,270074
278,a1009,20100111,3981,4000,4012,4050,4012,4031,4035,31,35,316116,1275745.51,270738
279,a1009,20100112,4031,4035,4000,4029,3981,4004,4004,-31,-31,447848,1793378.68,271068
280,a1009,20100113,4004,4004,3905,3938,3896,3909,3917,-95,-87,300960,1178993.33,260966
281,a1009,20100114,3909,3917,3943,3943,3918,3919,3931,2,14,190364,748376.07,259500
282,a1009,20100115,3919,3931,3905,3949,3902,3915,3928,-16,-3,313576,1232023.38,265124
283,a1009,20100118,3915,3928,3908,3925,3890,3909,3908,-19,-20,249986,976977.45,269332
284,a1009,20100119,3909,3908,3935,3935,3910,3919,3921,11,13,167968,658724.03,274202
285,a1009,20100120,3919,3921,3910,3929,3858,3861,3881,-60,-40,335400,1301796.66,290088
286,a1009,20100121,3861,3881,3860,3903,3852,3901,3878,20,-3,271388,1052480.39,280512
287,a1009,20100122,3901,3878,3887,3893,3837,3889,3872,11,-6,280556,1086413.02,270304
288,a1009,20100125,3889,3872,3878,3926,3875,3911,3907,39,35,337600,1319098.17,277594
289,a1009,20100126,3911,3907,3910,3930,3883,3885,3904,-22,-3,470020,1834998.5,278582
290,a1009,20100127,3885,3904,3905,3938,3900,3922,3920,18,16,618382,2424612.58,296746
291,a1009,20100128,3922,3920,3900,3900,3842,3863,3865,-57,-55,401078,1550541.43,277646
292,a1009,20100129,3863,3865,3870,3884,3850,3853,3868,-12,3,260046,1006095.76,264630
293,a1009,20100201,3853,3868,3839,3849,3760,3768,3795,-100,-73,404240,1534095.33,282970
294,a1009,20100202,3768,3795,3785,3798,3728,3735,3755,-60,-40,374218,1405390.47,279460
295,a1009,20100203,3735,3755,3771,3785,3744,3782,3767,27,12,291838,1099613.11,271958
296,a1009,20100204,3782,3767,3740,3760,3720,3755,3742,-12,-25,250890,938905.99,274098
297,a1009,20100205,3755,3742,3740,3793,3728,3785,3777,43,35,539114,2036493.09,280652
298,a1009,20100208,3785,3777,3810,3825,3801,3812,3812,35,35,224846,857133.93,275382
299,a1009,20100209,3812,3812,3812,3819,3796,3809,3807,-3,-5,141526,538887.65,271300
300,a1009,20100210,3809,3807,3807,3815,3748,3769,3779,-38,-28,302080,1141588.46,273654
301,a1009,20100211,3769,3779,3807,3828,3784,3798,3807,19,28,243738,928005.44,251010
302,a1009,20100212,3798,3807,3801,3808,3763,3776,3780,-31,-27,133432,504474.68,246028
303,a1009,20100222,3776,3780,3815,3850,3800,3819,3816,39,36,171364,653926.18,249340
304,a1009,20100223,3819,3816,3830,3878,3825,3874,3854,58,38,342832,1321529.2,269414
305,a1009,20100224,3874,3854,3851,3867,3848,3858,3858,4,4,204128,787581.92,261240
306,a1009,20100225,3858,3858,3867,3874,3825,3838,3849,-20,-9,205796,792260.07,252990
307,a1009,20100226,3838,3849,3830,3845,3820,3830,3833,-19,-16,182768,700567.82,252534
308,a1009,20100301,3830,3833,3860,3904,3843,3883,3880,50,47,422434,1639175.26,272608
309,a1009,20100302,3883,3880,3881,3898,3865,3873,3882,-7,2,428712,1664286.76,272774
310,a1009,20100303,3873,3882,3886,3910,3878,3892,3894,10,12,388958,1514983.74,275790
311,a1009,20100304,3892,3894,3882,3889,3833,3834,3861,-60,-33,299648,1157182.69,272514
312,a1009,20100305,3834,3861,3814,3840,3804,3835,3822,-26,-39,212816,813502.64,262814
313,a1009,20100308,3835,3822,3842,3845,3821,3842,3836,20,14,201768,774005.65,267618
314,a1009,20100309,3842,3836,3836,3855,3826,3845,3840,9,4,217344,834778.34,263458
315,a1009,20100310,3845,3840,3835,3852,3834,3836,3842,-4,2,118736,456193.31,259312
316,a1009,20100311,3836,3842,3855,3876,3830,3850,3856,8,14,466534,1799082.41,261064
317,a1009,20100312,3850,3856,3825,3830,3806,3810,3815,-46,-41,293040,1118202.2,256978
318,a1009,20100315,3810,3815,3813,3816,3786,3800,3800,-15,-15,212506,807531.6,253694
319,a1009,20100316,3800,3800,3805,3839,3804,3838,3820,38,20,208026,794825.19,243116
320,a1009,20100317,3838,3820,3850,3859,3841,3846,3848,26,28,170430,655945.68,238796
321,a1009,20100318,3846,3848,3858,3858,3827,3835,3842,-13,-6,129994,499471.08,234726
322,a1009,20100319,3835,3842,3842,3875,3841,3861,3862,19,20,236678,914162.03,230474
323,a1009,20100322,3861,3862,3850,3885,3850,3870,3867,8,5,182286,705019.04,220340
324,a1009,20100323,3870,3867,3900,3901,3861,3870,3880,3,13,175342,680461.13,214350
325,a1009,20100324,3870,3880,3867,3871,3850,3858,3860,-22,-20,117950,455360.53,210272
326,a1009,20100325,3858,3860,3855,3874,3855,3862,3865,2,5,89278,345099.79,211644
327,a1009,20100326,3862,3865,3850,3858,3835,3853,3845,-12,-20,120740,464359.47,209620
328,a1009,20100329,3853,3845,3868,3878,3855,3869,3867,24,22,80396,310892.08,201918
329,a1009,20100330,3869,3867,3880,3898,3862,3893,3883,26,16,168978,656232.54,197156
330,a1009,20100331,3893,3883,3896,3920,3885,3888,3902,5,19,281680,1099166.9,205352
331,a1009,20100401,3888,3902,3847,3876,3838,3868,3863,-34,-39,122882,474701.19,194516
332,a1009,20100402,3868,3863,3867,3884,3867,3878,3876,15,13,64704,250819.92,196756
333,a1009,20100406,3878,3876,3872,3885,3869,3875,3878,-1,2,58094,225307.97,194454
334,a1009,20100407,3875,3878,3884,3903,3880,3894,3891,16,13,127604,496574.09,198182
335,a1009,20100408,3894,3891,3895,3916,3881,3883,3902,-8,11,142680,556749.8,191820
336,a1009,20100409,3883,3902,3885,3896,3885,3891,3890,-11,-12,56112,218291.53,189198
337,a1009,20100412,3891,3890,3905,3914,3890,3908,3905,18,15,90922,355087.28,181570
338,a1009,20100413,3908,3905,3910,3910,3888,3904,3898,-1,-7,89558,349165.1,183170
339,a1009,20100414,3904,3898,3919,3922,3901,3902,3911,4,13,85970,336229.43,175678
340,a1009,20100415,3902,3911,3905,3906,3888,3892,3895,-19,-16,46140,179750.9,168494
341,a1009,20100416,3892,3895,3910,3915,3901,3901,3905,6,10,41262,161165.6,159592
342,a1009,20100419,3901,3905,3894,3899,3863,3872,3883,-33,-22,49664,192870.61,148886
343,a1009,20100420,3872,3883,3890,3894,3883,3891,3888,8,5,38984,151592.99,138380
344,a1009,20100421,3891,3888,3894,3898,3889,3893,3893,5,5,27354,106494.62,131910
345,a1009,20100422,3893,3893,3899,3907,3895,3899,3901,6,8,25794,100642.98,125382
346,a1009,20100423,3899,3901,3910,3916,3905,3909,3909,8,8,30100,117686.62,115966
347,a1009,20100426,3909,3909,3914,3919,3905,3911,3910,2,1,19532,76377.11,110542
348,a1009,20100427,3911,3910,3900,3905,3888,3894,3894,-16,-16,11934,46472.09,107624
349,a1009,20100428,3894,3894,3880,3880,3850,3874,3866,-20,-28,14852,57431.43,101348
350,a1009,20100429,3874,3866,3878,3887,3873,3876,3880,10,14,5878,22812.19,100636
351,a1009,20100430,3876,3880,3880,3894,3872,3893,3881,13,1,8262,32067.64,98974
352,a1009,20100504,3893,3881,3880,3880,3868,3878,3874,-3,-7,5960,23089.6,97642
353,a1009,20100505,3878,3874,3864,3926,3862,3920,3907,46,33,33600,131292.97,85816
354,a1009,20100506,3920,3907,3920,3920,3890,3891,3903,-16,-4,15724,61380.89,80236
355,a1009,20100507,3891,3903,3868,3869,3825,3825,3847,-78,-56,19992,76910.79,74464
356,a1009,20100510,3825,3847,3840,3864,3840,3858,3852,11,5,14616,56310.05,70260
357,a1009,20100511,3858,3852,3852,3858,3835,3837,3844,-15,-8,7160,27529.36,68042
358,a1009,20100512,3837,3844,3843,3865,3842,3859,3857,15,13,14366,55418.33,64788
359,a1009,20100513,3859,3857,3869,3869,3845,3854,3852,-3,-5,3778,14556.45,64332
360,a1009,20100514,3854,3852,3852,3853,3826,3833,3836,-19,-16,6050,23210.87,63978
361,a1009,20100517,3833,3836,3808,3819,3714,3740,3763,-96,-73,19854,74722.01,57634
362,a1009,20100518,3740,3763,3749,3767,3717,3763,3749,0,-14,7026,26347.09,56844
363,a1009,20100519,3763,3749,3749,3749,3723,3728,3732,-21,-17,7988,29818.81,55968
364,a1009,20100520,3728,3732,3742,3747,3725,3729,3736,-3,4,5450,20361.96,56322
365,a1009,20100521,3729,3736,3725,3766,3724,3757,3750,21,14,10470,39269.52,53072
366,a1009,20100524,3757,3750,3750,3769,3750,3767,3760,17,10,4524,17014.24,51948
367,a1009,20100525,3767,3760,3757,3761,3743,3749,3753,-11,-7,7214,27077.73,48946
368,a1009,20100526,3749,3753,3754,3771,3740,3761,3759,8,6,4284,16107.53,48660
369,a1009,20100527,3761,3759,3765,3766,3757,3765,3762,6,3,1958,7366.81,48184
370,a1009,20100528,3765,3762,3777,3781,3759,3759,3765,-3,3,6446,24272.9,48214
371,a1009,20100531,3759,3765,3730,3754,3730,3746,3747,-19,-18,4790,17949.61,46548
372,a1009,20100601,3746,3747,3746,3752,3722,3724,3734,-23,-13,4570,17066.01,45390
373,a1009,20100602,3724,3734,3729,3739,3718,3728,3730,-6,-4,3690,13765.12,44896
374,a1009,20100603,3728,3730,3730,3738,3730,3733,3733,3,3,3180,11873.68,44848
375,a1009,20100604,3733,3733,3770,3770,3743,3749,3753,16,20,3270,12273.42,44414
376,a1009,20100607,3749,3753,3725,3725,3683,3698,3702,-55,-51,3766,13943.88,44672
377,a1009,20100608,3698,3702,3700,3726,3700,3713,3712,11,10,3500,12993.43,44802
378,a1009,20100609,3713,3712,3700,3705,3679,3702,3693,-10,-19,4794,17704.51,43714
379,a1009,20100610,3702,3693,3707,3715,3698,3700,3705,7,12,7490,27756.29,40986
380,a1009,20100611,3700,3705,3701,3705,3683,3690,3694,-15,-11,5508,20349.29,39212
381,a1009,20100617,3690,3694,3712,3723,3704,3712,3716,18,22,4678,17385.21,38044
382,a1009,20100618,3712,3716,3710,3726,3710,3723,3720,7,4,3808,14165.87,38642
383,a1009,20100621,3723,3720,3740,3769,3733,3767,3751,47,31,6090,22845.76,37588
384,a1009,20100622,3767,3751,3755,3756,3746,3755,3749,4,-2,1936,7259.64,37056
385,a1009,20100623,3755,3749,3730,3758,3730,3747,3747,-2,-2,1278,4789.8,36654
386,a1009,20100624,3747,3747,3740,3751,3740,3743,3745,-4,-2,1306,4891.23,36766
387,a1009,20100625,3743,3745,3745,3745,3726,3729,3732,-16,-13,1592,5942.33,35956
388,a1009,20100628,3729,3732,3721,3745,3721,3744,3742,12,10,3720,13920.49,33240
389,a1009,20100629,3744,3742,3740,3754,3726,3740,3743,-2,1,3802,14231.68,31802
390,a1009,20100630,3740,3743,3725,3731,3720,3728,3726,-15,-17,2450,9129.54,30312
391,a1009,20100701,3728,3726,3726,3743,3724,3734,3737,8,11,2948,11018.13,28014
392,a1009,20100702,3734,3737,3737,3760,3725,3757,3748,20,11,3310,12407.67,26728
393,a1009,20100705,3757,3748,3750,3754,3747,3747,3748,-1,0,940,3523.58,25992
394,a1009,20100706,3747,3748,3743,3754,3730,3749,3745,1,-3,2536,9499.44,25036
395,a1009,20100707,3749,3745,3753,3760,3744,3758,3756,13,11,1924,7226.66,23696
396,a1009,20100708,3758,3756,3785,3794,3766,3772,3770,16,14,1478,5572.33,22822
397,a1009,20100709,3772,3770,3777,3781,3769,3778,3774,8,4,1724,6507.35,22018
398,a1009,20100712,3778,3774,3788,3791,3768,3768,3774,-6,0,1778,6711.74,20828
399,a1009,20100713,3768,3774,3765,3776,3760,3762,3764,-12,-10,864,3252.89,20332
400,a1009,20100714,3762,3764,3765,3767,3760,3764,3762,0,-2,286,1076.14,20308
401,a1009,20100715,3764,3762,3764,3780,3764,3767,3771,5,9,986,3718.37,19978
402,a1009,20100716,3767,3771,3788,3790,3773,3784,3782,13,11,1426,5394.5,19736
403,a1009,20100719,3784,3782,3784,3784,3772,3781,3778,-1,-4,948,3581.98,19422
404,a1009,20100720,3781,3778,3772,3793,3769,3788,3780,10,2,1716,6487.48,18470
405,a1009,20100721,3788,3780,3790,3796,3786,3792,3790,12,10,1182,4480.93,17872
406,a1009,20100722,3792,3790,3796,3796,3785,3789,3790,-1,0,3318,12575.79,15160
407,a1009,20100723,3789,3790,3795,3801,3788,3795,3794,5,4,1104,4188.66,14486
408,a1009,20100726,3795,3794,3790,3808,3788,3802,3800,8,6,2196,8345.42,13916
409,a1009,20100727,3802,3800,3790,3792,3775,3786,3785,-14,-15,1034,3914.14,13398
410,a1009,20100728,3786,3785,3791,3793,3784,3791,3788,6,3,1082,4099.4,12942
411,a1009,20100729,3791,3788,3800,3801,3790,3797,3796,9,8,584,2216.91,12778
412,a1009,20100730,3797,3796,3806,3815,3799,3803,3803,7,7,1450,5514.82,12288
413,a1009,20100802,3803,3803,3815,3851,3801,3845,3833,42,30,5672,21744.68,10788
414,a1009,20100803,3845,3833,3833,3849,3820,3849,3843,16,10,2518,9679.17,10234
415,a1009,20100804,3849,3843,3853,3866,3835,3838,3852,-5,9,1132,4361.47,9654
416,a1009,20100805,3838,3852,3858,3872,3822,3822,3839,-30,-13,856,3286.23,9316
417,a1009,20100806,3822,3839,3830,3834,3817,3834,3824,-5,-15,290,1109.19,9158
418,a1009,20100809,3834,3824,3834,3859,3829,3855,3847,31,23,1750,6732.8,8434
419,a1009,20100810,3855,3847,3830,3843,3802,3834,3832,-13,-15,912,3495.21,7996
420,a1009,20100811,3834,3832,3834,3840,3821,3821,3834,-11,2,556,2131.96,7728
421,a1009,20100812,3821,3834,3821,3840,3803,3818,3811,-16,-23,3982,15175.92,7568
422,a1009,20100813,3818,3811,3848,3848,3824,3835,3835,24,24,362,1388.48,7426
423,a1009,20100816,3835,3835,3835,3839,3820,3832,3832,-3,-3,454,1739.97,7198
424,a1009,20100817,3832,3832,3810,3820,3810,3820,3813,-12,-19,666,2539.92,6592
425,a1009,20100818,3820,3813,3838,3838,3810,3819,3829,6,16,350,1340.35,6488
426,a1009,20100819,3819,3829,3824,3824,3790,3801,3804,-28,-25,188,715.23,6414
427,a1009,20100820,3801,3804,3790,3790,3753,3760,3768,-44,-36,360,1356.7,6164
428,a1009,20100823,3760,3768,3778,3778,3746,3757,3755,-11,-13,206,773.64,6054
429,a1009,20100824,3757,3755,3730,3780,3730,3771,3764,16,9,452,1701.64,5738
430,a1009,20100825,3771,3764,3752,3781,3745,3745,3757,-19,-7,138,518.5,5678
431,a1009,20100826,3745,3757,3741,3763,3741,3763,3750,6,-7,586,2197.82,5150
432,a1009,20100827,3763,3750,3756,3786,3752,3785,3765,35,15,504,1897.84,4750
433,a1009,20100830,3785,3765,3806,3810,3789,3789,3804,24,39,774,2944.9,4324
434,a1009,20100831,3789,3804,3747,3760,3726,3728,3740,-76,-64,490,1832.78,4118
435,a1009,20100901,3728,3740,3735,3748,3721,3721,3738,-19,-2,166,620.62,2680
436,a1009,20100902,3721,3738,3721,3766,3721,3727,3754,-11,16,56,210.24,1976
437,a1009,20100903,3727,3754,3746,3776,3746,3776,3764,22,10,32,120.46,1932
438,a1009,20100906,3776,3764,3790,3800,3782,3795,3786,31,22,146,552.77,1892
439,a1009,20100907,3795,3786,0,0,0,3786,3786,0,0,0,0,1740
440,a1009,20100908,3786,3786,3795,3800,3795,3800,3795,14,9,34,129.04,1554
441,a1009,20100909,3800,3795,0,0,0,3795,3795,0,0,0,0,1552
442,a1009,20100910,3795,3795,0,0,0,3795,3795,0,0,0,0,548
443,a1009,20100913,3795,3795,3766,3774,3766,3772,3772,-23,-23,42,158.44,508
444,a1009,20100914,3772,3772,0,0,0,3772,3763,0,-9,0,0,0
445,a1011,20100104,3982,3977,3970,4015,3970,4011,4002,34,25,88,352.18,178
446,a1011,20100105,4011,4002,4026,4028,4008,4028,4023,26,21,24,96.57,162
447,a1011,20100106,4028,4023,4020,4114,4004,4100,4068,77,45,56,227.85,170
448,a1011,20100107,4100,4068,4129,4133,3906,4019,4075,-49,7,326,1328.57,176
449,a1011,20100108,4019,4075,4026,4027,3941,3964,3978,-111,-97,68,270.51,200
450,a1011,20100111,3964,3978,3990,4019,3990,4001,4002,23,24,26,104.06,190
451,a1011,20100112,4001,4002,3971,3990,3971,3985,3982,-17,-20,6,23.89,194
452,a1011,20100113,3985,3982,3900,3917,3885,3890,3899,-92,-83,82,319.74,204
453,a1011,20100114,3890,3899,3902,3910,3902,3906,3906,7,7,14,54.68,190
454,a1011,20100115,3906,3906,3890,3922,3890,3902,3906,-4,0,44,171.9,186
455,a1011,20100118,3902,3906,3905,3905,3881,3891,3895,-15,-11,30,116.87,188
456,a1011,20100119,3891,3895,3928,3928,3891,3905,3913,10,18,46,180.02,212
457,a1011,20100120,3905,3913,3860,3880,3851,3868,3871,-45,-42,74,286.51,264
458,a1011,20100121,3868,3871,3867,3880,3852,3879,3867,8,-4,20,77.34,274
459,a1011,20100122,3879,3867,3834,3834,3822,3822,3830,-45,-37,6,22.98,274
460,a1011,20100125,3822,3830,3878,3904,3849,3879,3868,49,38,22,85.12,270
461,a1011,20100126,3879,3868,3866,3907,3865,3867,3874,-1,6,104,402.93,256
462,a1011,20100127,3867,3874,3888,3915,3888,3900,3903,26,29,30,117.1,266
463,a1011,20100128,3900,3903,3878,3878,3826,3840,3842,-63,-61,72,276.66,260
464,a1011,20100129,3840,3842,3849,3856,3849,3850,3850,8,8,12,46.21,252
465,a1011,20100201,3850,3850,3810,3813,3750,3750,3775,-100,-75,44,166.14,242
466,a1011,20100202,3750,3775,3770,3770,3700,3704,3721,-71,-54,142,528.41,244
467,a1011,20100203,3704,3721,3754,3773,3722,3773,3745,52,24,58,217.22,230
468,a1011,20100204,3773,3745,3705,3741,3705,3741,3730,-4,-15,74,276.09,260
469,a1011,20100205,3741,3730,3739,3770,3715,3765,3751,35,21,94,352.66,214
470,a1011,20100208,3765,3751,3765,3791,3765,3791,3773,40,22,6,22.64,212
471,a1011,20100209,3791,3773,3806,3806,3760,3776,3775,3,2,180,679.62,228
472,a1011,20100210,3776,3775,3787,3787,3731,3731,3750,-44,-25,120,450,232
473,a1011,20100211,3731,3750,3678,3800,3678,3764,3763,14,13,218,820.34,138
474,a1011,20100212,3764,3763,3767,3782,3733,3733,3752,-30,-11,64,240.16,146
475,a1011,20100222,3733,3752,3872,3872,3766,3781,3779,29,27,30,113.4,130
476,a1011,20100223,3781,3779,3819,3865,3801,3840,3826,61,47,48,183.66,136
477,a1011,20100224,3840,3826,3800,3844,3800,3823,3821,-3,-5,12,45.85,138
478,a1011,20100225,3823,3821,3851,3851,3789,3795,3811,-26,-10,64,243.95,126
479,a1011,20100226,3795,3811,3785,3796,3785,3790,3790,-21,-21,12,45.48,120
480,a1011,20100301,3790,3790,3800,3850,3800,3841,3826,51,36,106,405.58,124
481,a1011,20100302,3841,3826,3836,3884,3826,3826,3852,0,26,324,1248.07,136
482,a1011,20100303,3826,3852,3849,3859,3843,3851,3850,-1,-2,66,254.15,156
483,a1011,20100304,3851,3850,3821,3835,3818,3818,3829,-32,-21,86,329.33,178
484,a1011,20100305,3818,3829,3785,3812,3785,3801,3799,-28,-30,72,273.59,180
485,a1011,20100308,3801,3799,0,0,0,3799,3799,0,0,0,0,180
486,a1011,20100309,3799,3799,3816,3828,3810,3817,3817,18,18,28,106.9,186
487,a1011,20100310,3817,3817,3815,3816,3815,3816,3815,-1,-2,24,91.56,168
488,a1011,20100311,3816,3815,3859,3859,3806,3823,3832,8,17,104,398.56,148
489,a1011,20100312,3823,3832,3820,3820,3764,3788,3790,-44,-42,60,227.4,148
490,a1011,20100315,3788,3790,3776,3776,3775,3775,3775,-15,-15,4,15.1,148
491,a1011,20100316,3775,3775,3807,3874,3781,3803,3792,28,17,6720,25483.74,558
492,a1011,20100317,3803,3792,3803,3832,3803,3818,3818,26,26,52,198.57,566
493,a1011,20100318,3818,3818,3818,3818,3805,3814,3814,-4,-4,408,1556.22,162
494,a1011,20100319,3814,3814,3824,3848,3824,3840,3839,26,25,36,138.24,146
495,a1011,20100322,3840,3839,3827,3858,3827,3848,3853,9,14,148,570.3,258
496,a1011,20100323,3848,3853,3869,3869,3841,3850,3854,-3,1,26,100.22,260
497,a1011,20100324,3850,3854,3835,3847,3833,3833,3836,-21,-18,26,99.75,268
498,a1011,20100325,3833,3836,3833,3839,3833,3839,3837,3,1,6,23.02,266
499,a1011,20100326,3839,3837,3826,3835,3815,3835,3823,-2,-14,36,137.64,268
500,a1011,20100329,3835,3823,3841,3845,3841,3845,3843,22,20,10,38.43,266
501,a1011,20100330,3845,3843,3863,3866,3835,3865,3857,22,14,46,177.46,258
502,a1011,20100331,3865,3857,3870,3885,3861,3872,3870,15,13,116,448.99,306
503,a1011,20100401,3872,3870,3855,3855,3842,3845,3846,-25,-24,52,200.04,302
504,a1011,20100402,3845,3846,3850,3850,3845,3845,3847,-1,1,4,15.39,304
505,a1011,20100406,3845,3847,3838,3865,3838,3859,3857,12,10,20,77.15,298
506,a1011,20100407,3859,3857,3865,3889,3865,3880,3881,23,24,94,364.85,284
507,a1011,20100408,3880,3881,3890,3909,3879,3879,3893,-2,12,130,506.16,258
508,a1011,20100409,3879,3893,3895,3895,3872,3886,3883,-7,-10,72,279.6,232
509,a1011,20100412,3886,3883,3914,3914,3900,3912,3906,29,23,144,562.58,208
510,a1011,20100413,3912,3906,3891,3909,3891,3908,3906,2,0,32,124.99,184
511,a1011,20100414,3908,3906,3956,3956,3926,3930,3940,24,34,224,882.73,232
512,a1011,20100415,3930,3940,3926,3930,3916,3916,3922,-24,-18,64,251.01,222
513,a1011,20100416,3916,3922,3954,3954,3932,3943,3941,21,19,78,307.4,262
514,a1011,20100419,3943,3941,3970,3970,3900,3908,3918,-33,-23,158,619.14,238
515,a1011,20100420,3908,3918,3917,3940,3915,3922,3920,4,2,116,454.77,162
516,a1011,20100421,3922,3920,3955,3955,3916,3929,3935,9,15,770,3029.95,158
517,a1011,20100422,3929,3935,3967,3967,3932,3932,3947,-3,12,108,426.32,166
518,a1011,20100423,3932,3947,3983,3988,3941,3954,3953,7,6,122,482.34,146
519,a1011,20100426,3954,3953,3959,3960,3930,3950,3953,-3,0,86,339.98,136
520,a1011,20100427,3950,3953,3950,3950,3926,3936,3937,-17,-16,52,204.72,138
521,a1011,20100428,3936,3937,3902,3924,3900,3904,3905,-33,-32,56,218.7,138
522,a1011,20100429,3904,3905,3915,3915,3910,3910,3913,5,8,14,54.79,130
523,a1011,20100430,3910,3913,3893,3930,3881,3930,3913,17,0,82,320.92,122
524,a1011,20100504,3930,3913,3946,3946,3901,3918,3918,5,5,86,337,148
525,a1011,20100505,3918,3918,3935,3955,3913,3955,3937,37,19,82,322.9,110
526,a1011,20100506,3955,3937,3980,3994,3912,3930,3948,-7,11,74,292.18,98
527,a1011,20100507,3930,3948,3901,3938,3855,3862,3889,-86,-59,278,1081.3,108
528,a1011,20100510,3862,3889,3890,3910,3867,3905,3876,16,-13,2180,8450.95,1430
529,a1011,20100511,3905,3876,3896,3903,3895,3900,3896,24,20,620,2416.1,1106
530,a1011,20100512,3900,3896,3912,3912,3912,3912,3912,16,16,10,39.12,1104
531,a1011,20100513,3912,3912,3952,3952,3883,3926,3927,14,15,958,3762.85,292
532,a1011,20100514,3926,3927,3927,3927,3898,3906,3915,-21,-12,54,211.41,282
533,a1011,20100517,3906,3915,3850,3873,3817,3833,3845,-82,-70,732,2815.09,436
534,a1011,20100518,3833,3845,3826,3868,3815,3849,3847,4,2,252,969.59,400
535,a1011,20100519,3849,3847,3830,3834,3816,3824,3827,-23,-20,70,267.93,392
536,a1011,20100520,3824,3827,3836,3836,3817,3825,3828,-2,1,76,290.93,374
537,a1011,20100521,3825,3828,3826,3859,3826,3853,3847,25,19,200,769.4,370
538,a1011,20100524,3853,3847,3841,3860,3841,3860,3852,13,5,128,493.15,324
539,a1011,20100525,3860,3852,3838,3850,3814,3819,3832,-33,-20,132,505.89,294
540,a1011,20100526,3819,3832,3840,3845,3820,3845,3828,13,-4,52,199.1,304
541,a1011,20100527,3845,3828,3858,3858,3835,3839,3842,11,14,92,353.54,290
542,a1011,20100528,3839,3842,3884,3884,3841,3847,3851,5,9,66,254.2,286
543,a1011,20100531,3847,3851,3821,3852,3801,3815,3822,-36,-29,370,1414.39,292
544,a1011,20100601,3815,3822,3813,3815,3790,3795,3803,-27,-19,76,289.04,268
545,a1011,20100602,3795,3803,3803,3820,3795,3820,3802,17,-1,42,159.72,254
546,a1011,20100603,3820,3802,3805,3824,3801,3809,3809,7,7,70,266.68,252
547,a1011,20100604,3809,3809,3832,3832,3812,3816,3821,7,12,88,336.26,234
548,a1011,20100607,3816,3821,3781,3781,3757,3757,3766,-64,-55,56,210.91,228
549,a1011,20100608,3757,3766,3757,3785,3757,3772,3777,6,11,128,483.46,196
550,a1011,20100609,3772,3777,3780,3780,3739,3763,3751,-14,-26,158,592.66,238
551,a1011,20100610,3763,3751,3789,3790,3770,3779,3777,28,26,150,566.64,228
552,a1011,20100611,3779,3777,3790,3790,3755,3755,3773,-22,-4,158,596.19,266
553,a1011,20100617,3755,3773,3810,3810,3782,3793,3797,20,24,166,630.43,196
554,a1011,20100618,3793,3797,3808,3808,3795,3796,3799,-1,2,134,509.08,170
555,a1011,20100621,3796,3799,3819,3848,3806,3848,3821,49,22,50,191.08,176
556,a1011,20100622,3848,3821,3855,3855,3827,3827,3832,6,11,38,145.63,174
557,a1011,20100623,3827,3832,3805,3828,3805,3823,3821,-9,-11,58,221.66,162
558,a1011,20100624,3823,3821,3820,3837,3820,3820,3821,-1,0,20,76.44,160
559,a1011,20100625,3820,3821,3835,3835,3800,3800,3808,-21,-13,22,83.79,164
560,a1011,20100628,3800,3808,3814,3814,3794,3806,3805,-2,-3,16,60.89,158
561,a1011,20100629,3806,3805,3819,3830,3801,3801,3813,-4,8,42,160.18,156
562,a1011,20100630,3801,3813,3802,3802,3776,3781,3786,-32,-27,12,45.43,154
563,a1011,20100701,3781,3786,3790,3790,3785,3785,3787,-1,1,16,60.6,166
564,a1011,20100702,3785,3787,3800,3800,3781,3800,3795,13,8,44,166.98,130
565,a1011,20100705,3800,3795,3826,3826,3792,3797,3800,2,5,42,159.62,140
566,a1011,20100706,3797,3800,3782,3789,3781,3785,3784,-15,-16,42,158.97,142
567,a1011,20100707,3785,3784,3794,3810,3788,3788,3798,4,14,100,379.86,154
568,a1011,20100708,3788,3798,3828,3828,3815,3827,3820,29,22,90,343.82,148
569,a1011,20100709,3827,3820,3820,3833,3820,3833,3828,13,8,148,566.61,134
570,a1011,20100712,3833,3828,3839,3840,3821,3821,3831,-7,3,42,160.93,132
571,a1011,20100713,3821,3831,3816,3816,3807,3807,3814,-24,-17,36,137.32,158
572,a1011,20100714,3807,3814,3815,3820,3811,3819,3816,5,2,32,122.13,142
573,a1011,20100715,3819,3816,3819,3830,3815,3815,3822,-1,6,74,282.87,156
574,a1011,20100716,3815,3822,3820,3849,3820,3834,3838,12,16,44,168.9,148
575,a1011,20100719,3834,3838,3825,3825,3821,3821,3822,-17,-16,8,30.58,144
576,a1011,20100720,3821,3822,3809,3835,3809,3835,3816,13,-6,32,122.14,132
577,a1011,20100721,3835,3816,3840,3840,3828,3828,3830,12,14,20,76.6,124
578,a1011,20100722,3828,3830,3823,3841,3823,3830,3839,0,9,46,176.61,126
579,a1011,20100723,3830,3839,3849,3870,3749,3749,3822,-90,-17,60,229.32,124
580,a1011,20100726,3749,3822,3819,3838,3819,3837,3832,15,10,66,252.92,134
581,a1011,20100727,3837,3832,3840,3840,3806,3807,3811,-25,-21,70,266.82,140
582,a1011,20100728,3807,3811,3809,3815,3803,3814,3809,3,-2,36,137.14,138
583,a1011,20100729,3814,3809,3816,3848,3816,3848,3830,39,21,12,45.97,138
584,a1011,20100730,3848,3830,3825,3845,3825,3826,3836,-4,6,54,207.17,142
585,a1011,20100802,3826,3836,3880,3880,3850,3870,3866,34,30,120,463.95,140
586,a1011,20100803,3870,3866,3872,3920,3860,3879,3877,13,11,88,341.25,148
587,a1011,20100804,3879,3877,3890,3895,3870,3878,3881,1,4,48,186.3,136
588,a1011,20100805,3878,3881,3860,3860,3840,3840,3850,-41,-31,26,100.11,140
589,a1011,20100806,3840,3850,3846,3950,3839,3851,3881,1,31,102,395.88,166
590,a1011,20100809,3851,3881,3897,3935,3897,3916,3916,35,35,40,156.65,162
591,a1011,20100810,3916,3916,3895,3909,3885,3893,3896,-23,-20,34,132.48,160
592,a1011,20100811,3893,3896,3898,3898,3881,3890,3886,-6,-10,10,38.86,164
593,a1011,20100812,3890,3886,3870,3917,3870,3890,3893,4,7,90,350.44,138
594,a1011,20100813,3890,3893,3895,3902,3895,3902,3900,9,7,22,85.8,122
595,a1011,20100816,3902,3900,3938,3949,3910,3934,3933,34,33,82,322.58,136
596,a1011,20100817,3934,3933,3890,3910,3890,3910,3905,-23,-28,8,31.24,136
597,a1011,20100818,3910,3905,3926,3933,3856,3856,3899,-49,-6,26,101.38,136
598,a1011,20100819,3856,3899,3861,3889,3861,3874,3872,-25,-27,68,263.35,130
599,a1011,20100820,3874,3872,3855,3855,3845,3845,3852,-27,-20,8,30.82,132
600,a1011,20100823,3845,3852,3890,3890,3833,3844,3863,-8,11,164,633.58,170
601,a1011,20100824,3844,3863,3836,3850,3833,3835,3837,-28,-26,32,122.79,182
602,a1011,20100825,3835,3837,3820,3820,3810,3810,3814,-27,-23,16,61.03,184
603,a1011,20100826,3810,3814,3800,3810,3800,3810,3804,-4,-10,10,38.04,182
604,a1011,20100827,3810,3804,3829,3829,3801,3821,3816,17,12,110,419.84,196
605,a1011,20100830,3821,3816,3825,3850,3825,3845,3843,29,27,80,307.46,164
606,a1011,20100831,3845,3843,3807,3807,3800,3800,3804,-43,-39,28,106.52,164
607,a1011,20100901,3800,3804,3800,3810,3791,3804,3802,0,-2,12,45.63,168
608,a1011,20100902,3804,3802,3795,3795,3795,3795,3795,-7,-7,2,7.59,166
609,a1011,20100903,3795,3795,3801,3801,3800,3801,3800,6,5,20,76.01,164
610,a1011,20100906,3801,3800,3845,3845,3836,3836,3842,36,42,62,238.25,178
611,a1011,20100907,3836,3842,3830,3850,3818,3845,3827,3,-15,296,1133.06,204
612,a1011,20100908,3845,3827,3847,3854,3847,3854,3849,27,22,18,69.3,208
613,a1011,20100909,3854,3849,3800,3840,3756,3810,3802,-39,-47,40,152.11,228
614,a1011,20100910,3810,3802,0,0,0,3802,3802,0,0,0,0,228
615,a1011,20100913,3802,3802,3842,3842,3810,3812,3818,10,16,20,76.37,216
616,a1011,20100914,3812,3818,3839,3839,3799,3817,3811,-1,-7,20,76.22,212
617,a1011,20100915,3817,3811,3858,3858,3800,3804,3818,-7,7,8,30.54,216
618,a1011,20100916,3804,3818,3825,3850,3814,3815,3828,-3,10,156,597.25,236
619,a1011,20100917,3815,3828,3840,3840,3815,3815,3820,-13,-8,10,38.2,234
620,a1011,20100920,3815,3820,3900,3920,3752,3880,3834,60,14,750,2875.53,494
621,a1011,20100921,3880,3834,3850,3869,3806,3806,3852,-28,18,60,231.16,488
622,a1011,20100927,3806,3852,3920,3950,3880,3905,3920,53,68,258,1011.51,508
623,a1011,20100928,3905,3920,3874,3914,3874,3914,3904,-6,-16,68,265.49,524
624,a1011,20100929,3914,3904,3870,3898,3866,3866,3879,-38,-25,10,38.8,524
625,a1011,20100930,3866,3879,3875,3898,3875,3880,3888,1,9,20,77.76,522
626,a1011,20101008,3880,3888,3908,3908,3860,3860,3882,-28,-6,124,481.46,534
627,a1011,20101011,3860,3882,3950,4037,3950,4037,4023,155,141,118,474.79,536
628,a1011,20101012,4037,4023,3950,4027,3921,4000,3963,-23,-60,88,348.78,508
629,a1011,20101013,4000,3963,4000,4040,3981,4020,4000,57,37,26,104.01,514
630,a1011,20101014,4020,4000,4025,4025,3982,4001,4011,1,11,28,112.31,502
631,a1011,20101015,4001,4011,4001,4029,3856,4029,3994,18,-17,112,447.33,494
632,a1011,20101018,4029,3994,4000,4000,3957,3987,3984,-7,-10,38,151.41,486
633,a1011,20101019,3987,3984,3998,3999,3985,3992,3991,8,7,50,199.59,478
634,a1011,20101020,3992,3991,3995,3995,3935,3961,3959,-30,-32,44,174.24,462
635,a1011,20101021,3961,3959,3970,4025,3970,3996,4011,37,52,68,272.76,438
636,a1011,20101022,3996,4011,4030,4030,3990,4008,3997,-3,-14,32,127.93,424
637,a1011,20101025,4008,3997,3950,4078,3950,4078,4027,81,30,74,298.07,418
638,a1011,20101026,4078,4027,4080,4080,4021,4022,4043,-5,16,224,905.71,310
639,a1011,20101027,4022,4043,4050,4050,3981,3982,4002,-61,-41,20,80.05,300
640,a1011,20101028,3982,4002,4025,4025,3850,3983,3974,-19,-28,60,238.49,294
641,a1011,20101029,3983,3974,3950,3989,3935,3935,3945,-39,-29,48,189.4,294
642,a1011,20101101,3935,3945,3930,3990,3930,3990,3960,45,15,4,15.84,116
643,a1011,20101102,3990,3960,4085,4088,4017,4017,4051,57,91,16,64.83,116
644,a1011,20101103,4017,4051,0,0,0,4051,4051,0,0,0,0,116
645,a1011,20101104,4051,4051,0,0,0,4051,4051,0,0,0,0,116
646,a1011,20101105,4051,4051,4150,4150,4150,4150,4150,99,99,2,8.3,114
647,a1011,20101108,4150,4150,0,0,0,4150,4150,0,0,0,0,114
648,a1011,20101109,4150,4150,4160,4185,4160,4180,4176,30,26,14,58.47,2
649,a1011,20101110,4180,4176,0,0,0,4176,4176,0,0,0,0,2
650,a1011,20101111,4176,4176,0,0,0,4176,4176,0,0,0,0,0
651,a1011,20101112,4176,4176,0,0,0,4176,4095,0,-81,0,0,0
652,a1101,20100104,3970,3958,4000,4088,3985,4004,4001,46,43,2624,10500.5,13600
653,a1101,20100105,4004,4001,4018,4023,4000,4010,4009,9,8,2300,9222.19,13542
654,a1101,20100106,4010,4009,4001,4106,3997,4081,4066,72,57,4910,19965.26,12096
655,a1101,20100107,4081,4066,4100,4105,3904,3975,4014,-91,-52,4856,19495.96,12210
656,a1101,20100108,3975,4014,3958,3977,3891,3926,3933,-88,-81,3652,14364.07,12576
657,a1101,20100111,3926,3933,3941,3989,3941,3975,3976,42,43,3596,14299.45,13110
658,a1101,20100112,3975,3976,3968,3968,3918,3933,3934,-43,-42,7616,29962.09,15102
659,a1101,20100113,3933,3934,3868,3891,3831,3863,3862,-71,-72,6680,25804.35,16222
660,a1101,20100114,3863,3862,3896,3897,3871,3874,3882,12,20,3590,13937.15,17004
661,a1101,20100115,3874,3882,3866,3890,3858,3862,3870,-20,-12,3738,14469.05,17086
662,a1101,20100118,3862,3870,3838,3866,3838,3856,3855,-14,-15,3158,12176.04,17492
663,a1101,20100119,3856,3855,3866,3876,3860,3865,3867,10,12,2542,9830.67,18002
664,a1101,20100120,3865,3867,3867,3868,3808,3810,3829,-57,-38,4558,17455.24,19368
665,a1101,20100121,3810,3829,3818,3843,3800,3832,3820,3,-9,5494,20990.35,20194
666,a1101,20100122,3832,3820,3812,3819,3783,3818,3810,-2,-10,11892,45311.13,20060
667,a1101,20100125,3818,3810,3818,3854,3811,3846,3839,36,29,4336,16647.91,20156
668,a1101,20100126,3846,3839,3837,3852,3820,3823,3835,-16,-4,4742,18189.66,21078
669,a1101,20100127,3823,3835,3845,3854,3835,3846,3842,11,7,4070,15638.3,20942
670,a1101,20100128,3846,3842,3825,3825,3768,3789,3796,-53,-46,6172,23431.72,21816
671,a1101,20100129,3789,3796,3796,3806,3773,3777,3792,-19,-4,2430,9216.39,21532
672,a1101,20100201,3777,3792,3758,3773,3709,3715,3731,-77,-61,9148,34134.51,22902
673,a1101,20100202,3715,3731,3731,3737,3670,3678,3697,-53,-34,17750,65630.67,32230
674,a1101,20100203,3678,3697,3719,3725,3688,3724,3709,27,12,9352,34692.66,35136
675,a1101,20100204,3724,3709,3700,3704,3677,3697,3690,-12,-19,5598,20657.38,36514
676,a1101,20100205,3697,3690,3680,3730,3677,3727,3715,37,25,10082,37457.82,38188
677,a1101,20100208,3727,3715,3738,3767,3735,3754,3748,39,33,4300,16117.51,38322
678,a1101,20100209,3754,3748,3756,3761,3742,3751,3749,3,1,3242,12156.52,37686
679,a1101,20100210,3751,3749,3750,3758,3692,3701,3714,-48,-35,15858,58901.11,43012
680,a1101,20100211,3701,3714,3731,3745,3720,3727,3732,13,18,8258,30822.22,42464
681,a1101,20100212,3727,3732,3731,3735,3701,3714,3714,-18,-18,4578,17003.08,42918
682,a1101,20100222,3714,3714,3748,3757,3732,3745,3733,31,19,13186,49230.02,43024
683,a1101,20100223,3745,3733,3751,3802,3751,3792,3772,59,39,29622,111759.15,47722
684,a1101,20100224,3792,3772,3772,3787,3770,3779,3774,7,2,21936,82801.65,47654
685,a1101,20100225,3779,3774,3850,3850,3755,3770,3774,-4,0,12496,47169.93,48248
686,a1101,20100226,3770,3774,3766,3780,3758,3764,3766,-10,-8,7788,29333.61,48858
687,a1101,20100301,3764,3766,3795,3817,3779,3806,3798,40,32,14706,55864.76,48490
688,a1101,20100302,3806,3798,3810,3816,3790,3796,3803,-2,5,17564,66801.78,48406
689,a1101,20100303,3796,3803,3803,3822,3800,3810,3812,7,9,10106,38525.61,48046
690,a1101,20100304,3810,3812,3814,3814,3768,3770,3786,-42,-26,14988,56747.8,48554
691,a1101,20100305,3770,3786,3763,3774,3750,3772,3760,-14,-26,10320,38804.86,49372
692,a1101,20100308,3772,3760,3770,3796,3768,3792,3783,32,23,16726,63291.08,50546
693,a1101,20100309,3792,3783,3791,3799,3778,3794,3789,11,6,9180,34789.22,49892
694,a1101,20100310,3794,3789,3793,3802,3782,3784,3792,-5,3,12044,45679.63,50158
695,a1101,20100311,3784,3792,3803,3814,3772,3790,3794,-2,2,25038,95010.7,54466
696,a1101,20100312,3790,3794,3750,3772,3750,3761,3760,-33,-34,17580,66103.07,56446
697,a1101,20100315,3761,3760,3760,3768,3746,3751,3756,-9,-4,18314,68793.8,61616
698,a1101,20100316,3751,3756,3756,3799,3753,3798,3774,42,18,16206,61167.49,60732
699,a1101,20100317,3798,3774,3806,3810,3789,3793,3795,19,21,30532,115893.26,61178
700,a1101,20100318,3793,3795,3792,3800,3780,3785,3788,-10,-7,18346,69507.11,60566
701,a1101,20100319,3785,3788,3790,3820,3788,3815,3810,27,22,33024,125841.89,63638
702,a1101,20100322,3815,3810,3815,3829,3804,3819,3818,9,8,36324,138686.74,68828
703,a1101,20100323,3819,3818,3833,3851,3817,3825,3837,7,19,40194,154225.02,70074
704,a1101,20100324,3825,3837,3825,3827,3802,3803,3813,-34,-24,23232,88590.85,73886
705,a1101,20100325,3803,3813,3810,3823,3802,3813,3815,0,2,17598,67148.5,74928
706,a1101,20100326,3813,3815,3800,3807,3792,3807,3799,-8,-16,27076,102872.69,80656
707,a1101,20100329,3807,3799,3811,3833,3805,3825,3821,26,22,35324,134978.61,84198
708,a1101,20100330,3825,3821,3833,3847,3815,3835,3833,14,12,41410,158743.76,83340
709,a1101,20100331,3835,3833,3833,3848,3829,3830,3837,-3,4,47562,182538.92,83756
710,a1101,20100401,3830,3837,3800,3820,3799,3815,3813,-22,-24,31966,121888.81,84304
711,a1101,20100402,3815,3813,3820,3829,3818,3828,3825,15,12,23976,91711.12,82972
712,a1101,20100406,3828,3825,3828,3837,3820,3828,3831,3,6,23012,88166.23,83676
713,a1101,20100407,3828,3831,3840,3870,3833,3864,3852,33,21,61834,238204.69,91770
714,a1101,20100408,3864,3852,3853,3898,3853,3862,3879,10,27,97382,377756.63,100006
715,a1101,20100409,3862,3879,3868,3892,3862,3890,3880,11,1,55004,213447.81,102528
716,a1101,20100412,3890,3880,3905,3935,3902,3930,3915,50,35,99120,388113.34,106832
717,a1101,20100413,3930,3915,3915,3947,3902,3945,3924,30,9,249366,978732.7,120090
718,a1101,20100414,3945,3924,3960,3964,3936,3939,3948,15,24,173136,683619.91,103704
719,a1101,20100415,3939,3948,3938,3949,3926,3929,3937,-19,-11,96066,378261.18,102586
720,a1101,20100416,3929,3937,3952,3968,3945,3953,3955,16,18,126732,501260.13,110568
721,a1101,20100419,3953,3955,3940,3950,3903,3916,3928,-39,-27,136534,536385.03,111184
722,a1101,20100420,3916,3928,3931,3962,3931,3956,3951,28,23,192604,761120.06,126296
723,a1101,20100421,3956,3951,3960,3979,3955,3971,3969,20,18,231448,918636.37,144388
724,a1101,20100422,3971,3969,3978,3995,3977,3981,3985,12,16,213782,852070.74,157868
725,a1101,20100423,3981,3985,3986,4005,3986,3992,3995,7,10,228426,912685.72,166058
726,a1101,20100426,3992,3995,3998,4005,3980,3990,3993,-5,-2,171704,685653.25,157204
727,a1101,20100427,3990,3993,3980,3982,3958,3973,3969,-20,-24,143266,568636.32,148294
728,a1101,20100428,3973,3969,3943,3955,3906,3949,3940,-20,-29,147676,581945.61,146168
729,a1101,20100429,3949,3940,3950,3964,3950,3953,3957,13,17,73382,290391.02,147088
730,a1101,20100430,3953,3957,3957,3989,3953,3988,3965,31,8,128442,509357.54,150710
731,a1101,20100504,3988,3965,3965,3974,3956,3965,3963,0,-2,109026,432151.32,147120
732,a1101,20100505,3965,3963,3964,4031,3948,4026,4006,63,43,539238,2160696.68,236426
733,a1101,20100506,4026,4006,4025,4027,3972,3977,3995,-29,-11,489972,1957925.33,206120
734,a1101,20100507,3977,3995,3940,3944,3899,3911,3923,-84,-72,379706,1489782.65,194340
735,a1101,20100510,3911,3923,3940,3960,3928,3955,3944,32,21,261150,1030199.74,203512
736,a1101,20100511,3955,3944,3948,3952,3923,3928,3936,-16,-8,237636,935513.72,199814
737,a1101,20100512,3928,3936,3939,3971,3935,3958,3958,22,22,226094,894937.92,195902
738,a1101,20100513,3958,3958,3958,3966,3941,3956,3952,-2,-6,138812,548592.85,196232
739,a1101,20100514,3956,3952,3953,3955,3912,3923,3933,-29,-19,169968,668534.07,200978
740,a1101,20100517,3923,3933,3910,3912,3809,3843,3851,-90,-82,305380,1176041.28,205728
741,a1101,20100518,3843,3851,3840,3873,3825,3869,3856,18,5,210406,811505.94,203712
742,a1101,20100519,3869,3856,3835,3859,3827,3831,3842,-25,-14,178838,687197.2,198688
743,a1101,20100520,3831,3842,3850,3863,3836,3847,3851,5,9,164612,633945.42,199584
744,a1101,20100521,3847,3851,3844,3883,3840,3872,3866,21,15,328810,1271225.52,203494
745,a1101,20100524,3872,3866,3872,3890,3866,3886,3879,20,13,165108,640498.11,202658
746,a1101,20100525,3886,3879,3875,3875,3841,3846,3856,-33,-23,161154,621503.85,197734
747,a1101,20100526,3846,3856,3859,3880,3830,3874,3862,18,6,260208,1004980.25,210034
748,a1101,20100527,3874,3862,3879,3879,3859,3872,3868,10,6,172790,668435.78,199878
749,a1101,20100528,3872,3868,3882,3894,3864,3868,3878,0,10,219636,851864.26,201002
750,a1101,20100531,3868,3878,3854,3857,3831,3832,3844,-46,-34,179904,691627.58,208090
751,a1101,20100601,3832,3844,3838,3843,3806,3811,3821,-33,-23,175060,669059.15,206462
752,a1101,20100602,3811,3821,3800,3829,3800,3827,3818,6,-3,180870,690708.71,205608
753,a1101,20100603,3827,3818,3824,3840,3823,3830,3831,12,13,137288,525962.24,205006
754,a1101,20100604,3830,3831,3852,3856,3832,3842,3844,11,13,102152,392719.74,199150
755,a1101,20100607,3842,3844,3781,3798,3772,3789,3788,-55,-56,120568,456724.55,204794
756,a1101,20100608,3789,3788,3790,3818,3789,3807,3806,19,18,116218,442343.35,207114
757,a1101,20100609,3807,3806,3800,3800,3768,3796,3784,-10,-22,159430,603387.07,197242
758,a1101,20100610,3796,3784,3800,3821,3793,3800,3807,16,23,130832,498110.99,188042
759,a1101,20100611,3800,3807,3801,3809,3790,3795,3798,-12,-9,73402,278842.48,182804
760,a1101,20100617,3795,3798,3846,3846,3818,3823,3829,25,31,71140,272410.74,172496
761,a1101,20100618,3823,3829,3828,3838,3821,3830,3830,1,1,94266,361126.29,172690
762,a1101,20100621,3830,3830,3848,3888,3845,3882,3868,52,38,124578,481868.5,175674
763,a1101,20100622,3882,3868,3869,3875,3861,3870,3867,2,-1,55036,212834.42,175472
764,a1101,20100623,3870,3867,3852,3873,3851,3863,3862,-4,-5,62360,240858.66,172590
765,a1101,20100624,3863,3862,3855,3869,3853,3859,3861,-3,-1,49000,189221.76,171678
766,a1101,20100625,3859,3861,3849,3854,3838,3846,3845,-15,-16,38052,146343.91,171360
767,a1101,20100628,3846,3845,3844,3859,3842,3854,3854,9,9,48758,187936.37,174068
768,a1101,20100629,3854,3854,3856,3868,3828,3846,3851,-8,-3,77006,296550.56,170908
769,a1101,20100630,3846,3851,3832,3835,3811,3822,3821,-29,-30,47202,180371.56,171230
770,a1101,20100701,3822,3821,3812,3825,3812,3814,3819,-7,-2,31824,121544.15,172500
771,a1101,20100702,3814,3819,3815,3841,3815,3833,3827,14,8,48998,187516.19,172704
772,a1101,20100705,3833,3827,3825,3839,3820,3821,3825,-6,-2,29400,112473.52,172788
773,a1101,20100706,3821,3825,3820,3820,3794,3808,3804,-17,-21,67110,255348.58,175464
774,a1101,20100707,3808,3804,3805,3818,3804,3811,3811,7,7,29922,114045.11,174700
775,a1101,20100708,3811,3811,3859,3859,3841,3846,3848,35,37,56018,215602.38,163782
776,a1101,20100709,3846,3848,3860,3865,3843,3859,3854,11,6,86356,332859.44,161118
777,a1101,20100712,3859,3854,3888,3888,3848,3850,3861,-4,7,56184,216971.44,159328
778,a1101,20100713,3850,3861,3859,3859,3828,3832,3844,-29,-17,45282,174090.37,156064
779,a1101,20100714,3832,3844,3844,3849,3840,3845,3843,1,-1,27884,107177.43,153726
780,a1101,20100715,3845,3843,3848,3869,3843,3849,3857,6,14,66088,254935.43,147396
781,a1101,20100716,3849,3857,3885,3894,3870,3879,3882,22,25,84852,329443.91,140564
782,a1101,20100719,3879,3882,3869,3881,3862,3879,3871,-3,-11,45596,176513.6,135012
783,a1101,20100720,3879,3871,3862,3888,3862,3881,3875,10,4,38832,150480.75,131674
784,a1101,20100721,3881,3875,3881,3898,3871,3873,3883,-2,8,40190,156070.9,120718
785,a1101,20100722,3873,3883,3878,3880,3862,3876,3871,-7,-12,27822,107719.42,117996
786,a1101,20100723,3876,3871,3877,3889,3875,3881,3883,10,12,33948,131821.73,113548
787,a1101,20100726,3881,3883,3876,3904,3875,3895,3894,12,11,35654,138838.15,109222
788,a1101,20100727,3895,3894,3878,3889,3861,3865,3870,-29,-24,26688,103290.45,103628
789,a1101,20100728,3865,3870,3863,3872,3859,3868,3865,-2,-5,16792,64901.08,101224
790,a1101,20100729,3868,3865,3882,3894,3871,3890,3883,25,18,26912,104500.79,92664
791,a1101,20100730,3890,3883,3915,3915,3897,3904,3905,21,22,24844,97022.36,84454
792,a1101,20100802,3904,3905,3950,3978,3929,3972,3956,67,51,42386,167700.88,76428
793,a1101,20100803,3972,3956,3956,3965,3934,3939,3950,-17,-6,16468,65065,74024
794,a1101,20100804,3939,3950,3950,3963,3929,3939,3946,-11,-4,27238,107504.08,69176
795,a1101,20100805,3939,3946,3958,3962,3902,3903,3928,-43,-18,21202,83297.42,68428
796,a1101,20100806,3903,3928,3920,3934,3903,3933,3919,5,-9,19960,78231.23,62300
797,a1101,20100809,3933,3919,3940,3992,3925,3970,3965,51,46,33142,131416.12,52624
798,a1101,20100810,3970,3965,3950,3957,3931,3938,3944,-27,-21,11400,44971.93,52282
799,a1101,20100811,3938,3944,3920,3951,3919,3922,3938,-22,-6,10492,41322.45,51030
800,a1101,20100812,3922,3938,3925,3960,3908,3932,3935,-6,-3,15504,61021.79,47274
801,a1101,20100813,3932,3935,3954,3971,3949,3969,3962,34,27,15972,63292.81,44976
802,a1101,20100816,3969,3962,3973,4006,3965,3996,3989,34,27,18446,73588.62,44576
803,a1101,20100817,3996,3989,3972,3988,3962,3986,3974,-3,-15,7932,31526.71,43854
804,a1101,20100818,3986,3974,4001,4024,3958,3969,3996,-5,22,10098,40358.21,42406
805,a1101,20100819,3969,3996,3970,3975,3940,3955,3957,-41,-39,6818,26984.08,42506
806,a1101,20100820,3955,3957,3940,3940,3883,3889,3901,-68,-56,11754,45854.41,41752
807,a1101,20100823,3889,3901,3889,3908,3882,3888,3894,-13,-7,6972,27152.68,41272
808,a1101,20100824,3888,3894,3890,3896,3868,3869,3885,-25,-9,4618,17942.32,40680
809,a1101,20100825,3869,3885,3878,3880,3851,3857,3866,-28,-19,7098,27440.97,41012
810,a1101,20100826,3857,3866,3882,3882,3866,3876,3871,10,5,3274,12676.02,41456
811,a1101,20100827,3876,3871,3883,3895,3880,3890,3887,19,16,4380,17025.41,42278
812,a1101,20100830,3890,3887,3914,3936,3906,3919,3922,32,35,5780,22674.19,42022
813,a1101,20100831,3919,3922,3899,3899,3861,3863,3879,-59,-43,4638,17993.05,41602
814,a1101,20100901,3863,3879,3871,3882,3855,3871,3870,-8,-9,3618,14005.26,41664
815,a1101,20100902,3871,3870,3870,3874,3859,3868,3867,-2,-3,3312,12809.55,41660
816,a1101,20100903,3868,3867,3869,3897,3869,3895,3885,28,18,4022,15627.48,42308
817,a1101,20100906,3895,3885,3910,3941,3910,3927,3928,42,43,4724,18559.42,42146
818,a1101,20100907,3927,3928,3930,3945,3915,3944,3934,16,6,5000,19672.61,42200
819,a1101,20100908,3944,3934,3968,3969,3921,3928,3942,-6,8,3374,13302.84,42192
820,a1101,20100909,3928,3942,3940,3940,3850,3886,3903,-56,-39,4436,17315.53,41952
821,a1101,20100910,3886,3903,3898,3899,3883,3894,3889,-9,-14,2834,11023.62,42114
822,a1101,20100913,3894,3889,3880,3889,3877,3889,3882,0,-7,1594,6189.33,41864
823,a1101,20100914,3889,3882,3880,3900,3876,3879,3884,-3,2,2570,9984.37,41262
824,a1101,20100915,3879,3884,3892,3895,3878,3890,3887,6,3,3896,15144.39,40924
825,a1101,20100916,3890,3887,3896,3900,3875,3882,3885,-5,-2,3134,12177.81,39880
826,a1101,20100917,3882,3885,3888,3895,3879,3886,3886,1,1,2416,9390.63,39626
827,a1101,20100920,3886,3886,3920,4014,3920,3985,3984,99,98,15760,62796.73,38154
828,a1101,20100921,3985,3984,3975,3975,3933,3948,3955,-36,-29,3454,13660.71,37750
829,a1101,20100927,3948,3955,4030,4095,3996,4009,4034,54,79,5114,20633.52,37886
830,a1101,20100928,4009,4034,3991,4021,3984,4018,3994,-16,-40,13816,55191.12,37348
831,a1101,20100929,4018,3994,3980,4000,3951,3980,3984,-14,-10,11890,47380.31,36934
832,a1101,20100930,3980,3984,3984,3984,3955,3980,3975,-4,-9,1412,5613.88,36666
833,a1101,20101008,3980,3975,3919,3975,3919,3954,3957,-21,-18,1290,5104.91,36432
834,a1101,20101011,3954,3957,4099,4115,4096,4115,4113,158,156,12318,50664.59,36326
835,a1101,20101012,4115,4113,4065,4104,4030,4074,4080,-39,-33,11322,46200.49,35942
836,a1101,20101013,4074,4080,4078,4114,4078,4100,4094,20,14,4202,17203.5,35258
837,a1101,20101014,4100,4094,4112,4115,4096,4105,4108,11,14,3220,13228.69,33938
838,a1101,20101015,4105,4108,4110,4120,4071,4110,4106,2,-2,3592,14750.09,33496
839,a1101,20101018,4110,4106,4092,4092,4059,4068,4070,-38,-36,3190,12985.93,33236
840,a1101,20101019,4068,4070,4078,4098,4068,4071,4075,1,5,2974,12121.66,33168
841,a1101,20101020,4071,4075,4060,4112,4021,4057,4059,-18,-16,5514,22381.94,32758
842,a1101,20101021,4057,4059,4098,4140,4088,4098,4117,39,58,6286,25884.16,32628
843,a1101,20101022,4098,4117,4061,4118,4061,4107,4109,-10,-8,2576,10584.82,31298
844,a1101,20101025,4107,4109,4116,4188,4116,4170,4156,61,47,3120,12967.52,31062
845,a1101,20101026,4170,4156,4180,4180,4125,4133,4141,-23,-15,2466,10212.59,29946
846,a1101,20101027,4133,4141,4161,4180,4051,4051,4092,-90,-49,3074,12580.1,29918
847,a1101,20101028,4051,4092,4086,4090,4060,4073,4074,-19,-18,836,3406.36,30000
848,a1101,20101029,4073,4074,4074,4074,4020,4044,4043,-30,-31,1544,6243.54,30382
849,a1101,20101101,4044,4043,4065,4113,4054,4102,4092,59,49,1714,7013.78,30388
850,a1101,20101102,4102,4092,4092,4104,4079,4100,4093,8,1,1836,7516.27,29500
851,a1101,20101103,4100,4093,4107,4119,4085,4095,4100,2,7,902,3698.69,29438
852,a1101,20101104,4095,4100,4120,4151,4104,4144,4130,44,30,1240,5121.7,29316
853,a1101,20101105,4144,4130,4170,4259,4170,4253,4221,123,91,6376,26915.66,28262
854,a1101,20101108,4253,4221,4230,4268,4188,4242,4244,21,23,2326,9872.82,28078
855,a1101,20101109,4242,4244,4250,4265,4216,4244,4241,0,-3,2660,11283.57,27474
856,a1101,20101110,4244,4241,4304,4339,4252,4278,4296,37,55,2528,10861.41,26968
857,a1101,20101111,4278,4296,4297,4343,4272,4305,4300,9,4,832,3577.74,26838
858,a1101,20101112,4305,4300,4336,4336,4150,4210,4197,-90,-103,3306,13878.41,25950
859,a1101,20101115,4210,4197,4186,4254,4112,4160,4164,-37,-33,3052,12710.33,25418
860,a1101,20101116,4160,4164,4178,4179,4118,4122,4134,-42,-30,1468,6069.26,25128
861,a1101,20101117,4122,4134,4109,4109,3970,3983,4001,-151,-133,6336,25354.63,25448
862,a1101,20101118,3983,4001,4035,4078,3961,4013,3999,12,-2,6238,24945.77,24680
863,a1101,20101119,4013,3999,4045,4045,3987,4022,4017,23,18,544,2185.52,24634
864,a1101,20101122,4022,4017,3978,4010,3975,3988,3990,-29,-27,1652,6593.06,24642
865,a1101,20101123,3988,3990,4004,4014,3988,4000,3997,10,7,1410,5636.63,25052
866,a1101,20101124,4000,3997,4027,4027,3997,4018,4009,21,12,588,2357.66,24982
867,a1101,20101125,4018,4009,4028,4028,4000,4001,4015,-8,6,300,1204.67,24950
868,a1101,20101126,4001,4015,4016,4016,3966,3982,3980,-33,-35,1116,4442.56,25122
869,a1101,20101129,3982,3980,3969,3978,3942,3975,3957,-5,-23,1244,4922.67,25040
870,a1101,20101130,3975,3957,3971,3971,3944,3962,3955,5,-2,1598,6320.21,24708
871,a1101,20101201,3962,3955,3953,3970,3953,3964,3964,9,9,380,1506.54,24598
872,a1101,20101202,3964,3964,3985,3999,3981,3995,3991,31,27,1068,4263.12,24390
873,a1101,20101203,3995,3991,3981,4011,3980,4002,3999,11,8,432,1727.73,24376
874,a1101,20101206,4002,3999,4028,4028,4000,4005,4013,6,14,194,778.65,24370
875,a1101,20101207,4005,4013,3982,3989,3973,3988,3980,-25,-33,182,724.4,24356
876,a1101,20101208,3988,3980,3967,3972,3950,3953,3963,-27,-17,412,1632.92,24348
877,a1101,20101209,3953,3963,3969,3975,3962,3963,3968,0,5,130,515.94,24336
878,a1101,20101210,3963,3968,3950,3969,3950,3960,3962,-8,-6,118,467.61,24342
879,a1101,20101213,3960,3962,3955,3977,3955,3958,3966,-4,4,82,325.23,24328
880,a1101,20101214,3958,3966,3977,3995,3969,3975,3980,9,14,244,971.25,24302
881,a1101,20101215,3975,3980,3963,3979,3945,3945,3963,-35,-17,282,1117.7,24284
882,a1101,20101216,3945,3963,3955,3955,3932,3951,3949,-12,-14,94,371.24,24300
883,a1101,20101217,3951,3949,3934,3960,3934,3948,3951,-1,2,438,1730.94,24276
884,a1101,20101220,3948,3951,3968,3978,3928,3941,3960,-10,9,916,3627.37,24288
885,a1101,20101221,3941,3960,3900,3969,3862,3947,3950,-13,-10,1208,4771.65,24224
886,a1101,20101222,3947,3950,3963,3963,3930,3931,3944,-19,-6,152,599.58,24210
887,a1101,20101223,3931,3944,3911,3948,3911,3942,3941,-2,-3,668,2632.92,24206
888,a1101,20101224,3942,3941,3950,4000,3935,3980,3976,39,35,2394,9520.05,23972
889,a1101,20101227,3980,3976,4001,4007,3931,3978,3990,2,14,612,2442.08,23946
890,a1101,20101228,3978,3990,4033,4034,3988,4000,3995,10,5,210,839.07,23954
891,a1101,20101229,4000,3995,4020,4020,3981,4001,3997,6,2,404,1614.87,23958
892,a1101,20101230,4001,3997,3981,4030,3981,4029,4003,32,6,200,800.69,23958
893,a1101,20101231,4029,4003,3992,4149,3990,4050,4040,47,37,3052,12332.74,21756
894,a1103,20100104,3971,3956,3989,4018,3989,4010,4006,54,50,16,64.1,100
895,a1103,20100105,4010,4006,4000,4020,4000,4016,4015,10,9,14,56.21,90
896,a1103,20100106,4016,4015,4010,4050,4010,4050,4044,35,29,26,105.17,90
897,a1103,20100107,4050,4044,4100,4100,3998,3998,4066,-46,22,62,252.15,64
898,a1103,20100108,3998,4066,3990,3990,3913,3940,3951,-126,-115,24,94.84,66
899,a1103,20100111,3940,3951,3980,3980,3980,3980,3980,29,29,2,7.96,64
900,a1103,20100112,3980,3980,3926,3959,3926,3959,3942,-21,-38,4,15.77,64
901,a1103,20100113,3959,3942,3889,3889,3847,3870,3869,-72,-73,32,123.82,68
902,a1103,20100114,3870,3869,0,0,0,3869,3869,0,0,0,0,68
903,a1103,20100115,3869,3869,0,0,0,3869,3869,0,0,0,0,68
904,a1103,20100118,3869,3869,0,0,0,3869,3869,0,0,0,0,68
905,a1103,20100119,3869,3869,3880,3880,3850,3850,3865,-19,-4,12,46.38,62
906,a1103,20100120,3850,3865,3845,3845,3820,3820,3832,-45,-33,8,30.66,62
907,a1103,20100121,3820,3832,3792,3815,3791,3811,3805,-21,-27,14,53.27,58
908,a1103,20100122,3811,3805,3829,3829,3798,3815,3812,10,7,10,38.12,60
909,a1103,20100125,3815,3812,3829,3841,3829,3841,3836,29,24,10,38.36,62
910,a1103,20100126,3841,3836,3845,3845,3845,3845,3845,9,9,4,15.38,62
911,a1103,20100127,3845,3845,3844,3866,3836,3860,3848,15,3,60,230.88,54
912,a1103,20100128,3860,3848,3785,3785,3785,3785,3785,-63,-63,2,7.57,54
913,a1103,20100129,3785,3785,0,0,0,3785,3785,0,0,0,0,54
914,a1103,20100201,3785,3785,3787,3787,3715,3715,3732,-70,-53,16,59.72,54
915,a1103,20100202,3715,3732,3701,3701,3670,3670,3680,-62,-52,6,22.08,50
916,a1103,20100203,3670,3680,0,0,0,3680,3680,0,0,0,0,50
917,a1103,20100204,3680,3680,0,0,0,3680,3680,0,0,0,0,50
918,a1103,20100205,3680,3680,3701,3701,3701,3701,3701,21,21,1800,6661.8,1850
919,a1103,20100208,3701,3701,3720,3750,3720,3750,3730,49,29,18,67.15,1852
920,a1103,20100209,3750,3730,3750,3750,3736,3736,3737,6,7,46,171.94,1846
921,a1103,20100210,3736,3737,3737,3737,3737,3737,3737,0,0,720,2690.64,1126
922,a1103,20100211,3737,3737,3742,3783,3710,3748,3741,11,4,460,1721.2,692
923,a1103,20100212,3748,3741,3718,3718,3700,3700,3709,-41,-32,4,14.84,690
924,a1103,20100222,3700,3709,3702,3740,3702,3740,3729,31,20,14,52.21,688
925,a1103,20100223,3740,3729,3720,3766,3716,3765,3744,36,15,14,52.42,688
926,a1103,20100224,3765,3744,3776,3776,3776,3776,3776,32,32,2,7.55,690
927,a1103,20100225,3776,3776,3795,3795,3755,3755,3768,-21,-8,10,37.68,692
928,a1103,20100226,3755,3768,0,0,0,3768,3768,0,0,0,0,692
929,a1103,20100301,3768,3768,3779,3808,3779,3805,3800,37,32,10,38,690
930,a1103,20100302,3805,3800,3809,3809,3809,3809,3809,9,9,2,7.62,688
931,a1103,20100303,3809,3809,0,0,0,3809,3809,0,0,0,0,688
932,a1103,20100304,3809,3809,0,0,0,3809,3809,0,0,0,0,688
933,a1103,20100305,3809,3809,3770,3770,3770,3770,3770,-39,-39,2,7.54,688
934,a1103,20100308,3770,3770,0,0,0,3770,3770,0,0,0,0,688
935,a1103,20100309,3770,3770,0,0,0,3770,3770,0,0,0,0,688
936,a1103,20100310,3770,3770,3772,3772,3772,3772,3772,2,2,1200,4526.4,1886
937,a1103,20100311,3772,3772,0,0,0,3772,3772,0,0,0,0,1886
938,a1103,20100312,3772,3772,3768,3768,3768,3768,3768,-4,-4,2,7.54,1888
939,a1103,20100315,3768,3768,0,0,0,3768,3768,0,0,0,0,1888
940,a1103,20100316,3768,3768,0,0,0,3768,3768,0,0,0,0,1888
941,a1103,20100317,3768,3768,3791,3791,3790,3790,3790,22,22,14,53.07,1890
942,a1103,20100318,3790,3790,3810,3810,3810,3810,3810,20,20,4,15.24,1894
943,a1103,20100319,3810,3810,3809,3812,3801,3811,3807,1,-3,22,83.77,1898
944,a1103,20100322,3811,3807,3815,3815,3808,3813,3811,6,4,26,99.1,1904
945,a1103,20100323,3813,3811,3827,3827,3827,3827,3827,16,16,4,15.31,1904
946,a1103,20100324,3827,3827,3810,3810,3804,3809,3807,-18,-20,20,76.16,1904
947,a1103,20100325,3809,3807,3810,3810,3810,3810,3810,3,3,2,7.62,1902
948,a1103,20100326,3810,3810,3809,3809,3797,3808,3800,-2,-10,14,53.21,1900
949,a1103,20100329,3808,3800,3812,3820,3810,3820,3814,20,14,24,91.55,1896
950,a1103,20100330,3820,3814,3830,3837,3830,3837,3833,23,19,4,15.33,1894
951,a1103,20100331,3837,3833,3835,3848,3830,3835,3835,2,2,672,2577.22,1264
952,a1103,20100401,3835,3835,3800,3800,3800,3800,3800,-35,-35,1200,4560,64
953,a1103,20100402,3800,3800,3820,3820,3809,3815,3816,15,16,14,53.43,64
954,a1103,20100406,3815,3816,3815,3830,3800,3825,3822,9,6,26,99.39,68
955,a1103,20100407,3825,3822,3811,3854,3811,3854,3837,32,15,36,138.16,72
956,a1103,20100408,3854,3837,3864,3864,3859,3859,3861,22,24,4,15.45,76
957,a1103,20100409,3859,3861,3865,3872,3865,3872,3870,11,9,18,69.66,88
958,a1103,20100412,3872,3870,3917,3920,3916,3920,3917,50,47,16,62.69,96
959,a1103,20100413,3920,3917,3909,3928,3895,3928,3910,11,-7,34,132.97,98
960,a1103,20100414,3928,3910,3945,3947,3933,3933,3939,23,29,8,31.52,96
961,a1103,20100415,3933,3939,0,0,0,3939,3939,0,0,0,0,96
962,a1103,20100416,3939,3939,3955,3955,3945,3955,3952,16,13,70,276.7,120
963,a1103,20100419,3955,3952,3950,3950,3908,3935,3932,-17,-20,48,188.75,138
964,a1103,20100420,3935,3932,3849,3973,3849,3968,3948,36,16,60,236.92,128
965,a1103,20100421,3968,3948,3990,3990,3979,3986,3985,38,37,22,87.67,130
966,a1103,20100422,3986,3985,3971,4004,3971,4001,3998,16,13,48,191.91,124
967,a1103,20100423,4001,3998,4025,4043,4015,4015,4028,17,30,28,112.81,126
968,a1103,20100426,4015,4028,4015,4050,4015,4032,4032,4,4,56,225.82,122
969,a1103,20100427,4032,4032,4035,4035,3990,4016,4013,-16,-19,34,136.45,122
970,a1103,20100428,4016,4013,3961,4008,3961,3981,3978,-32,-35,38,151.19,116
971,a1103,20100429,3981,3978,3995,3995,3988,3988,3989,10,11,8,31.92,116
972,a1103,20100430,3988,3989,4000,4020,4000,4020,4002,31,13,24,96.06,104
973,a1103,20100504,4020,4002,4010,4010,3998,3998,4009,-4,7,1004,4026.01,1106
974,a1103,20100505,3998,4009,4045,4070,4041,4066,4048,57,39,50,202.42,1112
975,a1103,20100506,4066,4048,4024,4024,4023,4023,4023,-25,-25,18,72.42,1106
976,a1103,20100507,4023,4023,3955,3986,3941,3943,3954,-80,-69,96,379.64,1104
977,a1103,20100510,3943,3954,3958,3970,3955,3963,3963,9,9,24,95.12,1098
978,a1103,20100511,3963,3963,3955,3960,3941,3941,3947,-22,-16,28,110.53,1080
979,a1103,20100512,3941,3947,3965,3987,3965,3975,3969,28,22,40,158.77,1054
980,a1103,20100513,3975,3969,3980,3980,3950,3979,3964,10,-5,16,63.44,1054
981,a1103,20100514,3979,3964,0,0,0,3964,3964,0,0,0,0,1054
982,a1103,20100517,3964,3964,3920,3920,3843,3865,3872,-99,-92,50,193.63,1054
983,a1103,20100518,3865,3872,3876,3876,3876,3876,3876,4,4,10,38.76,1054
984,a1103,20100519,3876,3876,0,0,0,3876,3876,0,0,0,0,1054
985,a1103,20100520,3876,3876,3855,3889,3855,3889,3870,13,-6,8,30.96,1056
986,a1103,20100521,3889,3870,3868,3894,3861,3894,3874,24,4,94,364.21,1072
987,a1103,20100524,3894,3874,3895,3906,3885,3906,3895,32,21,52,202.58,1072
988,a1103,20100525,3906,3895,3860,3880,3860,3880,3870,-15,-25,4,15.48,1072
989,a1103,20100526,3880,3870,3860,3899,3854,3899,3870,29,0,88,340.57,1026
990,a1103,20100527,3899,3870,3870,3880,3870,3880,3875,10,5,40,155,1044
991,a1103,20100528,3880,3875,3888,3888,3888,3888,3888,13,13,2,7.78,1046
992,a1103,20100531,3888,3888,3788,3855,3788,3839,3839,-49,-49,86,330.17,1088
993,a1103,20100601,3839,3839,3823,3835,3805,3817,3822,-22,-17,12,45.87,1088
994,a1103,20100602,3817,3822,3817,3835,3811,3826,3823,4,1,14,53.52,1088
995,a1103,20100603,3826,3823,3832,3832,3829,3829,3829,6,6,16,61.28,1076
996,a1103,20100604,3829,3829,3834,3846,3834,3843,3843,14,14,20,76.86,1080
997,a1103,20100607,3843,3843,3793,3795,3771,3780,3785,-63,-58,24,90.86,1098
998,a1103,20100608,3780,3785,3819,3819,3800,3815,3813,30,28,22,83.89,1088
999,a1103,20100609,3815,3813,0,0,0,3813,3813,0,0,0,0,1088
1000,a1103,20100610,3813,3813,3788,3829,3788,3809,3808,-4,-5,42,159.95,1088
1001,a1103,20100611,3809,3808,0,0,0,3808,3808,0,0,0,0,1088
1002,a1103,20100617,3808,3808,3813,3834,3812,3816,3819,8,11,18,68.74,1088
1003,a1103,20100618,3816,3819,0,0,0,3819,3819,0,0,0,0,1088
1004,a1103,20100621,3819,3819,3850,3888,3850,3864,3860,45,41,36,138.96,1068
1005,a1103,20100622,3864,3860,3842,3877,3842,3877,3865,17,5,92,355.64,1066
1006,a1103,20100623,3877,3865,3864,3864,3857,3857,3860,-8,-5,4,15.44,1066
1007,a1103,20100624,3857,3860,0,0,0,3860,3860,0,0,0,0,1066
1008,a1103,20100625,3860,3860,0,0,0,3860,3860,0,0,0,0,1066
1009,a1103,20100628,3860,3860,3858,3858,3858,3858,3858,-2,-2,1000,3858,66
1010,a1103,20100629,3858,3858,3852,3852,3849,3849,3850,-9,-8,8,30.8,64
1011,a1103,20100630,3849,3850,3849,3849,3810,3814,3822,-36,-28,76,290.53,66
1012,a1103,20100701,3814,3822,3827,3827,3815,3815,3819,-7,-3,88,336.1,96
1013,a1103,20100702,3815,3819,3824,3830,3824,3830,3826,11,7,12,45.92,104
1014,a1103,20100705,3830,3826,3826,3826,3826,3826,3826,0,0,2,7.65,106
1015,a1103,20100706,3826,3826,3810,3816,3805,3814,3811,-12,-15,56,213.42,126
1016,a1103,20100707,3814,3811,0,0,0,3811,3811,0,0,0,0,126
1017,a1103,20100708,3811,3811,3841,3841,3841,3841,3841,30,30,20,76.82,106
1018,a1103,20100709,3841,3841,3870,3890,3862,3890,3869,49,28,18,69.64,106
1019,a1103,20100712,3890,3869,3871,3885,3855,3855,3868,-14,-1,28,108.33,114
1020,a1103,20100713,3855,3868,3860,3860,3845,3845,3847,-23,-21,14,53.86,114
1021,a1103,20100714,3845,3847,3850,3865,3850,3857,3852,10,5,18,69.34,114
1022,a1103,20100715,3857,3852,0,0,0,3852,3852,0,0,0,0,114
1023,a1103,20100716,3852,3852,3916,3919,3902,3909,3913,57,61,36,140.88,106
1024,a1103,20100719,3909,3913,3891,3891,3891,3891,3891,-22,-22,2,7.78,106
1025,a1103,20100720,3891,3891,3920,3928,3920,3921,3921,30,30,26,101.96,106
1026,a1103,20100721,3921,3921,3911,3913,3911,3913,3912,-8,-9,4,15.65,106
1027,a1103,20100722,3913,3912,3909,3909,3904,3904,3906,-8,-6,4,15.63,102
1028,a1103,20100723,3904,3906,3922,3923,3915,3915,3919,9,13,10,39.2,102
1029,a1103,20100726,3915,3919,3841,3920,3841,3920,3882,1,-37,38,147.52,102
1030,a1103,20100727,3920,3882,3890,3908,3886,3895,3897,13,15,18,70.16,102
1031,a1103,20100728,3895,3897,3890,3913,3890,3913,3901,16,4,4,15.61,102
1032,a1103,20100729,3913,3901,3940,3940,3905,3919,3925,18,24,24,94.2,116
1033,a1103,20100730,3919,3925,0,0,0,3925,3925,0,0,0,0,116
1034,a1103,20100802,3925,3925,3991,3991,3991,3991,3991,66,66,2,7.98,114
1035,a1103,20100803,3991,3991,0,0,0,3991,3991,0,0,0,0,114
1036,a1103,20100804,3991,3991,3919,4014,3919,3974,3982,-17,-9,82,326.56,142
1037,a1103,20100805,3974,3982,3955,3988,3948,3948,3959,-34,-23,30,118.8,146
1038,a1103,20100806,3948,3959,3922,4020,3922,3970,3975,11,16,54,214.69,146
1039,a1103,20100809,3970,3975,3975,4050,3975,4025,4018,50,43,80,321.45,182
1040,a1103,20100810,4025,4018,3985,4000,3981,3981,3989,-37,-29,10,39.9,182
1041,a1103,20100811,3981,3989,4003,4003,3975,3988,3988,-1,-1,10,39.88,178
1042,a1103,20100812,3988,3988,3990,3991,3984,3991,3989,3,1,12,47.87,172
1043,a1103,20100813,3991,3989,4065,4065,4017,4050,4042,61,53,26,105.11,180
1044,a1103,20100816,4050,4042,4047,4086,4047,4076,4076,34,34,34,138.6,198
1045,a1103,20100817,4076,4076,4084,4084,4045,4055,4054,-21,-22,22,89.2,188
1046,a1103,20100818,4055,4054,4127,4127,4015,4030,4081,-24,27,34,138.76,186
1047,a1103,20100819,4030,4081,4029,4029,4011,4027,4021,-54,-60,8,32.17,184
1048,a1103,20100820,4027,4021,4010,4010,3953,3953,3981,-68,-40,20,79.63,186
1049,a1103,20100823,3953,3981,3940,3940,3940,3940,3940,-41,-41,2,7.88,184
1050,a1103,20100824,3940,3940,3949,3949,3920,3920,3938,-20,-2,8,31.51,186
1051,a1103,20100825,3920,3938,3966,3966,3898,3921,3927,-17,-11,24,94.27,180
1052,a1103,20100826,3921,3927,3927,3927,3927,3927,3927,0,0,2,7.85,180
1053,a1103,20100827,3927,3927,3946,3968,3946,3968,3957,41,30,4,15.83,180
1054,a1103,20100830,3968,3957,3975,4017,3975,3997,3986,40,29,38,151.5,170
1055,a1103,20100831,3997,3986,3931,3931,3931,3931,3931,-55,-55,2,7.86,170
1056,a1103,20100901,3931,3931,0,0,0,3931,3931,0,0,0,0,170
1057,a1103,20100902,3931,3931,0,0,0,3931,3931,0,0,0,0,170
1058,a1103,20100903,3931,3931,3950,4001,3950,3967,3972,36,41,6,23.84,170
1059,a1103,20100906,3967,3972,0,0,0,3972,3972,0,0,0,0,170
1060,a1103,20100907,3972,3972,4050,4050,4004,4004,4010,32,38,20,80.2,166
1061,a1103,20100908,4004,4010,4058,4058,4021,4021,4039,11,29,4,16.16,166
1062,a1103,20100909,4021,4039,3995,3995,3950,3963,3972,-76,-67,110,437.01,186
1063,a1103,20100910,3963,3972,3967,3974,3952,3974,3963,2,-9,46,182.33,172
1064,a1103,20100913,3974,3963,3977,3977,3977,3977,3977,14,14,10,39.77,174
1065,a1103,20100914,3977,3977,4004,4004,3950,3950,3975,-27,-2,46,182.86,180
1066,a1103,20100915,3950,3975,3970,3990,3970,3978,3979,3,4,22,87.56,180
1067,a1103,20100916,3978,3979,3990,3990,3976,3976,3983,-3,4,20,79.66,176
1068,a1103,20100917,3976,3983,3958,3979,3958,3979,3975,-4,-8,14,55.65,164
1069,a1103,20100920,3979,3975,3990,4076,3990,4051,4037,76,62,196,791.37,242
1070,a1103,20100921,4051,4037,4020,4029,4006,4027,4009,-10,-28,88,352.87,240
1071,a1103,20100927,4027,4009,4127,4127,4065,4065,4097,56,88,20,81.95,244
1072,a1103,20100928,4065,4097,4041,4086,4041,4086,4063,-11,-34,60,243.78,244
1073,a1103,20100929,4086,4063,4030,4072,4023,4072,4030,9,-33,26,104.78,228
1074,a1103,20100930,4072,4030,4031,4055,4031,4055,4052,25,22,20,81.05,226
1075,a1103,20101008,4055,4052,4029,4045,4029,4029,4032,-23,-20,28,112.91,222
1076,a1103,20101011,4029,4032,4193,4193,4192,4193,4192,161,160,120,503.16,216
1077,a1103,20101012,4193,4192,4199,4208,4118,4179,4177,-13,-15,92,384.33,230
1078,a1103,20101013,4179,4177,4214,4214,4165,4170,4171,-7,-6,112,467.25,152
1079,a1103,20101014,4170,4171,4221,4221,4186,4186,4194,15,23,8,33.56,152
1080,a1103,20101015,4186,4194,4160,4233,4159,4226,4203,32,9,30,126.1,168
1081,a1103,20101018,4226,4203,4170,4186,4124,4174,4160,-29,-43,20,83.21,166
1082,a1103,20101019,4174,4160,4171,4215,4170,4174,4190,14,30,20,83.81,166
1083,a1103,20101020,4174,4190,4122,4163,4122,4163,4147,-27,-43,20,82.95,164
1084,a1103,20101021,4163,4147,4202,4246,4171,4201,4209,54,62,42,176.81,164
1085,a1103,20101022,4201,4209,4165,4205,4165,4205,4187,-4,-22,16,66.99,156
1086,a1103,20101025,4205,4187,4240,4278,4240,4263,4259,76,72,20,85.18,150
1087,a1103,20101026,4263,4259,4304,4304,4238,4238,4254,-21,-5,8,34.04,148
1088,a1103,20101027,4238,4254,4210,4210,4161,4161,4187,-93,-67,6,25.12,150
1089,a1103,20101028,4161,4187,4195,4195,4161,4161,4178,-26,-9,4,16.71,150
1090,a1103,20101029,4161,4178,4175,4230,4127,4127,4182,-51,4,90,376.41,148
1091,a1103,20101101,4127,4182,4203,4219,4203,4219,4217,37,35,22,92.79,166
1092,a1103,20101102,4219,4217,0,0,0,4217,4217,0,0,0,0,166
1093,a1103,20101103,4217,4217,4228,4228,4182,4182,4186,-35,-31,22,92.1,146
1094,a1103,20101104,4182,4186,4219,4254,4219,4254,4245,68,59,22,93.41,140
1095,a1103,20101105,4254,4245,4350,4378,4301,4351,4363,106,118,32,139.62,146
1096,a1103,20101108,4351,4363,4280,4440,4280,4399,4357,36,-6,92,400.87,176
1097,a1103,20101109,4399,4357,4388,4395,4388,4395,4390,38,33,22,96.59,176
1098,a1103,20101110,4395,4390,4429,4490,4420,4423,4443,33,53,192,853.21,176
1099,a1103,20101111,4423,4443,4380,4450,4380,4426,4442,-17,-1,78,346.48,162
1100,a1103,20101112,4426,4442,4592,4592,4265,4306,4340,-136,-102,36,156.27,162
1101,a1103,20101115,4306,4340,4409,4409,4194,4213,4246,-127,-94,30,127.39,162
1102,a1103,20101116,4213,4246,4223,4264,4150,4245,4222,-1,-24,38,160.44,142
1103,a1103,20101117,4245,4222,4054,4104,4054,4054,4059,-168,-163,20,81.2,150
1104,a1103,20101118,4054,4059,4118,4125,4078,4110,4097,51,38,12,49.17,142
1105,a1103,20101119,4110,4097,4101,4147,4097,4118,4117,21,20,30,123.53,142
1106,a1103,20101122,4118,4117,4125,4125,4124,4124,4124,7,7,6,24.75,136
1107,a1103,20101123,4124,4124,4130,4130,4130,4130,4130,6,6,2,8.26,134
1108,a1103,20101124,4130,4130,4107,4107,4105,4106,4105,-24,-25,18,73.9,134
1109,a1103,20101125,4106,4105,4036,4213,4036,4128,4145,23,40,104,431.1,176
1110,a1103,20101126,4128,4145,4017,4080,4015,4046,4031,-99,-114,26,104.83,168
1111,a1103,20101129,4046,4031,3958,4084,3877,4058,3988,27,-43,140,558.45,216
1112,a1103,20101130,4058,3988,4092,4092,4015,4049,4041,61,53,132,533.45,140
1113,a1103,20101201,4049,4041,4072,4072,4072,4072,4072,31,31,2,8.14,142
1114,a1103,20101202,4072,4072,4085,4140,4080,4102,4112,30,40,22,90.48,146
1115,a1103,20101203,4102,4112,4096,4120,4082,4101,4105,-11,-7,24,98.52,158
1116,a1103,20101206,4101,4105,4147,4147,4101,4101,4106,-4,1,22,90.33,158
1117,a1103,20101207,4101,4106,4091,4091,4090,4090,4090,-16,-16,4,16.36,160
1118,a1103,20101208,4090,4090,4032,4060,3966,4050,4036,-40,-54,12,48.44,156
1119,a1103,20101209,4050,4036,4108,4108,4063,4076,4082,40,46,6,24.49,158
1120,a1103,20101210,4076,4082,4048,4070,4026,4047,4047,-35,-35,8,32.38,156
1121,a1103,20101213,4047,4047,4100,4115,4075,4115,4102,68,55,54,221.52,194
1122,a1103,20101214,4115,4102,4037,4117,4037,4092,4069,-10,-33,72,292.98,218
1123,a1103,20101215,4092,4069,4083,4083,4070,4070,4079,1,10,8,32.63,224
1124,a1103,20101216,4070,4079,4078,4078,4078,4078,4078,-1,-1,2,8.16,224
1125,a1103,20101217,4078,4078,4041,4079,4041,4046,4061,-32,-17,8,32.49,226
1126,a1103,20101220,4046,4061,4107,4107,4063,4070,4081,9,20,28,114.29,232
1127,a1103,20101221,4070,4081,4051,4070,4040,4057,4053,-24,-28,14,56.74,238
1128,a1103,20101222,4057,4053,4055,4055,4050,4050,4051,-3,-2,6,24.31,242
1129,a1103,20101223,4050,4051,4050,4066,4031,4066,4050,15,-1,52,210.61,204
1130,a1103,20101224,4066,4050,4080,4119,4074,4119,4098,69,48,148,606.64,240
1131,a1103,20101227,4119,4098,4118,4130,4100,4105,4118,7,20,88,362.44,262
1132,a1103,20101228,4105,4118,4145,4145,4103,4118,4123,0,5,114,470.13,264
1133,a1103,20101229,4118,4123,4116,4116,4081,4088,4089,-35,-34,42,171.77,246
1134,a1103,20101230,4088,4089,4100,4100,4100,4100,4100,11,11,2,8.2,246
1135,a1103,20101231,4100,4100,4115,4129,4100,4129,4117,29,17,36,148.21,216
1136,a1105,20100104,3999,3995,4027,4095,4016,4027,4029,32,34,206,830.01,1066
1137,a1105,20100105,4027,4029,4027,4049,4022,4025,4036,-4,7,222,896.05,966
1138,a1105,20100106,4025,4036,4041,4121,4041,4096,4083,60,47,174,710.51,942
1139,a1105,20100107,4096,4083,4124,4124,3923,3999,4021,-84,-62,410,1648.74,890
1140,a1105,20100108,3999,4021,3973,3985,3930,3940,3951,-81,-70,148,584.83,928
1141,a1105,20100111,3940,3951,3966,4009,3966,3991,3995,40,44,56,223.76,930
1142,a1105,20100112,3991,3995,3954,3986,3951,3965,3971,-30,-24,226,897.66,1052
1143,a1105,20100113,3965,3971,3900,3900,3866,3869,3881,-102,-90,1574,6109.25,2196
1144,a1105,20100114,3869,3881,3882,3892,3868,3871,3874,-10,-7,766,2967.88,2554
1145,a1105,20100115,3871,3874,3865,3880,3856,3862,3866,-12,-8,324,1252.81,2586
1146,a1105,20100118,3862,3866,3860,3866,3845,3852,3857,-14,-9,1402,5408.51,3756
1147,a1105,20100119,3852,3857,3862,3870,3853,3861,3861,4,4,182,702.82,3832
1148,a1105,20100120,3861,3861,3860,3860,3800,3808,3816,-53,-45,1122,4282.5,4590
1149,a1105,20100121,3808,3816,3810,3840,3802,3822,3822,6,6,544,2079.28,4594
1150,a1105,20100122,3822,3822,3820,3827,3786,3816,3818,-6,-4,8204,31323.95,4616
1151,a1105,20100125,3816,3818,3818,3859,3818,3849,3844,31,26,652,2506.93,4796
1152,a1105,20100126,3849,3844,3844,3852,3825,3825,3834,-19,-10,1276,4892.34,5752
1153,a1105,20100127,3825,3834,3836,3852,3836,3846,3845,12,11,242,930.66,5714
1154,a1105,20100128,3846,3845,3806,3826,3769,3784,3801,-61,-44,1210,4599.51,6166
1155,a1105,20100129,3784,3801,3789,3803,3774,3774,3790,-27,-11,374,1417.6,6142
1156,a1105,20100201,3774,3790,3771,3775,3710,3712,3723,-78,-67,1720,6403.64,6988
1157,a1105,20100202,3712,3723,3724,3727,3670,3675,3694,-48,-29,862,3184.46,7378
1158,a1105,20100203,3675,3694,3719,3724,3688,3724,3710,30,16,1178,4370.82,7370
1159,a1105,20100204,3724,3710,3685,3697,3679,3696,3686,-14,-24,922,3399.29,7598
1160,a1105,20100205,3696,3686,3680,3724,3671,3721,3710,35,24,890,3302.51,7596
1161,a1105,20100208,3721,3710,3745,3756,3730,3737,3734,27,24,1792,6692.39,6432
1162,a1105,20100209,3737,3734,3740,3747,3735,3743,3740,9,6,438,1638.31,6326
1163,a1105,20100210,3743,3740,3743,3751,3696,3704,3711,-36,-29,2950,10949.12,8112
1164,a1105,20100211,3704,3711,3734,3738,3721,3730,3729,19,18,840,3132.88,7838
1165,a1105,20100212,3730,3729,3721,3729,3691,3713,3707,-16,-22,948,3514.98,7864
1166,a1105,20100222,3713,3707,3750,3750,3724,3735,3723,28,16,8034,29914.84,8034
1167,a1105,20100223,3735,3723,3738,3790,3738,3781,3747,58,24,10326,38694.71,8840
1168,a1105,20100224,3781,3747,3790,3790,3761,3776,3765,29,18,13008,48983.22,8756
1169,a1105,20100225,3776,3765,3780,3789,3760,3767,3772,2,7,1468,5538.25,9094
1170,a1105,20100226,3767,3772,3762,3780,3762,3769,3770,-3,-2,780,2941.08,9286
1171,a1105,20100301,3769,3770,3782,3816,3782,3810,3806,40,36,2964,11282.9,10508
1172,a1105,20100302,3810,3806,3808,3824,3796,3812,3814,6,8,2250,8583.64,10824
1173,a1105,20100303,3812,3814,3823,3833,3816,3824,3823,10,9,2374,9076.98,10668
1174,a1105,20100304,3824,3823,3816,3822,3783,3784,3799,-39,-24,2254,8564.84,11350
1175,a1105,20100305,3784,3799,3775,3780,3767,3779,3772,-20,-27,3946,14886.19,13030
1176,a1105,20100308,3779,3772,3776,3795,3773,3792,3786,20,14,2354,8914.24,13710
1177,a1105,20100309,3792,3786,3794,3797,3780,3792,3788,6,2,1918,7266.76,14312
1178,a1105,20100310,3792,3788,3788,3796,3783,3785,3790,-3,2,1696,6428.59,14936
1179,a1105,20100311,3785,3790,3799,3805,3770,3786,3787,-4,-3,4232,16029.37,14916
1180,a1105,20100312,3786,3787,3762,3768,3755,3759,3758,-28,-29,2090,7856.09,15400
1181,a1105,20100315,3759,3758,3756,3763,3742,3750,3751,-8,-7,3080,11555.01,16058
1182,a1105,20100316,3750,3751,3752,3789,3752,3789,3769,38,18,1956,7372.65,16002
1183,a1105,20100317,3789,3769,3796,3799,3787,3790,3792,21,23,2394,9078.16,16064
1184,a1105,20100318,3790,3792,3798,3798,3779,3784,3788,-8,-4,2006,7600.29,16106
1185,a1105,20100319,3784,3788,3789,3812,3786,3809,3804,21,16,4236,16117.95,14848
1186,a1105,20100322,3809,3804,3820,3820,3798,3811,3811,7,7,2374,9047.86,14880
1187,a1105,20100323,3811,3811,3820,3832,3807,3813,3820,2,9,2224,8497.71,14862
1188,a1105,20100324,3813,3820,3817,3817,3794,3798,3803,-22,-17,1766,6716.4,14968
1189,a1105,20100325,3798,3803,3800,3812,3799,3806,3807,3,4,1336,5087.45,14982
1190,a1105,20100326,3806,3807,3795,3805,3788,3804,3794,-3,-13,1992,7559.63,15134
1191,a1105,20100329,3804,3794,3809,3829,3804,3822,3818,28,24,2690,10271.83,15192
1192,a1105,20100330,3822,3818,3833,3843,3813,3837,3832,19,14,3946,15121.79,15232
1193,a1105,20100331,3837,3832,3838,3848,3826,3829,3837,-3,5,3680,14120.22,15166
1194,a1105,20100401,3829,3837,3801,3820,3798,3815,3811,-22,-26,2490,9490.87,15320
1195,a1105,20100402,3815,3811,3820,3829,3815,3820,3819,9,8,3532,13490.39,16478
1196,a1105,20100406,3820,3819,3816,3829,3810,3821,3821,2,2,2186,8353.17,16562
1197,a1105,20100407,3821,3821,3825,3852,3822,3851,3840,30,19,4250,16322.3,16490
1198,a1105,20100408,3851,3840,3850,3877,3848,3850,3860,10,20,7580,29259.42,16536
1199,a1105,20100409,3850,3860,3851,3885,3851,3884,3871,24,11,7662,29659.67,17208
1200,a1105,20100412,3884,3871,3899,3929,3898,3926,3913,55,42,19678,77011.03,20852
1201,a1105,20100413,3926,3913,3913,3944,3886,3935,3921,22,8,53226,208750.25,32800
1202,a1105,20100414,3935,3921,3948,3954,3935,3940,3942,19,21,43552,171694,50222
1203,a1105,20100415,3940,3942,3942,3944,3917,3920,3932,-22,-10,25102,98704.89,59452
1204,a1105,20100416,3920,3932,3938,3958,3936,3954,3950,22,18,28268,111662.48,63128
1205,a1105,20100419,3954,3950,3945,3949,3915,3928,3935,-22,-15,27242,107200.56,65318
1206,a1105,20100420,3928,3935,3948,3992,3942,3987,3972,52,37,45054,178986.82,71704
1207,a1105,20100421,3987,3972,3980,4009,3977,4001,3993,29,21,41476,165644.25,70498
1208,a1105,20100422,4001,3993,4015,4030,3995,4028,4018,35,25,43500,174804.41,74574
1209,a1105,20100423,4028,4018,4048,4074,4033,4071,4058,53,40,61668,250293.82,78998
1210,a1105,20100426,4071,4058,4085,4098,4051,4087,4077,29,19,71474,291449.38,90136
1211,a1105,20100427,4087,4077,4071,4072,4040,4056,4055,-21,-22,71402,289557.93,83706
1212,a1105,20100428,4056,4055,4006,4039,3990,4019,4020,-36,-35,76330,306871.09,87240
1213,a1105,20100429,4019,4020,4028,4039,4024,4030,4031,10,11,30122,121446.17,86412
1214,a1105,20100430,4030,4031,4031,4080,4031,4076,4049,45,18,82948,335867.99,91258
1215,a1105,20100504,4076,4049,4049,4061,4035,4040,4044,-9,-5,62346,252150.95,88632
1216,a1105,20100505,4040,4044,4030,4106,4029,4105,4071,61,27,127944,520902.17,97444
1217,a1105,20100506,4105,4071,4089,4102,4041,4044,4063,-27,-8,81082,329502.53,96616
1218,a1105,20100507,4044,4063,4005,4014,3939,3941,3972,-122,-91,113698,451675.13,71902
1219,a1105,20100510,3941,3972,3970,4001,3965,3995,3983,23,11,52268,208202.75,73904
1220,a1105,20100511,3995,3983,3988,3991,3953,3957,3971,-26,-12,52348,207895.98,74088
1221,a1105,20100512,3957,3971,3975,4010,3967,3992,3994,21,23,63802,254826.93,75484
1222,a1105,20100513,3992,3994,3990,3997,3979,3995,3989,1,-5,28684,114422,75854
1223,a1105,20100514,3995,3989,3988,3993,3965,3970,3978,-19,-11,25288,100606.08,76084
1224,a1105,20100517,3970,3978,3955,3963,3860,3893,3902,-85,-76,41410,161604.5,77460
1225,a1105,20100518,3893,3902,3888,3924,3875,3922,3906,20,4,34946,136502.16,75216
1226,a1105,20100519,3922,3906,3890,3909,3880,3885,3897,-21,-9,33482,130486.15,75572
1227,a1105,20100520,3885,3897,3900,3917,3885,3900,3901,3,4,28624,111679.26,77596
1228,a1105,20100521,3900,3901,3898,3930,3890,3923,3915,22,14,44712,175053.54,76282
1229,a1105,20100524,3923,3915,3925,3937,3917,3930,3928,15,13,22738,89329.73,76528
1230,a1105,20100525,3930,3928,3923,3924,3878,3882,3896,-46,-32,38988,151922.12,82232
1231,a1105,20100526,3882,3896,3900,3909,3868,3897,3888,1,-8,57938,225307.68,84656
1232,a1105,20100527,3897,3888,3898,3906,3885,3900,3895,12,7,22344,87049.62,83064
1233,a1105,20100528,3900,3895,3916,3916,3890,3892,3904,-3,9,29312,114457,83578
1234,a1105,20100531,3892,3904,3880,3880,3830,3833,3852,-71,-52,45636,175804.58,90016
1235,a1105,20100601,3833,3852,3842,3844,3818,3827,3832,-25,-20,26562,101808.91,85704
1236,a1105,20100602,3827,3832,3827,3848,3822,3842,3837,10,5,30704,117818.06,84484
1237,a1105,20100603,3842,3837,3843,3855,3839,3843,3844,6,7,19554,75179.51,83850
1238,a1105,20100604,3843,3844,3865,3865,3845,3854,3855,10,11,17692,68219.74,81942
1239,a1105,20100607,3854,3855,3800,3802,3778,3793,3791,-62,-64,17646,66912.9,81198
1240,a1105,20100608,3793,3791,3802,3820,3793,3814,3809,23,18,14278,54396.33,81500
1241,a1105,20100609,3814,3809,3801,3808,3780,3807,3794,-2,-15,22652,85949.38,79756
1242,a1105,20100610,3807,3794,3815,3824,3801,3805,3812,11,18,15518,59155.48,78646
1243,a1105,20100611,3805,3812,3805,3816,3798,3802,3807,-10,-5,9940,37843.21,77894
1244,a1105,20100617,3802,3807,3845,3845,3816,3818,3830,11,23,18154,69546.77,85664
1245,a1105,20100618,3818,3830,3826,3846,3823,3835,3835,5,5,22604,86702.66,86264
1246,a1105,20100621,3835,3835,3858,3905,3849,3897,3879,62,44,30040,116549.87,88154
1247,a1105,20100622,3897,3879,3880,3888,3872,3878,3878,-1,-1,16356,63437.07,86682
1248,a1105,20100623,3878,3878,3863,3885,3860,3873,3872,-5,-6,18084,70025.44,86604
1249,a1105,20100624,3873,3872,3861,3883,3861,3875,3875,3,3,8888,34443.69,87148
1250,a1105,20100625,3875,3875,3866,3871,3853,3859,3861,-16,-14,11258,43472.71,87712
1251,a1105,20100628,3859,3861,3861,3866,3857,3858,3861,-3,0,13254,51175.8,90588
1252,a1105,20100629,3858,3861,3863,3872,3828,3841,3850,-20,-11,17934,69055.72,90362
1253,a1105,20100630,3841,3850,3820,3828,3809,3820,3817,-30,-33,11908,45463.14,91290
1254,a1105,20100701,3820,3817,3817,3823,3810,3810,3818,-7,1,6140,23442.75,91326
1255,a1105,20100702,3810,3818,3809,3845,3809,3841,3830,23,12,15650,59944.65,93074
1256,a1105,20100705,3841,3830,3833,3840,3824,3825,3831,-5,1,8964,34346.02,93932
1257,a1105,20100706,3825,3831,3820,3830,3805,3825,3815,-6,-16,13480,51433.45,95158
1258,a1105,20100707,3825,3815,3820,3838,3818,3830,3831,15,16,13014,49865.14,97308
1259,a1105,20100708,3830,3831,3888,3890,3868,3870,3874,39,43,21708,84107.51,99368
1260,a1105,20100709,3870,3874,3886,3894,3873,3891,3883,17,9,38122,148052.63,105224
1261,a1105,20100712,3891,3883,3890,3902,3869,3871,3885,-12,2,24040,93411.78,103822
1262,a1105,20100713,3871,3885,3880,3884,3851,3856,3866,-29,-19,22952,88752.39,106908
1263,a1105,20100714,3856,3866,3865,3880,3864,3869,3870,3,4,18722,72465.62,107718
1264,a1105,20100715,3869,3870,3871,3912,3867,3883,3894,13,24,71814,279712.6,113150
1265,a1105,20100716,3883,3894,3920,3946,3912,3939,3935,45,41,93944,369709.03,126926
1266,a1105,20100719,3939,3935,3934,3953,3922,3947,3932,12,-3,46790,184009.61,128846
1267,a1105,20100720,3947,3932,3930,3970,3923,3961,3947,29,15,95356,376390.67,140980
1268,a1105,20100721,3961,3947,3966,3976,3950,3956,3962,9,15,115282,456847.41,146764
1269,a1105,20100722,3956,3962,3960,3967,3928,3941,3945,-21,-17,97526,384805.7,147638
1270,a1105,20100723,3941,3945,3943,3978,3939,3959,3965,14,20,136958,543070.76,155262
1271,a1105,20100726,3959,3965,3956,3985,3951,3972,3970,7,5,139252,552896.21,162848
1272,a1105,20100727,3972,3970,3950,3957,3918,3922,3935,-48,-35,97242,382679.17,160484
1273,a1105,20100728,3922,3935,3931,3937,3923,3936,3931,1,-4,71704,281892.62,161470
1274,a1105,20100729,3936,3931,3950,3960,3934,3952,3948,21,17,103792,409857.31,162022
1275,a1105,20100730,3952,3948,3965,3985,3964,3977,3975,29,27,120576,479342.89,167022
1276,a1105,20100802,3977,3975,4006,4065,4000,4047,4044,72,69,212692,860241.45,190772
1277,a1105,20100803,4047,4044,4039,4042,3995,4000,4019,-44,-25,184028,739750.01,191648
1278,a1105,20100804,4000,4019,4018,4055,4007,4022,4030,3,11,286986,1156692.64,214804
1279,a1105,20100805,4022,4030,4052,4054,3965,3973,4000,-57,-30,271196,1085024.38,216622
1280,a1105,20100806,3973,4000,3990,4010,3963,4007,3989,7,-11,267860,1068599.69,223884
1281,a1105,20100809,4007,3989,4015,4095,4001,4069,4055,80,66,634226,2572106.51,276712
1282,a1105,20100810,4069,4055,4054,4054,4018,4027,4035,-28,-20,325578,1313759.45,267672
1283,a1105,20100811,4027,4035,4019,4052,4015,4023,4036,-12,1,327614,1322552.22,254052
1284,a1105,20100812,4023,4036,4021,4075,4002,4037,4049,1,13,657870,2663923.88,292660
1285,a1105,20100813,4037,4049,4051,4106,4051,4103,4080,54,31,607018,2476834.46,331462
1286,a1105,20100816,4103,4080,4115,4164,4105,4145,4142,65,62,757314,3137414.87,389952
1287,a1105,20100817,4145,4142,4120,4137,4102,4135,4117,-7,-25,533466,2196689.43,390032
1288,a1105,20100818,4135,4117,4159,4177,4085,4105,4139,-12,22,709270,2936234.3,368988
1289,a1105,20100819,4105,4139,4110,4116,4071,4090,4093,-49,-46,553422,2265495.35,357956
1290,a1105,20100820,4090,4093,4052,4056,4014,4020,4032,-73,-61,398900,1608425.29,333572
1291,a1105,20100823,4020,4032,4032,4048,4008,4018,4027,-14,-5,378596,1524644.75,322426
1292,a1105,20100824,4018,4027,4012,4032,3994,3997,4016,-30,-11,296472,1190866.98,313998
1293,a1105,20100825,3997,4016,4001,4012,3974,3981,3995,-35,-21,267606,1069304.82,301682
1294,a1105,20100826,3981,3995,3991,4011,3991,4010,4000,15,5,237798,951354.14,296874
1295,a1105,20100827,4010,4000,4027,4037,4014,4026,4025,26,25,238032,958166.11,294502
1296,a1105,20100830,4026,4025,4060,4078,4045,4059,4062,34,37,260856,1059857.37,278740
1297,a1105,20100831,4059,4062,4031,4031,3987,3990,4004,-72,-58,245490,983057.96,267774
1298,a1105,20100901,3990,4004,3999,4018,3981,4002,4001,-2,-3,234628,938922.88,268714
1299,a1105,20100902,4002,4001,4005,4010,3983,3998,3996,-3,-5,295294,1180135.35,270996
1300,a1105,20100903,3998,3996,4002,4037,3998,4033,4021,37,25,335558,1349278.99,262214
1301,a1105,20100906,4033,4021,4069,4087,4053,4071,4072,50,51,298456,1215372.28,273996
1302,a1105,20100907,4071,4072,4077,4092,4055,4092,4079,20,7,398622,1626139.59,279808
1303,a1105,20100908,4092,4079,4112,4119,4063,4077,4091,-2,12,277396,1135073.68,280230
1304,a1105,20100909,4077,4091,4070,4089,3982,4023,4036,-68,-55,326164,1316536.93,252780
1305,a1105,20100910,4023,4036,4031,4042,4016,4034,4027,-2,-9,210198,846510.1,247048
1306,a1105,20100913,4034,4027,4013,4031,4011,4030,4020,3,-7,188712,758632.69,239734
1307,a1105,20100914,4030,4020,4025,4035,4006,4009,4020,-11,0,209300,841490.56,247630
1308,a1105,20100915,4009,4020,4022,4045,4012,4038,4029,18,9,313248,1262352.44,246696
1309,a1105,20100916,4038,4029,4044,4054,4014,4026,4034,-3,5,229816,927239.41,239682
1310,a1105,20100917,4026,4034,4040,4045,4023,4037,4034,3,0,222414,897344.57,230018
1311,a1105,20100920,4037,4034,4100,4190,4091,4146,4158,112,124,722904,3006162.03,282944
1312,a1105,20100921,4146,4158,4130,4137,4081,4110,4111,-48,-47,385860,1586498.39,244682
1313,a1105,20100927,4110,4111,4225,4254,4156,4177,4194,66,83,365840,1534388.33,237800
1314,a1105,20100928,4177,4194,4160,4189,4148,4182,4169,-12,-25,180622,753092.7,222754
1315,a1105,20100929,4182,4169,4149,4154,4088,4120,4123,-49,-46,179928,741949.89,202358
1316,a1105,20100930,4120,4123,4110,4128,4095,4124,4116,1,-7,98480,405377.92,198250
1317,a1105,20101008,4124,4116,4090,4131,4090,4092,4112,-24,-4,107540,442287.16,201478
1318,a1105,20101011,4092,4112,4276,4276,4269,4276,4275,164,163,55002,235183.91,207710
1319,a1105,20101012,4276,4275,4250,4287,4203,4257,4259,-18,-16,358862,1528623.27,217874
1320,a1105,20101013,4257,4259,4286,4295,4250,4279,4273,20,14,258156,1103116.52,220940
1321,a1105,20101014,4279,4273,4290,4299,4271,4280,4284,7,11,219138,938791.75,230496
1322,a1105,20101015,4280,4284,4294,4309,4236,4302,4288,18,4,285458,1224248.43,234946
1323,a1105,20101018,4302,4288,4257,4269,4230,4240,4247,-48,-41,179830,763915.68,228928
1324,a1105,20101019,4240,4247,4258,4279,4240,4256,4262,9,15,160406,683706.12,219532
1325,a1105,20101020,4256,4262,4206,4263,4184,4243,4235,-19,-27,158838,672738.12,214594
1326,a1105,20101021,4243,4235,4288,4341,4278,4290,4312,55,77,281760,1215144.91,210408
1327,a1105,20101022,4290,4312,4305,4313,4283,4293,4301,-19,-11,131828,567003.44,203032
1328,a1105,20101025,4293,4301,4309,4394,4308,4368,4355,67,54,178748,778476.62,177792
1329,a1105,20101026,4368,4355,4360,4376,4317,4330,4345,-25,-10,115870,503498.38,153818
1330,a1105,20101027,4330,4345,4343,4372,4238,4240,4296,-105,-49,79844,343057.25,145714
1331,a1105,20101028,4240,4296,4281,4284,4251,4270,4269,-26,-27,53288,227507.29,142854
1332,a1105,20101029,4270,4269,4269,4269,4197,4212,4224,-57,-45,63240,267163.96,134894
1333,a1105,20101101,4212,4224,4234,4302,4231,4283,4279,59,55,62892,269169.03,130740
1334,a1105,20101102,4283,4279,4288,4288,4259,4284,4277,5,-2,43614,186566.23,128504
1335,a1105,20101103,4284,4277,4286,4297,4255,4266,4283,-11,6,40820,174863.11,119900
1336,a1105,20101104,4266,4283,4300,4333,4283,4328,4308,45,25,44906,193498.21,116316
1337,a1105,20101105,4328,4308,4398,4478,4382,4467,4440,159,132,93894,416968.4,115506
1338,a1105,20101108,4467,4440,4475,4508,4410,4489,4470,49,30,90802,405896.43,114312
1339,a1105,20101109,4489,4470,4448,4537,4448,4512,4502,42,32,60328,271609.75,117216
1340,a1105,20101110,4512,4502,4580,4645,4517,4562,4593,60,91,73134,335959.58,110566
1341,a1105,20101111,4562,4593,4580,4636,4538,4593,4595,0,2,55620,255590.4,108390
1342,a1105,20101112,4593,4595,4635,4635,4412,4427,4461,-168,-134,84848,378528.48,102056
1343,a1105,20101115,4427,4461,4447,4475,4284,4358,4384,-103,-77,106142,465389.94,85246
1344,a1105,20101116,4358,4384,4378,4388,4292,4301,4342,-83,-42,71944,312382.11,70360
1345,a1105,20101117,4301,4342,4171,4200,4169,4169,4176,-173,-166,41272,172385.05,66552
1346,a1105,20101118,4169,4176,4246,4249,4130,4193,4176,17,0,57432,239870.33,59396
1347,a1105,20101119,4193,4176,4240,4240,4151,4201,4198,25,22,35462,148889.77,57108
1348,a1105,20101122,4201,4198,4123,4195,4123,4167,4167,-31,-31,24926,103890.44,53438
1349,a1105,20101123,4167,4167,4185,4213,4155,4180,4186,13,19,43936,183956.25,51706
1350,a1105,20101124,4180,4186,4200,4240,4196,4211,4214,25,28,25496,107464.62,51064
1351,a1105,20101125,4211,4214,4231,4235,4201,4205,4220,-9,6,15868,66969.81,50436
1352,a1105,20101126,4205,4220,4213,4217,4130,4155,4165,-65,-55,16470,68611.13,48866
1353,a1105,20101129,4155,4165,4140,4167,4111,4164,4135,-1,-30,16202,66999.45,44286
1354,a1105,20101130,4164,4135,4146,4160,4121,4151,4143,16,8,13624,56452.38,39674
1355,a1105,20101201,4151,4143,4143,4171,4132,4169,4155,26,12,5704,23704.96,38656
1356,a1105,20101202,4169,4155,4210,4243,4209,4226,4222,71,67,10996,46431.17,34042
1357,a1105,20101203,4226,4222,4218,4260,4210,4243,4238,21,16,6966,29524.19,31734
1358,a1105,20101206,4243,4238,4270,4274,4240,4250,4259,12,21,4878,20780.04,30822
1359,a1105,20101207,4250,4259,4250,4257,4225,4253,4240,-6,-19,3498,14833.87,31002
1360,a1105,20101208,4253,4240,4238,4238,4180,4180,4206,-60,-34,6670,28055.1,29574
1361,a1105,20101209,4180,4206,4212,4218,4198,4202,4210,-4,4,2892,12177.19,29424
1362,a1105,20101210,4202,4210,4204,4204,4183,4201,4192,-9,-18,2512,10531.06,28784
1363,a1105,20101213,4201,4192,4180,4244,4168,4231,4223,39,31,5782,24421.42,27284
1364,a1105,20101214,4231,4223,4250,4273,4240,4261,4256,38,33,5598,23826.23,25318
1365,a1105,20101215,4261,4256,4251,4370,4231,4232,4258,-24,2,8394,35749.55,21646
1366,a1105,20101216,4232,4258,4232,4254,4232,4242,4243,-16,-15,3276,13902.79,20162
1367,a1105,20101217,4242,4243,4246,4252,4237,4241,4242,-2,-1,4086,17336.79,17742
1368,a1105,20101220,4241,4242,4266,4279,4200,4230,4243,-12,1,4698,19937.19,17166
1369,a1105,20101221,4230,4243,4251,4261,4230,4261,4248,18,5,3378,14352.99,15896
1370,a1105,20101222,4261,4248,4276,4276,4236,4237,4253,-11,5,1664,7077.42,15448
1371,a1105,20101223,4237,4253,4246,4267,4238,4264,4254,11,1,1710,7274.38,14870
1372,a1105,20101224,4264,4254,4288,4350,4274,4341,4310,87,56,9102,39230.71,15850
1373,a1105,20101227,4341,4310,4325,4380,4316,4374,4356,64,46,7590,33065.37,16980
1374,a1105,20101228,4374,4356,4425,4445,4402,4402,4423,46,67,2962,13101.38,17032
1375,a1105,20101229,4402,4423,4380,4411,4347,4358,4376,-65,-47,1674,7326.77,16814
1376,a1105,20101230,4358,4376,4344,4375,4329,4375,4347,-1,-29,1082,4704.34,16716
1377,a1105,20101231,4375,4347,4363,4372,4350,4361,4362,14,15,790,3446.41,16586
1378,a1107,20100118,,3880,3879,3879,3840,3845,3865,-35,-15,32,123.68,20
1379,a1107,20100119,3845,3865,3850,3850,3850,3850,3850,-15,-15,4,15.4,20
1380,a1107,20100120,3850,3850,3945,3945,3810,3810,3843,-40,-7,24,92.25,16
1381,a1107,20100121,3810,3843,3866,3866,3800,3832,3830,-11,-13,102,390.74,60
1382,a1107,20100122,3832,3830,3825,3825,3785,3798,3802,-32,-28,48,182.54,70
1383,a1107,20100125,3798,3802,3836,3845,3836,3836,3839,34,37,12,46.07,68
1384,a1107,20100126,3836,3839,3820,3840,3820,3825,3838,-14,-1,174,667.98,224
1385,a1107,20100127,3825,3838,0,0,0,3838,3838,0,0,0,0,224
1386,a1107,20100128,3838,3838,3837,3837,3775,3778,3798,-60,-40,78,296.31,238
1387,a1107,20100129,3778,3798,3771,3797,3771,3771,3785,-27,-13,278,1052.39,38
1388,a1107,20100201,3771,3785,3752,3752,3707,3726,3730,-59,-55,46,171.61,46
1389,a1107,20100202,3726,3730,3725,3725,3660,3676,3704,-54,-26,28,103.72,54
1390,a1107,20100203,3676,3704,3691,3718,3691,3718,3707,14,3,16,59.32,46
1391,a1107,20100204,3718,3707,3707,3709,3675,3682,3690,-25,-17,32,118.1,50
1392,a1107,20100205,3682,3690,3700,3720,3700,3720,3700,30,10,1724,6379.17,1762
1393,a1107,20100208,3720,3700,3740,3740,3720,3720,3734,20,34,22,82.15,1760
1394,a1107,20100209,3720,3734,3730,3730,3730,3730,3730,-4,-4,2,7.46,1760
1395,a1107,20100210,3730,3730,3739,3746,3690,3693,3734,-37,4,436,1628.41,1418
1396,a1107,20100211,3693,3734,3733,3735,3725,3725,3730,-9,-4,26,96.99,1418
1397,a1107,20100212,3725,3730,3718,3719,3690,3693,3704,-37,-26,32,118.54,1432
1398,a1107,20100222,3693,3704,0,0,0,3704,3704,0,0,0,0,1432
1399,a1107,20100223,3704,3704,3720,3785,3720,3766,3756,62,52,20,75.13,1432
1400,a1107,20100224,3766,3756,3760,3774,3760,3763,3767,7,11,32,120.57,1434
1401,a1107,20100225,3763,3767,3776,3776,3741,3741,3757,-26,-10,36,135.25,1452
1402,a1107,20100226,3741,3757,3745,3766,3745,3754,3759,-3,2,42,157.9,1458
1403,a1107,20100301,3754,3759,3752,3815,3752,3798,3795,39,36,70,265.68,1466
1404,a1107,20100302,3798,3795,3788,3809,3788,3796,3794,1,-1,52,197.3,1456
1405,a1107,20100303,3796,3794,3819,3820,3809,3809,3816,15,22,28,106.87,1462
1406,a1107,20100304,3809,3816,3798,3798,3763,3763,3786,-53,-30,26,98.44,1478
1407,a1107,20100305,3763,3786,3770,3775,3766,3768,3770,-18,-16,50,188.54,1496
1408,a1107,20100308,3768,3770,3784,3785,3784,3785,3784,15,14,6,22.71,1494
1409,a1107,20100309,3785,3784,3780,3789,3777,3783,3784,-1,0,14,52.99,1498
1410,a1107,20100310,3783,3784,3795,3795,3778,3778,3789,-6,5,44,166.73,1492
1411,a1107,20100311,3778,3789,3791,3791,3753,3770,3775,-19,-14,28,105.71,1502
1412,a1107,20100312,3770,3775,3769,3769,3731,3742,3753,-33,-22,66,247.72,1516
1413,a1107,20100315,3742,3753,3733,3755,3733,3745,3741,-8,-12,20,74.83,1520
1414,a1107,20100316,3745,3741,3753,3781,3753,3781,3766,40,25,78,293.75,1536
1415,a1107,20100317,3781,3766,0,0,0,3766,3766,0,0,0,0,1536
1416,a1107,20100318,3766,3766,3800,3800,3775,3775,3783,9,17,18,68.1,1538
1417,a1107,20100319,3775,3783,3791,3813,3790,3802,3800,19,17,76,288.84,1508
1418,a1107,20100322,3802,3800,3800,3830,3800,3810,3815,10,15,80,305.22,1536
1419,a1107,20100323,3810,3815,3825,3825,3781,3781,3814,-34,-1,12,45.78,1536
1420,a1107,20100324,3781,3814,3813,3813,3802,3812,3809,-2,-5,36,137.13,1538
1421,a1107,20100325,3812,3809,3818,3825,3818,3820,3820,11,11,8,30.56,1540
1422,a1107,20100326,3820,3820,3785,3815,3785,3808,3802,-12,-18,64,243.35,1538
1423,a1107,20100329,3808,3802,3828,3844,3828,3834,3832,32,30,26,99.63,1518
1424,a1107,20100330,3834,3832,3832,3848,3821,3840,3839,8,7,50,191.97,1476
1425,a1107,20100331,3840,3839,3844,3856,3840,3840,3844,1,5,1360,5227.89,132
1426,a1107,20100401,3840,3844,3833,3833,3810,3833,3826,-11,-18,16,61.23,130
1427,a1107,20100402,3833,3826,3835,3839,3826,3831,3832,5,6,94,360.29,100
1428,a1107,20100406,3831,3832,3828,3828,3828,3828,3828,-4,-4,4,15.31,100
1429,a1107,20100407,3828,3828,3846,3850,3842,3848,3845,20,17,18,69.23,92
1430,a1107,20100408,3848,3845,3861,3876,3861,3865,3866,20,21,36,139.19,92
1431,a1107,20100409,3865,3866,3958,3958,3866,3898,3887,32,21,62,241.02,76
1432,a1107,20100412,3898,3887,3940,3940,3940,3940,3940,53,53,14,55.16,76
1433,a1107,20100413,3940,3940,3940,3940,3917,3939,3928,-1,-12,22,86.42,90
1434,a1107,20100414,3939,3928,0,0,0,3928,3928,0,0,0,0,90
1435,a1107,20100415,3928,3928,0,0,0,3928,3928,0,0,0,0,90
1436,a1107,20100416,3928,3928,3979,3979,3970,3970,3976,42,48,12,47.72,82
1437,a1107,20100419,3970,3976,3947,3947,3932,3932,3934,-44,-42,26,102.3,82
1438,a1107,20100420,3932,3934,3978,4012,3978,4007,4004,73,70,94,376.41,112
1439,a1107,20100421,4007,4004,4007,4034,4007,4026,4019,22,15,44,176.85,100
1440,a1107,20100422,4026,4019,4022,4058,4022,4050,4048,31,29,18,72.88,104
1441,a1107,20100423,4050,4048,4090,4093,4080,4080,4088,32,40,26,106.31,108
1442,a1107,20100426,4080,4088,4101,4129,4095,4095,4109,7,21,54,221.94,110
1443,a1107,20100427,4095,4109,4085,4094,4078,4094,4082,-15,-27,16,65.32,102
1444,a1107,20100428,4094,4082,4061,4064,4056,4056,4059,-26,-23,14,56.83,102
1445,a1107,20100429,4056,4059,4056,4056,4036,4055,4044,-4,-15,28,113.25,102
1446,a1107,20100430,4055,4044,4063,4085,4062,4085,4066,41,22,24,97.59,88
1447,a1107,20100504,4085,4066,4061,4070,4061,4065,4063,-1,-3,36,146.29,78
1448,a1107,20100505,4065,4063,4084,4109,4080,4108,4099,45,36,30,122.97,62
1449,a1107,20100506,4108,4099,4095,4095,4080,4080,4089,-19,-10,14,57.25,70
1450,a1107,20100507,4080,4089,4009,4009,3975,3980,3996,-109,-93,12,47.96,74
1451,a1107,20100510,3980,3996,3980,4020,3980,4020,4001,24,5,10,40.01,70
1452,a1107,20100511,4020,4001,3980,3980,3980,3980,3980,-21,-21,2,7.96,68
1453,a1107,20100512,3980,3980,4010,4010,4010,4010,4010,30,30,2,8.02,70
1454,a1107,20100513,4010,4010,0,0,0,4010,4010,0,0,0,0,70
1455,a1107,20100514,4010,4010,4004,4004,4004,4004,4004,-6,-6,2,8.01,70
1456,a1107,20100517,4004,4004,3978,3978,3910,3910,3942,-94,-62,52,205,60
1457,a1107,20100518,3910,3942,3958,3958,3935,3949,3948,7,6,12,47.38,60
1458,a1107,20100519,3949,3948,3929,3934,3897,3934,3920,-14,-28,10,39.21,56
1459,a1107,20100520,3934,3920,0,0,0,3920,3920,0,0,0,0,56
1460,a1107,20100521,3920,3920,3841,3960,3841,3960,3924,40,4,12,47.09,56
1461,a1107,20100524,3960,3924,3965,3965,3965,3965,3965,41,41,2,7.93,56
1462,a1107,20100525,3965,3965,3930,3930,3856,3917,3907,-48,-58,18,70.33,56
1463,a1107,20100526,3917,3907,3939,3939,3939,3939,3939,32,32,2,7.88,56
1464,a1107,20100527,3939,3939,0,0,0,3939,3939,0,0,0,0,56
1465,a1107,20100528,3939,3939,0,0,0,3939,3939,0,0,0,0,56
1466,a1107,20100531,3939,3939,0,0,0,3939,3939,0,0,0,0,56
1467,a1107,20100601,3939,3939,0,0,0,3939,3939,0,0,0,0,56
1468,a1107,20100602,3939,3939,3888,3888,3845,3859,3855,-80,-84,58,223.64,64
1469,a1107,20100603,3859,3855,3860,3878,3859,3859,3864,4,9,8,30.92,64
1470,a1107,20100604,3859,3864,3856,3883,3855,3879,3867,15,3,16,61.88,62
1471,a1107,20100607,3879,3867,3812,3812,3812,3812,3812,-55,-55,6,22.87,62
1472,a1107,20100608,3812,3812,3839,3845,3831,3831,3836,19,24,34,130.46,62
1473,a1107,20100609,3831,3836,0,0,0,3836,3836,0,0,0,0,62
1474,a1107,20100610,3836,3836,0,0,0,3836,3836,0,0,0,0,62
1475,a1107,20100611,3836,3836,0,0,0,3836,3836,0,0,0,0,62
1476,a1107,20100617,3836,3836,3850,3850,3836,3836,3837,0,1,18,69.08,54
1477,a1107,20100618,3836,3837,3847,3851,3847,3851,3849,14,12,140,538.86,194
1478,a1107,20100621,3851,3849,3843,3900,3842,3900,3881,51,32,34,131.97,186
1479,a1107,20100622,3900,3881,3886,3886,3886,3886,3886,5,5,2,7.77,186
1480,a1107,20100623,3886,3886,3900,3915,3875,3877,3886,-9,0,20,77.74,194
1481,a1107,20100624,3877,3886,3883,3894,3877,3877,3883,-9,-3,372,1444.68,554
1482,a1107,20100625,3877,3883,3814,3885,3814,3868,3851,-15,-32,8,30.81,552
1483,a1107,20100628,3868,3851,3848,3954,3847,3864,3876,13,25,74,286.88,536
1484,a1107,20100629,3864,3876,3865,3865,3851,3851,3858,-25,-18,4,15.43,538
1485,a1107,20100630,3851,3858,3838,3838,3811,3813,3821,-45,-37,12,45.85,534
1486,a1107,20100701,3813,3821,0,0,0,3821,3821,0,0,0,0,534
1487,a1107,20100702,3821,3821,3822,3838,3822,3838,3830,17,9,8,30.64,534
1488,a1107,20100705,3838,3830,3835,3835,3835,3835,3835,5,5,4,15.34,538
1489,a1107,20100706,3835,3835,3815,3815,3815,3815,3815,-20,-20,2,7.63,538
1490,a1107,20100707,3815,3815,0,0,0,3815,3815,0,0,0,0,538
1491,a1107,20100708,3815,3815,3899,3899,3857,3857,3874,42,59,18,69.74,534
1492,a1107,20100709,3857,3874,0,0,0,3874,3874,0,0,0,0,534
1493,a1107,20100712,3874,3874,0,0,0,3874,3874,0,0,0,0,534
1494,a1107,20100713,3874,3874,0,0,0,3874,3874,0,0,0,0,534
1495,a1107,20100714,3874,3874,0,0,0,3874,3874,0,0,0,0,534
1496,a1107,20100715,3874,3874,0,0,0,3874,3874,0,0,0,0,534
1497,a1107,20100716,3874,3874,3939,3949,3920,3949,3936,75,62,6,23.62,530
1498,a1107,20100719,3949,3936,3924,3940,3924,3940,3932,4,-4,4,15.73,528
1499,a1107,20100720,3940,3932,0,0,0,3932,3932,0,0,0,0,528
1500,a1107,20100721,3932,3932,0,0,0,3932,3932,0,0,0,0,528
1501,a1107,20100722,3932,3932,3939,3939,3939,3939,3939,7,7,4,15.76,526
1502,a1107,20100723,3939,3939,3959,3976,3951,3951,3961,12,22,24,95.07,528
1503,a1107,20100726,3951,3961,0,0,0,3961,3961,0,0,0,0,528
1504,a1107,20100727,3961,3961,3926,3926,3920,3920,3922,-41,-39,6,23.53,532
1505,a1107,20100728,3920,3922,3928,3930,3928,3930,3928,8,6,10,39.28,522
1506,a1107,20100729,3930,3928,0,0,0,3928,3928,0,0,0,0,522
1507,a1107,20100730,3928,3928,3977,3986,3961,3978,3973,50,45,20,79.47,524
1508,a1107,20100802,3978,3973,0,0,0,3973,3973,0,0,0,0,524
1509,a1107,20100803,3973,3973,4003,4020,3970,4015,4002,42,29,8,32.02,524
1510,a1107,20100804,4015,4002,0,0,0,4002,4002,0,0,0,0,524
1511,a1107,20100805,4002,4002,4007,4007,3970,3970,3987,-32,-15,10,39.87,528
1512,a1107,20100806,3970,3987,3990,4035,3990,3995,4006,8,19,6,24.04,526
1513,a1107,20100809,3995,4006,4022,4078,4021,4051,4050,45,44,54,218.73,536
1514,a1107,20100810,4051,4050,0,0,0,4050,4050,0,0,0,0,536
1515,a1107,20100811,4050,4050,4052,4052,4006,4035,4029,-15,-21,16,64.48,542
1516,a1107,20100812,4035,4029,4035,4037,4032,4037,4034,8,5,14,56.48,530
1517,a1107,20100813,4037,4034,4051,4100,4040,4100,4073,66,39,12,48.88,528
1518,a1107,20100816,4100,4073,4162,4164,4162,4164,4163,91,90,4,16.65,528
1519,a1107,20100817,4164,4163,4130,4130,4130,4130,4130,-33,-33,8,33.04,526
1520,a1107,20100818,4130,4130,4155,4155,4081,4081,4119,-49,-11,478,1969.36,708
1521,a1107,20100819,4081,4119,4119,4120,4075,4075,4107,-44,-12,42,172.53,706
1522,a1107,20100820,4075,4107,4060,4060,4025,4025,4043,-82,-64,48,194.07,728
1523,a1107,20100823,4025,4043,4020,4020,4020,4020,4020,-23,-23,2,8.04,728
1524,a1107,20100824,4020,4020,4012,4012,4006,4006,4010,-14,-10,8,32.08,730
1525,a1107,20100825,4006,4010,4002,4022,3983,3983,4004,-27,-6,30,120.14,736
1526,a1107,20100826,3983,4004,4008,4017,4006,4016,4012,12,8,18,72.22,732
1527,a1107,20100827,4016,4012,4021,4037,4021,4037,4030,25,18,42,169.27,702
1528,a1107,20100830,4037,4030,4059,4087,4059,4060,4075,30,45,28,114.1,704
1529,a1107,20100831,4060,4075,4035,4035,4007,4016,4016,-59,-59,26,104.42,712
1530,a1107,20100901,4016,4016,4020,4020,4000,4008,4010,-8,-6,24,96.26,718
1531,a1107,20100902,4008,4010,4015,4019,4000,4011,4013,1,3,34,136.46,702
1532,a1107,20100903,4011,4013,4029,4048,4019,4048,4031,35,18,52,209.62,702
1533,a1107,20100906,4048,4031,4060,4096,4060,4080,4085,49,54,64,261.48,706
1534,a1107,20100907,4080,4085,4081,4081,4080,4080,4080,-5,-5,6,24.48,708
1535,a1107,20100908,4080,4080,4096,4113,4091,4095,4096,15,16,48,196.65,708
1536,a1107,20100909,4095,4096,4060,4060,4032,4032,4046,-64,-50,8,32.37,708
1537,a1107,20100910,4032,4046,4059,4059,4028,4051,4048,5,2,44,178.14,708
1538,a1107,20100913,4051,4048,0,0,0,4048,4048,0,0,0,0,708
1539,a1107,20100914,4048,4048,4031,4031,4028,4028,4029,-20,-19,6,24.17,712
1540,a1107,20100915,4028,4029,4040,4078,4040,4078,4050,49,21,16,64.81,710
1541,a1107,20100916,4078,4050,0,0,0,4050,4050,0,0,0,0,710
1542,a1107,20100917,4050,4050,4057,4057,4051,4051,4054,1,4,200,810.8,510
1543,a1107,20100920,4051,4054,4138,4173,4070,4150,4108,96,54,1864,7657.81,1152
1544,a1107,20100921,4150,4108,4130,4147,4053,4120,4125,12,17,172,709.52,1142
1545,a1107,20100927,4120,4125,4211,4211,4170,4180,4187,55,62,96,401.97,1128
1546,a1107,20100928,4180,4187,4110,4198,4110,4198,4172,11,-15,36,150.22,1136
1547,a1107,20100929,4198,4172,4139,4150,4098,4130,4131,-42,-41,96,396.67,1072
1548,a1107,20100930,4130,4131,4116,4136,4109,4136,4116,5,-15,92,378.74,1070
1549,a1107,20101008,4136,4116,4136,4138,4110,4110,4124,-6,8,46,189.73,1058
1550,a1107,20101011,4110,4124,4288,4288,4288,4288,4288,164,164,14,60.03,1056
1551,a1107,20101012,4288,4288,4300,4305,4280,4299,4290,11,2,88,377.54,1046
1552,a1107,20101013,4299,4290,4324,4325,4281,4320,4295,30,5,74,317.85,1046
1553,a1107,20101014,4320,4295,4327,4328,4311,4327,4323,32,28,8,34.59,1050
1554,a1107,20101015,4327,4323,4310,4357,4291,4357,4329,34,6,80,346.37,1042
1555,a1107,20101018,4357,4329,4309,4309,4283,4297,4296,-32,-33,6,25.78,1040
1556,a1107,20101019,4297,4296,4316,4328,4310,4328,4316,32,20,10,43.16,1038
1557,a1107,20101020,4328,4316,4188,4316,4188,4316,4281,0,-35,28,119.88,1040
1558,a1107,20101021,4316,4281,4400,4400,4350,4359,4366,78,85,30,130.99,1040
1559,a1107,20101022,4359,4366,4385,4385,4350,4368,4362,2,-4,18,78.52,1040
1560,a1107,20101025,4368,4362,4418,4459,4416,4459,4444,97,82,90,399.97,1058
1561,a1107,20101026,4459,4444,4406,4430,4388,4412,4406,-32,-38,54,237.93,1062
1562,a1107,20101027,4412,4406,4444,4444,4321,4357,4353,-49,-53,28,121.89,1066
1563,a1107,20101028,4357,4353,4300,4368,4300,4368,4347,15,-6,54,234.74,1068
1564,a1107,20101029,4368,4347,4393,4393,4272,4306,4311,-41,-36,48,206.97,1066
1565,a1107,20101101,4306,4311,4328,4383,4328,4379,4363,68,52,60,261.79,1072
1566,a1107,20101102,4379,4363,4363,4379,4351,4370,4362,7,-1,40,174.52,1072
1567,a1107,20101103,4370,4362,4400,4400,4356,4356,4376,-6,14,18,78.78,1070
1568,a1107,20101104,4356,4376,4373,4425,4370,4425,4389,49,13,38,166.79,1086
1569,a1107,20101105,4425,4389,4488,4564,4488,4564,4546,175,157,40,181.87,1094
1570,a1107,20101108,4564,4546,4614,4664,4520,4630,4606,84,60,134,617.22,1132
1571,a1107,20101109,4630,4606,4630,4666,4566,4658,4611,52,5,160,737.91,1128
1572,a1107,20101110,4658,4611,4670,4790,4670,4735,4753,124,142,126,598.99,1160
1573,a1107,20101111,4735,4753,4680,4760,4680,4760,4726,7,-27,306,1446.36,912
1574,a1107,20101112,4760,4726,4615,4653,4537,4537,4589,-189,-137,742,3405.31,820
1575,a1107,20101115,4537,4589,4406,4564,4406,4450,4479,-139,-110,192,860.12,812
1576,a1107,20101116,4450,4479,4469,4495,4346,4444,4429,-35,-50,50,221.48,808
1577,a1107,20101117,4444,4429,4253,4270,4252,4270,4253,-159,-176,22,93.58,802
1578,a1107,20101118,4270,4253,4273,4286,4169,4286,4203,33,-50,112,470.81,796
1579,a1107,20101119,4286,4203,4250,4359,4250,4310,4290,107,87,56,240.24,812
1580,a1107,20101122,4310,4290,4261,4290,4247,4265,4265,-25,-25,16,68.25,806
1581,a1107,20101123,4265,4265,4270,4300,4253,4275,4273,10,8,24,102.57,806
1582,a1107,20101124,4275,4273,4279,4353,4277,4310,4306,37,33,62,267,810
1583,a1107,20101125,4310,4306,4328,4328,4288,4305,4308,-1,2,22,94.79,802
1584,a1107,20101126,4305,4308,4309,4309,4219,4255,4269,-53,-39,16,68.31,802
1585,a1107,20101129,4255,4269,4298,4298,4191,4236,4252,-33,-17,34,144.58,802
1586,a1107,20101130,4236,4252,4218,4228,4191,4211,4212,-41,-40,104,438.11,786
1587,a1107,20101201,4211,4212,4196,4235,4196,4234,4224,22,12,28,118.29,780
1588,a1107,20101202,4234,4224,4293,4329,4278,4299,4296,75,72,24,103.11,780
1589,a1107,20101203,4299,4296,4291,4330,4291,4330,4309,34,13,22,94.81,780
1590,a1107,20101206,4330,4309,4340,4340,4306,4329,4325,20,16,12,51.9,780
1591,a1107,20101207,4329,4325,4285,4331,4285,4325,4306,0,-19,48,206.7,776
1592,a1107,20101208,4325,4306,4316,4316,4252,4288,4280,-18,-26,30,128.4,770
1593,a1107,20101209,4288,4280,4300,4300,4290,4300,4297,20,17,8,34.38,770
1594,a1107,20101210,4300,4297,4265,4300,4261,4300,4269,3,-28,32,136.63,756
1595,a1107,20101213,4300,4269,4300,4328,4300,4322,4314,53,45,14,60.4,756
1596,a1107,20101214,4322,4314,4366,4366,4330,4350,4345,36,31,62,269.42,752
1597,a1107,20101215,4350,4345,4370,4370,4308,4339,4342,-6,-3,16,69.48,750
1598,a1107,20101216,4339,4342,4403,4403,4315,4318,4342,-24,0,42,182.4,760
1599,a1107,20101217,4318,4342,4311,4330,4311,4330,4316,-12,-26,78,336.71,730
1600,a1107,20101220,4330,4316,4366,4366,4301,4311,4334,-5,18,22,95.36,734
1601,a1107,20101221,4311,4334,4315,4355,4314,4355,4331,21,-3,18,77.97,736
1602,a1107,20101222,4355,4331,4360,4360,4327,4327,4339,-4,8,8,34.71,736
1603,a1107,20101223,4327,4339,4342,4342,4342,4342,4342,3,3,6,26.05,730
1604,a1107,20101224,4342,4342,4372,4450,4372,4450,4418,108,76,42,185.57,738
1605,a1107,20101227,4450,4418,4466,4499,4415,4499,4438,81,20,72,319.59,768
1606,a1107,20101228,4499,4438,4488,4538,4488,4501,4502,63,64,36,162.09,750
1607,a1107,20101229,4501,4502,4458,4463,4419,4430,4443,-72,-59,14,62.21,748
1608,a1107,20101230,4430,4443,4440,4465,4440,4465,4455,22,12,6,26.73,748
1609,a1107,20101231,4465,4455,4465,4465,4432,4448,4449,-7,-6,14,62.29,744
1610,a1109,20100315,,3793,3800,3800,3765,3765,3774,-28,-19,406,1532.59,252
1611,a1109,20100316,3765,3774,3786,3805,3775,3785,3789,11,15,164,621.42,322
1612,a1109,20100317,3785,3789,3813,3819,3784,3799,3803,10,14,308,1171.56,486
1613,a1109,20100318,3799,3803,3801,3807,3790,3791,3798,-12,-5,92,349.43,508
1614,a1109,20100319,3791,3798,3819,3828,3806,3809,3816,11,18,158,602.94,574
1615,a1109,20100322,3809,3816,3820,3849,3813,3832,3830,16,14,262,1003.55,658
1616,a1109,20100323,3832,3830,3878,3878,3833,3836,3846,6,16,244,938.58,696
1617,a1109,20100324,3836,3846,3825,3840,3820,3820,3829,-26,-17,216,827.07,774
1618,a1109,20100325,3820,3829,3813,3844,3813,3832,3835,3,6,144,552.36,816
1619,a1109,20100326,3832,3835,3823,3835,3816,3832,3823,-3,-12,194,741.75,870
1620,a1109,20100329,3832,3823,3841,3852,3836,3848,3844,25,21,114,438.29,880
1621,a1109,20100330,3848,3844,3868,3870,3846,3860,3860,16,16,178,687.21,904
1622,a1109,20100331,3860,3860,3865,3873,3850,3853,3862,-7,2,232,896.17,916
1623,a1109,20100401,3853,3862,3860,3860,3813,3844,3846,-18,-16,278,1069.38,994
1624,a1109,20100402,3844,3846,3853,3859,3845,3849,3852,3,6,226,870.62,1048
1625,a1109,20100406,3849,3852,3852,3858,3842,3858,3851,6,-1,110,423.7,1054
1626,a1109,20100407,3858,3851,3868,3888,3854,3881,3873,30,22,170,658.44,1082
1627,a1109,20100408,3881,3873,3879,3913,3879,3881,3899,8,26,394,1536.39,1220
1628,a1109,20100409,3881,3899,3886,3914,3886,3910,3902,11,3,220,858.63,1198
1629,a1109,20100412,3910,3902,3913,3974,3913,3971,3959,69,57,788,3119.79,1548
1630,a1109,20100413,3971,3959,3956,4050,3951,4000,3979,41,20,922,3668.73,1818
1631,a1109,20100414,4000,3979,4014,4015,3960,3995,3995,16,16,364,1454.26,1862
1632,a1109,20100415,3995,3995,4010,4014,3982,3982,3996,-13,1,264,1054.96,1894
1633,a1109,20100416,3982,3996,4010,4012,3999,4007,4007,11,11,398,1595.03,1860
1634,a1109,20100419,4007,4007,4000,4005,3982,3982,3996,-25,-11,394,1574.52,1904
1635,a1109,20100420,3982,3996,4008,4048,4006,4044,4033,48,37,520,2097.18,1890
1636,a1109,20100421,4044,4033,4040,4064,4040,4062,4054,29,21,290,1175.69,1898
1637,a1109,20100422,4062,4054,4066,4100,4066,4086,4082,32,28,590,2408.42,2002
1638,a1109,20100423,4086,4082,4085,4120,4085,4120,4105,38,23,970,3982.28,2070
1639,a1109,20100426,4120,4105,4125,4161,4123,4150,4145,45,40,2348,9733.43,2928
1640,a1109,20100427,4150,4145,4145,4145,4129,4134,4136,-11,-9,2242,9273.06,3052
1641,a1109,20100428,4134,4136,4106,4109,4081,4090,4094,-46,-42,2120,8680.34,2848
1642,a1109,20100429,4090,4094,4097,4112,4083,4085,4097,-9,3,1464,5999.16,2876
1643,a1109,20100430,4085,4097,4096,4118,4088,4118,4098,21,1,1176,4819.64,2760
1644,a1109,20100504,4118,4098,4085,4108,4085,4088,4092,-10,-6,1208,4943.14,2762
1645,a1109,20100505,4088,4092,4031,4130,4031,4129,4106,37,14,1896,7785.32,2574
1646,a1109,20100506,4129,4106,4130,4130,4091,4092,4106,-14,0,1670,6857.53,2568
1647,a1109,20100507,4092,4106,4050,4060,4000,4002,4028,-104,-78,1820,7331.96,2572
1648,a1109,20100510,4002,4028,4029,4053,4025,4050,4040,22,12,1062,4291.13,2434
1649,a1109,20100511,4050,4040,4040,4048,4018,4020,4032,-20,-8,738,2976.03,2454
1650,a1109,20100512,4020,4032,4035,4059,4031,4046,4046,14,14,860,3480.21,2452
1651,a1109,20100513,4046,4046,4033,4054,4033,4046,4045,0,-1,566,2289.64,2476
1652,a1109,20100514,4046,4045,4040,4045,4021,4026,4034,-19,-11,584,2356.16,2522
1653,a1109,20100517,4026,4034,4000,4019,3936,3951,3973,-83,-61,1368,5435.9,2518
1654,a1109,20100518,3951,3973,3960,4063,3954,3990,3981,17,8,862,3432.16,2794
1655,a1109,20100519,3990,3981,3979,3984,3958,3964,3968,-17,-13,682,2706.49,2748
1656,a1109,20100520,3964,3968,3997,3997,3965,3975,3981,7,13,418,1664.18,2668
1657,a1109,20100521,3975,3981,3963,4001,3963,3996,3989,15,8,524,2090.64,2710
1658,a1109,20100524,3996,3989,3996,4010,3995,4005,4002,16,13,300,1200.71,2770
1659,a1109,20100525,4005,4002,4000,4000,3960,3960,3974,-42,-28,774,3075.97,2868
1660,a1109,20100526,3960,3974,3970,3985,3951,3977,3968,3,-6,596,2365.13,2998
1661,a1109,20100527,3977,3968,3975,3988,3958,3958,3978,-10,10,596,2370.95,3126
1662,a1109,20100528,3958,3978,3986,3993,3974,3974,3986,-4,8,458,1825.7,3154
1663,a1109,20100531,3974,3986,3957,3959,3880,3885,3906,-101,-80,4274,16695.21,3586
1664,a1109,20100601,3885,3906,3895,3899,3865,3867,3876,-39,-30,2300,8916.9,3738
1665,a1109,20100602,3867,3876,3866,3889,3855,3885,3876,9,0,1206,4675.35,3716
1666,a1109,20100603,3885,3876,3871,3896,3871,3882,3888,6,12,482,1874.04,3634
1667,a1109,20100604,3882,3888,3895,3915,3885,3892,3896,4,8,286,1114.51,3592
1668,a1109,20100607,3892,3896,3850,3850,3800,3831,3825,-65,-71,1664,6365.78,4052
1669,a1109,20100608,3831,3825,3835,3866,3830,3856,3852,31,27,698,2688.93,4194
1670,a1109,20100609,3856,3852,3846,3853,3830,3853,3838,1,-14,908,3484.91,4042
1671,a1109,20100610,3853,3838,3856,3878,3851,3860,3864,22,26,596,2303.37,3918
1672,a1109,20100611,3860,3864,3844,3865,3844,3859,3859,-5,-5,506,1952.73,3592
1673,a1109,20100617,3859,3859,3895,3896,3850,3850,3862,-9,3,4144,16004.72,4860
1674,a1109,20100618,3850,3862,3861,3880,3860,3868,3868,6,6,1500,5802.18,5648
1675,a1109,20100621,3868,3868,3900,3914,3885,3913,3897,45,29,6036,23526.03,8644
1676,a1109,20100622,3913,3897,3895,3898,3891,3897,3895,0,-2,1330,5181.5,9006
1677,a1109,20100623,3897,3895,3886,3896,3875,3890,3888,-5,-7,882,3429.46,9148
1678,a1109,20100624,3890,3888,3880,3898,3880,3888,3888,0,0,412,1601.97,9126
1679,a1109,20100625,3888,3888,3876,3888,3872,3876,3877,-12,-11,708,2745.03,9122
1680,a1109,20100628,3876,3877,3881,3884,3868,3873,3871,-4,-6,2058,7966.84,9744
1681,a1109,20100629,3873,3871,3871,3880,3838,3847,3863,-24,-8,3012,11637.02,11166
1682,a1109,20100630,3847,3863,3833,3839,3822,3832,3828,-31,-35,636,2434.95,11214
1683,a1109,20100701,3832,3828,3820,3834,3820,3824,3826,-4,-2,470,1798.52,11212
1684,a1109,20100702,3824,3826,3824,3846,3824,3842,3833,16,7,1362,5221.19,11530
1685,a1109,20100705,3842,3833,3843,3845,3827,3830,3835,-3,2,610,2339.53,11504
1686,a1109,20100706,3830,3835,3829,3829,3806,3823,3816,-12,-19,1568,5985.04,11314
1687,a1109,20100707,3823,3816,3816,3835,3816,3831,3828,15,12,1754,6715.76,11274
1688,a1109,20100708,3831,3828,3851,3878,3851,3858,3864,30,36,3468,13401.14,12672
1689,a1109,20100709,3858,3864,3880,3894,3865,3893,3878,29,14,3196,12395.37,13166
1690,a1109,20100712,3893,3878,3902,3918,3868,3868,3882,-10,4,1556,6041.55,13584
1691,a1109,20100713,3868,3882,3880,3881,3856,3858,3870,-24,-12,1144,4428.21,13636
1692,a1109,20100714,3858,3870,3866,3879,3865,3870,3869,0,-1,1258,4867.21,14108
1693,a1109,20100715,3870,3869,3879,3908,3868,3885,3888,16,19,4542,17661.4,15128
1694,a1109,20100716,3885,3888,3917,3943,3915,3937,3933,49,45,2652,10430.49,15608
1695,a1109,20100719,3937,3933,3923,3960,3923,3957,3941,24,8,2336,9207.02,15882
1696,a1109,20100720,3957,3941,3940,3980,3938,3973,3955,32,14,3942,15592.1,16792
1697,a1109,20100721,3973,3955,3972,3988,3940,3947,3956,-8,1,14830,58681.68,25204
1698,a1109,20100722,3947,3956,3953,3955,3918,3930,3933,-26,-23,9294,36556.15,28398
1699,a1109,20100723,3930,3933,3930,3963,3930,3950,3952,17,19,5456,21565.06,29240
1700,a1109,20100726,3950,3952,3948,3970,3936,3962,3957,10,5,6504,25738.2,30830
1701,a1109,20100727,3962,3957,3941,3947,3906,3910,3919,-47,-38,6256,24523.27,32688
1702,a1109,20100728,3910,3919,3914,3932,3912,3930,3921,11,2,3614,14171.61,32760
1703,a1109,20100729,3930,3921,3950,3950,3926,3948,3939,27,18,3852,15176.09,32724
1704,a1109,20100730,3948,3939,3962,3970,3955,3963,3964,24,25,6704,26575.18,33146
1705,a1109,20100802,3963,3964,3983,4048,3983,4037,4031,73,67,10456,42157.68,35024
1706,a1109,20100803,4037,4031,4026,4030,3990,3990,4007,-41,-24,8836,35408.87,36140
1707,a1109,20100804,3990,4007,4004,4037,3995,4008,4013,1,6,8618,34591.92,36912
1708,a1109,20100805,4008,4013,4027,4038,3963,3972,3996,-41,-17,14778,59064.86,40866
1709,a1109,20100806,3972,3996,3986,3996,3949,3996,3973,0,-23,20470,81337.92,49122
1710,a1109,20100809,3996,3973,4000,4079,3990,4059,4038,86,65,21356,86238.48,49158
1711,a1109,20100810,4059,4038,4036,4042,4002,4010,4016,-28,-22,26322,105729.92,58176
1712,a1109,20100811,4010,4016,4008,4032,4003,4008,4017,-8,1,13908,55877.41,58400
1713,a1109,20100812,4008,4017,4004,4045,3992,4025,4023,8,6,12704,51114.63,58510
1714,a1109,20100813,4025,4023,4045,4108,4044,4106,4074,83,51,21260,86613.46,60016
1715,a1109,20100816,4106,4074,4129,4189,4121,4165,4162,91,88,28824,119977.79,61502
1716,a1109,20100817,4165,4162,4146,4152,4117,4145,4130,-17,-32,23008,95025.15,66646
1717,a1109,20100818,4145,4130,4178,4185,4102,4113,4156,-17,26,27818,115612.52,69606
1718,a1109,20100819,4113,4156,4119,4124,4086,4105,4106,-51,-50,20142,82705.27,69988
1719,a1109,20100820,4105,4106,4066,4075,4030,4031,4046,-75,-60,14694,59457.06,68752
1720,a1109,20100823,4031,4046,4033,4056,4021,4029,4037,-17,-9,10736,43350.78,68654
1721,a1109,20100824,4029,4037,4025,4038,4003,4005,4020,-32,-17,21426,86134.85,75306
1722,a1109,20100825,4005,4020,4015,4026,3987,3998,4009,-22,-11,19142,76748.27,77678
1723,a1109,20100826,3998,4009,4009,4023,4005,4018,4013,9,4,19616,78719.4,85088
1724,a1109,20100827,4018,4013,4034,4050,4025,4041,4036,28,23,13310,53730.31,85408
1725,a1109,20100830,4041,4036,4072,4088,4060,4070,4076,34,40,15418,62847.99,85132
1726,a1109,20100831,4070,4076,4039,4039,4008,4011,4022,-65,-54,14334,57653.06,84916
1727,a1109,20100901,4011,4022,4016,4034,4002,4018,4017,-4,-5,8716,35019.08,85364
1728,a1109,20100902,4018,4017,4015,4041,4012,4029,4026,12,9,26612,107149.49,90678
1729,a1109,20100903,4029,4026,4035,4067,4026,4067,4047,41,21,18262,73916.83,92112
1730,a1109,20100906,4067,4047,4091,4128,4091,4098,4102,51,55,32750,134359.62,103054
1731,a1109,20100907,4098,4102,4103,4125,4082,4124,4101,22,-1,38454,157711.02,108672
1732,a1109,20100908,4124,4101,4153,4154,4103,4108,4126,7,25,19350,79840.98,108826
1733,a1109,20100909,4108,4126,4120,4123,4012,4056,4064,-70,-62,25590,104007.98,106326
1734,a1109,20100910,4056,4064,4069,4079,4049,4072,4063,8,-1,17762,72183.73,108480
1735,a1109,20100913,4072,4063,4054,4069,4050,4067,4057,4,-6,12614,51180.39,109424
1736,a1109,20100914,4067,4057,4060,4071,4038,4050,4057,-7,0,12666,51394.17,109814
1737,a1109,20100915,4050,4057,4065,4095,4051,4094,4077,37,20,35200,143512.53,114636
1738,a1109,20100916,4094,4077,4100,4118,4081,4095,4098,18,21,38020,155816.97,114546
1739,a1109,20100917,4095,4098,4110,4118,4087,4105,4104,7,6,40464,166076.45,118348
1740,a1109,20100920,4105,4104,4175,4252,4153,4196,4219,92,115,111740,471439.09,139248
1741,a1109,20100921,4196,4219,4191,4194,4140,4168,4166,-51,-53,55546,231429.84,136470
1742,a1109,20100927,4168,4166,4298,4299,4206,4216,4240,50,74,57582,244157.19,137820
1743,a1109,20100928,4216,4240,4206,4230,4192,4228,4213,-12,-27,26292,110775.53,138010
1744,a1109,20100929,4228,4213,4200,4200,4145,4161,4170,-52,-43,34232,142779.53,132972
1745,a1109,20100930,4161,4170,4152,4169,4142,4164,4158,-6,-12,28502,118517.61,132470
1746,a1109,20101008,4164,4158,4115,4173,4115,4141,4154,-17,-4,17596,73109.08,132904
1747,a1109,20101011,4141,4154,4320,4320,4320,4320,4320,166,166,14778,63840.96,142954
1748,a1109,20101012,4320,4320,4300,4341,4249,4311,4315,-9,-5,99194,428098,129142
1749,a1109,20101013,4311,4315,4329,4369,4312,4347,4335,32,20,84770,367538.81,141392
1750,a1109,20101014,4347,4335,4352,4375,4339,4355,4356,20,21,64558,281235.44,141264
1751,a1109,20101015,4355,4356,4361,4399,4319,4389,4364,33,8,81100,353946.52,139462
1752,a1109,20101018,4389,4364,4345,4362,4299,4316,4323,-48,-41,77702,335922.45,153584
1753,a1109,20101019,4316,4323,4345,4377,4330,4348,4352,25,29,59514,259024.98,155254
1754,a1109,20101020,4348,4352,4298,4368,4281,4360,4338,8,-14,82270,356961.58,163262
1755,a1109,20101021,4360,4338,4418,4460,4386,4412,4429,74,91,250390,1109022.49,199586
1756,a1109,20101022,4412,4429,4400,4456,4396,4430,4432,1,3,192122,851647.11,224818
1757,a1109,20101025,4430,4432,4450,4564,4449,4519,4509,87,77,394104,1777219.25,274556
1758,a1109,20101026,4519,4509,4521,4524,4464,4470,4488,-39,-21,328296,1473397.47,291206
1759,a1109,20101027,4470,4488,4520,4521,4338,4380,4433,-108,-55,313268,1388905.85,286626
1760,a1109,20101028,4380,4433,4415,4437,4388,4425,4416,-8,-17,187200,826772.97,287728
1761,a1109,20101029,4425,4416,4400,4410,4325,4357,4371,-59,-45,203044,887595.59,271858
1762,a1109,20101101,4357,4371,4381,4476,4381,4454,4452,83,81,367680,1637163.67,304702
1763,a1109,20101102,4454,4452,4456,4466,4426,4441,4447,-11,-5,307044,1365526.73,310228
1764,a1109,20101103,4441,4447,4455,4464,4398,4415,4441,-32,-6,300646,1335314.12,303316
1765,a1109,20101104,4415,4441,4451,4508,4436,4505,4478,64,37,437570,1959653.35,312864
1766,a1109,20101105,4505,4478,4577,4657,4558,4657,4627,179,149,627364,2903375.82,333626
1767,a1109,20101108,4657,4627,4620,4722,4600,4656,4656,29,29,811736,3779899.81,331406
1768,a1109,20101109,4656,4656,4633,4720,4620,4690,4671,34,15,607234,2836689.04,340112
1769,a1109,20101110,4690,4671,4748,4835,4702,4748,4778,77,107,1002486,4790646.3,356864
1770,a1109,20101111,4748,4778,4780,4816,4722,4769,4775,-9,-3,848684,4052708.63,365542
1771,a1109,20101112,4769,4775,4778,4779,4584,4584,4637,-191,-138,801982,3719453.52,336810
1772,a1109,20101115,4584,4637,4520,4631,4452,4538,4545,-99,-92,992420,4510757.76,320244
1773,a1109,20101116,4538,4545,4553,4566,4455,4465,4517,-80,-28,805754,3639639.98,324792
1774,a1109,20101117,4465,4517,4337,4357,4337,4337,4340,-180,-177,154270,669590.59,296840
1775,a1109,20101118,4337,4340,4375,4398,4255,4341,4324,1,-16,687140,2971670.25,289258
1776,a1109,20101119,4341,4324,4400,4402,4308,4362,4353,38,29,556640,2423122.36,290730
1777,a1109,20101122,4362,4353,4281,4347,4280,4309,4319,-44,-34,388592,1678444.63,286236
1778,a1109,20101123,4309,4319,4329,4378,4303,4345,4347,26,28,1388754,6037854.95,344508
1779,a1109,20101124,4345,4347,4374,4413,4359,4380,4383,33,36,797182,3494711.67,334600
1780,a1109,20101125,4380,4383,4399,4407,4365,4366,4388,-17,5,480134,2106899.18,305036
1781,a1109,20101126,4366,4388,4380,4383,4288,4318,4330,-70,-58,474646,2055225.09,289954
1782,a1109,20101129,4318,4330,4305,4333,4256,4332,4292,2,-38,336578,1444816.69,262524
1783,a1109,20101130,4332,4292,4315,4325,4266,4304,4296,12,4,214764,922776.93,249054
1784,a1109,20101201,4304,4296,4300,4332,4285,4330,4314,34,18,189216,816384.28,248152
1785,a1109,20101202,4330,4314,4389,4408,4370,4383,4388,69,74,215522,945777.78,254700
1786,a1109,20101203,4383,4388,4380,4428,4367,4407,4401,19,13,228554,1005921.24,257240
1787,a1109,20101206,4407,4401,4430,4440,4402,4414,4424,13,23,176942,782837.95,249094
1788,a1109,20101207,4414,4424,4403,4423,4385,4420,4404,-4,-20,133446,587827.76,244032
1789,a1109,20101208,4420,4404,4360,4389,4335,4336,4368,-68,-36,137824,602024.08,239598
1790,a1109,20101209,4336,4368,4378,4384,4350,4359,4367,-9,-1,126906,554323.18,230796
1791,a1109,20101210,4359,4367,4345,4365,4336,4364,4349,-3,-18,84424,367180.79,226338
1792,a1109,20101213,4364,4349,4339,4415,4333,4399,4391,50,42,195650,859194.11,219626
1793,a1109,20101214,4399,4391,4420,4444,4409,4430,4425,39,34,234224,1036572,215474
1794,a1109,20101215,4430,4425,4425,4459,4397,4399,4430,-26,5,245992,1089828.62,220104
1795,a1109,20101216,4399,4430,4405,4425,4400,4408,4414,-22,-16,134128,592092.14,219748
1796,a1109,20101217,4408,4414,4409,4425,4405,4414,4416,0,2,113218,500054.29,210978
1797,a1109,20101220,4414,4416,4450,4459,4382,4414,4432,-2,16,148638,658869.01,206786
1798,a1109,20101221,4414,4432,4429,4451,4416,4447,4436,15,4,142522,632264.34,223532
1799,a1109,20101222,4447,4436,4460,4463,4412,4414,4435,-22,-1,139922,620623.6,221128
1800,a1109,20101223,4414,4435,4427,4452,4416,4452,4437,17,2,181946,807425.61,204246
1801,a1109,20101224,4452,4437,4470,4550,4465,4536,4521,99,84,401108,1813803.6,230372
1802,a1109,20101227,4536,4521,4511,4560,4510,4554,4542,33,21,318200,1445488.14,229940
1803,a1109,20101228,4554,4542,4590,4625,4572,4581,4600,39,58,302054,1389470.38,236576
1804,a1109,20101229,4581,4600,4575,4588,4506,4519,4538,-81,-62,235104,1066987.89,229750
1805,a1109,20101230,4519,4538,4506,4549,4491,4546,4521,8,-17,164628,744351.79,217914
1806,a1109,20101231,4546,4521,4523,4547,4517,4528,4531,7,10,129558,587073.66,207086
1807,a1111,20100518,,3979,0,0,0,3979,3979,0,0,0,0,0
1808,a1111,20100519,3979,3979,0,0,0,3979,3979,0,0,0,0,0
1809,a1111,20100520,3979,3979,0,0,0,3979,3979,0,0,0,0,0
1810,a1111,20100521,3979,3979,3932,4023,3932,4023,3977,44,-2,4,15.91,0
1811,a1111,20100524,4023,3977,4008,4008,4007,4007,4007,30,30,4,16.03,4
1812,a1111,20100525,4007,4007,0,0,0,4007,4007,0,0,0,0,4
1813,a1111,20100526,4007,4007,4010,4010,3962,3980,3979,-27,-28,22,87.55,12
1814,a1111,20100527,3980,3979,0,0,0,3979,3979,0,0,0,0,12
1815,a1111,20100528,3979,3979,0,0,0,3979,3979,0,0,0,0,12
1816,a1111,20100531,3979,3979,3951,3951,3900,3900,3923,-79,-56,40,156.94,42
1817,a1111,20100601,3900,3923,3913,3913,3877,3888,3890,-35,-33,12,46.69,52
1818,a1111,20100602,3888,3890,3890,3902,3888,3899,3896,9,6,12,46.75,46
1819,a1111,20100603,3899,3896,3892,3892,3892,3892,3892,-4,-4,2,7.78,46
1820,a1111,20100604,3892,3892,3928,3928,3900,3904,3910,12,18,20,78.22,46
1821,a1111,20100607,3904,3910,3860,3860,3859,3859,3859,-51,-51,4,15.44,44
1822,a1111,20100608,3859,3859,3885,3885,3885,3885,3885,26,26,2,7.77,46
1823,a1111,20100609,3885,3885,3855,3875,3850,3858,3859,-27,-26,16,61.75,52
1824,a1111,20100610,3858,3859,0,0,0,3859,3859,0,0,0,0,52
1825,a1111,20100611,3859,3859,3861,3872,3857,3857,3870,-2,11,258,998.67,304
1826,a1111,20100617,3857,3870,3986,3986,3865,3865,3867,-5,-3,320,1237.53,606
1827,a1111,20100618,3865,3867,3870,3892,3870,3874,3874,7,7,12,46.49,614
1828,a1111,20100621,3874,3874,3909,3929,3903,3919,3910,45,36,566,2213.51,1148
1829,a1111,20100622,3919,3910,3915,3915,3897,3906,3906,-4,-4,268,1046.81,1408
1830,a1111,20100623,3906,3906,3900,3900,3890,3890,3896,-16,-10,6,23.38,1410
1831,a1111,20100624,3890,3896,3901,3901,3895,3896,3896,0,0,148,576.62,1550
1832,a1111,20100625,3896,3896,0,0,0,3896,3896,0,0,0,0,1550
1833,a1111,20100628,3896,3896,3879,3879,3879,3879,3879,-17,-17,2,7.76,1548
1834,a1111,20100629,3879,3879,3851,3851,3851,3851,3851,-28,-28,2,7.7,1550
1835,a1111,20100630,3851,3851,3841,3842,3841,3842,3841,-9,-10,4,15.37,1554
1836,a1111,20100701,3842,3841,3842,3842,3842,3842,3842,1,1,4,15.37,1556
1837,a1111,20100702,3842,3842,0,0,0,3842,3842,0,0,0,0,1556
1838,a1111,20100705,3842,3842,3847,3847,3847,3847,3847,5,5,2,7.69,1558
1839,a1111,20100706,3847,3847,3835,3835,3835,3835,3835,-12,-12,4,15.34,1560
1840,a1111,20100707,3835,3835,3842,3842,3842,3842,3842,7,7,4,15.37,1562
1841,a1111,20100708,3842,3842,3870,3882,3870,3870,3875,28,33,22,85.26,1574
1842,a1111,20100709,3870,3875,3885,3890,3881,3890,3887,15,12,18,69.98,1570
1843,a1111,20100712,3890,3887,3897,3899,3880,3880,3887,-7,0,14,54.42,1570
1844,a1111,20100713,3880,3887,3887,3887,3870,3870,3875,-17,-12,6,23.25,1574
1845,a1111,20100714,3870,3875,3875,3875,3875,3875,3875,0,0,60,232.5,1514
1846,a1111,20100715,3875,3875,3899,3900,3879,3881,3895,6,20,22,85.7,1512
1847,a1111,20100716,3881,3895,3920,3939,3920,3938,3932,43,37,20,78.65,1512
1848,a1111,20100719,3938,3932,3972,3972,3936,3960,3955,28,23,52,205.69,1554
1849,a1111,20100720,3960,3955,3965,3965,3948,3960,3957,5,2,6,23.75,1550
1850,a1111,20100721,3960,3957,3971,3971,3971,3971,3971,14,14,2,7.94,1552
1851,a1111,20100722,3971,3971,0,0,0,3971,3971,0,0,0,0,1552
1852,a1111,20100723,3971,3971,3969,3972,3969,3970,3970,-1,-1,14,55.58,1564
1853,a1111,20100726,3970,3970,3989,3989,3965,3965,3980,-5,10,14,55.73,1570
1854,a1111,20100727,3965,3980,3950,3950,3915,3920,3930,-60,-50,40,157.23,1590
1855,a1111,20100728,3920,3930,3931,3931,3930,3930,3930,0,0,26,102.18,1590
1856,a1111,20100729,3930,3930,3950,3956,3945,3952,3947,22,17,6066,23944.47,1168
1857,a1111,20100730,3952,3947,3977,3980,3952,3975,3970,28,23,2430,9648.73,1152
1858,a1111,20100802,3975,3970,4001,4052,4001,4046,4042,76,72,16,64.68,1144
1859,a1111,20100803,4046,4042,4015,4015,4015,4015,4015,-27,-27,6,24.09,1138
1860,a1111,20100804,4015,4015,0,0,0,4015,4015,0,0,0,0,1138
1861,a1111,20100805,4015,4015,4049,4049,3990,3995,4019,-20,4,20,80.38,1138
1862,a1111,20100806,3995,4019,4018,4018,3980,4000,3990,-19,-29,40,159.6,1152
1863,a1111,20100809,4000,3990,4051,4051,4051,4051,4051,61,61,2,8.1,1150
1864,a1111,20100810,4051,4051,4020,4034,4020,4034,4024,-17,-27,8,32.19,1152
1865,a1111,20100811,4034,4024,4016,4020,4016,4020,4019,-4,-5,8,32.15,1144
1866,a1111,20100812,4020,4019,4023,4023,4023,4023,4023,4,4,2,8.05,1144
1867,a1111,20100813,4023,4023,4055,4101,4055,4101,4068,78,45,32,130.2,1152
1868,a1111,20100816,4101,4068,4106,4187,4106,4165,4168,97,100,146,608.61,1044
1869,a1111,20100817,4165,4168,4152,4152,4152,4152,4152,-16,-16,2,8.3,1044
1870,a1111,20100818,4152,4152,4145,4149,4137,4137,4146,-15,-6,22,91.22,1056
1871,a1111,20100819,4137,4146,4068,4149,4068,4149,4108,3,-38,4,16.43,1056
1872,a1111,20100820,4149,4108,4070,4070,4070,4070,4070,-38,-38,6,24.42,1056
1873,a1111,20100823,4070,4070,4045,4046,4045,4046,4045,-24,-25,16,64.73,1050
1874,a1111,20100824,4046,4045,4023,4023,4023,4023,4023,-22,-22,2,8.05,1052
1875,a1111,20100825,4023,4023,4012,4031,3995,4014,4015,-9,-8,60,240.91,1050
1876,a1111,20100826,4014,4015,4039,4039,4007,4031,4020,16,5,46,184.95,1010
1877,a1111,20100827,4031,4020,4019,4050,4019,4050,4039,30,19,6,24.23,1008
1878,a1111,20100830,4050,4039,4098,4098,4098,4098,4098,59,59,2,8.2,1010
1879,a1111,20100831,4098,4098,4017,4050,4017,4020,4028,-78,-70,12,48.34,1008
1880,a1111,20100901,4020,4028,4023,4027,4011,4023,4020,-5,-8,32,128.64,1008
1881,a1111,20100902,4023,4020,4021,4021,4021,4021,4021,1,1,2,8.04,1010
1882,a1111,20100903,4021,4021,4041,4080,4041,4080,4063,59,42,18,73.14,1010
1883,a1111,20100906,4080,4063,4100,4126,4100,4122,4115,59,52,10,41.16,1006
1884,a1111,20100907,4122,4115,4114,4114,4114,4114,4114,-1,-1,2,8.23,1004
1885,a1111,20100908,4114,4114,4130,4137,4125,4126,4130,12,16,22,90.88,992
1886,a1111,20100909,4126,4130,4027,4064,4027,4064,4034,-66,-96,10,40.34,998
1887,a1111,20100910,4064,4034,4074,4075,4074,4075,4074,41,40,8,32.6,1000
1888,a1111,20100913,4075,4074,0,0,0,4074,4074,0,0,0,0,1000
1889,a1111,20100914,4074,4074,4071,4071,4071,4071,4071,-3,-3,2,8.14,1000
1890,a1111,20100915,4071,4071,0,0,0,4071,4071,0,0,0,0,1000
1891,a1111,20100916,4071,4071,4100,4100,4100,4100,4100,29,29,200,820,800
1892,a1111,20100917,4100,4100,4144,4144,4144,4144,4144,44,44,4,16.58,804
1893,a1111,20100920,4144,4144,4207,4250,4205,4225,4236,81,92,90,381.28,738
1894,a1111,20100921,4225,4236,4180,4218,4157,4209,4180,-27,-56,418,1747.52,340
1895,a1111,20100927,4209,4180,4239,4239,4212,4212,4228,32,48,6,25.37,338
1896,a1111,20100928,4212,4228,4203,4248,4200,4213,4208,-15,-20,18,75.75,326
1897,a1111,20100929,4213,4208,4179,4179,4160,4160,4169,-48,-39,4,16.68,326
1898,a1111,20100930,4160,4169,0,0,0,4169,4169,0,0,0,0,326
1899,a1111,20101008,4169,4169,0,0,0,4169,4169,0,0,0,0,326
1900,a1111,20101011,4169,4169,4335,4335,4335,4335,4335,166,166,18,78.03,336
1901,a1111,20101012,4335,4335,4281,4355,4281,4331,4318,-4,-17,58,250.48,354
1902,a1111,20101013,4331,4318,4355,4355,4355,4355,4355,37,37,20,87.1,354
1903,a1111,20101014,4355,4355,4389,4402,4375,4375,4389,20,34,28,122.91,350
1904,a1111,20101015,4375,4389,4398,4409,4398,4409,4399,20,10,120,527.98,434
1905,a1111,20101018,4409,4399,0,0,0,4399,4399,0,0,0,0,434
1906,a1111,20101019,4399,4399,4396,4396,4379,4379,4395,-20,-4,422,1855.08,850
1907,a1111,20101020,4379,4395,4352,4352,4352,4352,4352,-43,-43,2,8.7,850
1908,a1111,20101021,4352,4352,4433,4520,4420,4420,4472,68,120,32,143.11,850
1909,a1111,20101022,4420,4472,4447,4490,4432,4433,4458,-39,-14,12,53.5,854
1910,a1111,20101025,4433,4458,4516,4568,4516,4549,4558,91,100,406,1850.63,1044
1911,a1111,20101026,4549,4558,4510,4529,4510,4529,4516,-29,-42,16,72.26,1058
1912,a1111,20101027,4529,4516,4433,4439,4433,4438,4435,-78,-81,18,79.83,1054
1913,a1111,20101028,4438,4435,4454,4454,4454,4454,4454,19,19,300,1336.2,1354
1914,a1111,20101029,4454,4454,4403,4443,4371,4371,4401,-83,-53,22,96.82,1360
1915,a1111,20101101,4371,4401,4458,4500,4458,4500,4472,99,71,12,53.66,1350
1916,a1111,20101102,4500,4472,4508,4508,4461,4495,4479,23,7,16,71.67,1352
1917,a1111,20101103,4495,4479,4497,4497,4460,4460,4496,-19,17,402,1807.72,952
1918,a1111,20101104,4460,4496,4405,4550,4405,4517,4495,21,-1,14,62.94,950
1919,a1111,20101105,4517,4495,4669,4674,4633,4669,4645,174,150,76,353.07,888
1920,a1111,20101108,4669,4645,4671,4703,4671,4683,4679,38,34,68,318.22,828
1921,a1111,20101109,4683,4679,4728,4729,4651,4692,4706,13,27,34,160.01,822
1922,a1111,20101110,4692,4706,4828,4869,4781,4781,4819,75,113,8,38.56,822
1923,a1111,20101111,4781,4819,0,0,0,4819,4819,0,0,0,0,822
1924,a1111,20101112,4819,4819,4780,4794,4627,4627,4704,-192,-115,88,413.96,818
1925,a1111,20101115,4627,4704,4570,4588,4516,4588,4530,-116,-174,32,144.97,822
1926,a1111,20101116,4588,4530,4507,4507,4460,4460,4489,-70,-41,24,107.74,832
1927,a1111,20101117,4460,4489,4355,4355,4310,4310,4312,-179,-177,36,155.25,846
1928,a1111,20101118,4310,4312,4308,4413,4291,4307,4342,-5,30,118,512.38,838
1929,a1111,20101119,4307,4342,4305,4400,4240,4360,4341,18,-1,680,2952.18,280
1930,a1111,20101122,4360,4341,4292,4292,4292,4292,4292,-49,-49,2,8.58,282
1931,a1111,20101123,4292,4292,4295,4349,4280,4327,4310,35,18,94,405.14,240
1932,a1111,20101124,4327,4310,4370,4449,4346,4378,4402,68,92,108,475.45,240
1933,a1111,20101125,4378,4402,4376,4383,4355,4355,4371,-47,-31,24,104.91,244
1934,a1111,20101126,4355,4371,4336,4336,4285,4309,4329,-62,-42,128,554.12,250
1935,a1111,20101129,4309,4329,4263,4318,4260,4310,4287,-19,-42,28,120.05,252
1936,a1111,20101130,4310,4287,4315,4315,4245,4275,4276,-12,-11,108,461.83,296
1937,a1111,20101201,4275,4276,4256,4310,4256,4305,4294,29,18,84,360.77,284
1938,a1111,20101202,4305,4294,4330,4375,4330,4369,4362,75,68,58,253.04,260
1939,a1111,20101203,4369,4362,4378,4395,4378,4394,4387,32,25,58,254.46,266
1940,a1111,20101206,4394,4387,4400,4407,4393,4393,4402,6,15,10,44.02,266
1941,a1111,20101207,4393,4402,4389,4400,4368,4384,4384,-18,-18,16,70.15,266
1942,a1111,20101208,4384,4384,4370,4379,4303,4303,4346,-81,-38,56,243.39,274
1943,a1111,20101209,4303,4346,4359,4361,4335,4335,4352,-11,6,64,278.58,288
1944,a1111,20101210,4335,4352,4329,4340,4329,4339,4336,-13,-16,18,78.05,280
1945,a1111,20101213,4339,4336,4372,4399,4369,4384,4372,48,36,550,2405.14,780
1946,a1111,20101214,4384,4372,4422,4422,4395,4396,4421,24,49,508,2246.17,278
1947,a1111,20101215,4396,4421,4437,4438,4400,4400,4433,-21,12,150,665.02,280
1948,a1111,20101216,4400,4433,4410,4413,4400,4406,4407,-27,-26,36,158.65,282
1949,a1111,20101217,4406,4407,4402,4429,4402,4429,4409,22,2,8,35.27,280
1950,a1111,20101220,4429,4409,4519,4519,4390,4390,4437,-19,28,8,35.5,280
1951,a1111,20101221,4390,4437,4520,4520,4393,4441,4443,4,6,50,222.15,278
1952,a1111,20101222,4441,4443,4428,4428,4428,4428,4428,-15,-15,2,8.86,278
1953,a1111,20101223,4428,4428,4471,4500,4420,4452,4463,24,35,36,160.69,290
1954,a1111,20101224,4452,4463,4499,4530,4499,4530,4519,67,56,40,180.79,254
1955,a1111,20101227,4530,4519,4555,4572,4545,4572,4557,53,38,26,118.5,268
1956,a1111,20101228,4572,4557,4595,4618,4572,4575,4590,18,33,24,110.17,260
1957,a1111,20101229,4575,4590,4530,4588,4482,4506,4520,-84,-70,78,352.56,232
1958,a1111,20101230,4506,4520,4490,4501,4490,4500,4495,-20,-25,22,98.91,242
1959,a1111,20101231,4500,4495,4503,4533,4503,4530,4521,35,26,30,135.65,240
1960,a1201,20100715,,3870,3930,3935,3911,3920,3925,50,55,20,78.5,18
1961,a1201,20100716,3920,3925,3922,3963,3922,3961,3953,36,28,18,71.16,28
1962,a1201,20100719,3961,3953,3951,4015,3950,3974,3973,21,20,18,71.52,36
1963,a1201,20100720,3974,3973,3975,4000,3956,3992,3980,19,7,14,55.73,42
1964,a1201,20100721,3992,3980,3998,3998,3972,3972,3982,-8,2,32,127.45,66
1965,a1201,20100722,3972,3982,3982,3982,3955,3970,3965,-12,-17,50,198.29,86
1966,a1201,20100723,3970,3965,3973,3999,3973,3977,3979,12,14,20,79.6,88
1967,a1201,20100726,3977,3979,3981,3990,3981,3984,3985,5,6,32,127.53,96
1968,a1201,20100727,3984,3985,3969,3969,3945,3946,3955,-39,-30,82,324.34,120
1969,a1201,20100728,3946,3955,3954,3960,3934,3960,3952,5,-3,24,94.86,120
1970,a1201,20100729,3960,3952,4000,4000,3960,3974,3976,22,24,72,286.32,150
1971,a1201,20100730,3974,3976,3996,4000,3990,3992,3997,16,21,96,383.78,178
1972,a1201,20100802,3992,3997,4030,4068,4030,4062,4057,65,60,48,194.78,174
1973,a1201,20100803,4062,4057,4035,4044,4010,4010,4031,-47,-26,102,411.18,166
1974,a1201,20100804,4010,4031,4049,4049,4025,4026,4038,-5,7,74,298.83,144
1975,a1201,20100805,4026,4038,4040,4042,3990,3990,4015,-48,-23,96,385.46,160
1976,a1201,20100806,3990,4015,3991,4012,3960,4011,3989,-4,-26,48,191.51,176
1977,a1201,20100809,4011,3989,4012,4080,4003,4070,4061,81,72,88,357.43,180
1978,a1201,20100810,4070,4061,4046,4046,4025,4033,4035,-28,-26,74,298.62,198
1979,a1201,20100811,4033,4035,4011,4041,4011,4020,4029,-15,-6,14,56.41,200
1980,a1201,20100812,4020,4029,4018,4057,4018,4041,4038,12,9,62,250.38,224
1981,a1201,20100813,4041,4038,4060,4103,4060,4103,4081,65,43,34,138.77,222
1982,a1201,20100816,4103,4081,4116,4177,4116,4166,4164,85,83,86,358.15,252
1983,a1201,20100817,4166,4164,4188,4188,4132,4158,4157,-6,-7,1836,7633.88,2056
1984,a1201,20100818,4158,4157,4175,4188,4108,4134,4161,-23,4,152,632.58,2122
1985,a1201,20100819,4134,4161,4131,4131,4093,4110,4111,-51,-50,98,402.88,2136
1986,a1201,20100820,4110,4111,4070,4076,4038,4051,4057,-60,-54,232,941.43,2154
1987,a1201,20100823,4051,4057,4061,4067,4045,4050,4056,-7,-1,90,365.09,2174
1988,a1201,20100824,4050,4056,4030,4049,4028,4028,4036,-28,-20,184,742.67,2178
1989,a1201,20100825,4028,4036,4038,4043,4011,4015,4028,-21,-8,88,354.54,2198
1990,a1201,20100826,4015,4028,4037,4038,4024,4038,4030,10,2,82,330.5,2214
1991,a1201,20100827,4038,4030,4047,4065,4035,4052,4054,22,24,84,340.58,2238
1992,a1201,20100830,4052,4054,4071,4104,4071,4083,4091,29,37,116,474.61,2252
1993,a1201,20100831,4083,4091,4060,4060,4031,4042,4044,-49,-47,2022,8178.08,554
1994,a1201,20100901,4042,4044,4042,4059,4026,4042,4041,-2,-3,44,177.81,566
1995,a1201,20100902,4042,4041,4045,4060,4039,4051,4048,10,7,52,210.54,568
1996,a1201,20100903,4051,4048,4031,4087,4031,4083,4064,35,16,112,455.21,568
1997,a1201,20100906,4083,4064,4115,4140,4115,4126,4125,62,61,98,404.25,576
1998,a1201,20100907,4126,4125,4155,4155,4111,4144,4129,19,4,112,462.46,596
1999,a1201,20100908,4144,4129,4161,4168,4132,4141,4149,12,20,130,539.44,624
2000,a1201,20100909,4141,4149,4141,4141,4071,4093,4097,-56,-52,276,1130.88,724
2001,a1201,20100910,4093,4097,4117,4117,4085,4111,4104,14,7,64,262.67,760
2002,a1201,20100913,4111,4104,4088,4105,4088,4100,4100,-4,-4,110,451.05,786
2003,a1201,20100914,4100,4100,4090,4100,4080,4086,4086,-14,-14,488,1994.4,1208
2004,a1201,20100915,4086,4086,4092,4129,4088,4121,4119,35,33,352,1450.07,1204
2005,a1201,20100916,4121,4119,4129,4150,4114,4135,4135,16,16,668,2762.18,1194
2006,a1201,20100917,4135,4135,4144,4162,4140,4160,4151,25,16,90,373.65,1216
2007,a1201,20100920,4160,4151,4228,4285,4175,4225,4225,74,74,1648,6964.01,1910
2008,a1201,20100921,4225,4225,4200,4209,4171,4191,4187,-34,-38,590,2470.86,1590
2009,a1201,20100927,4191,4187,4285,4300,4232,4235,4259,48,72,296,1260.96,1570
2010,a1201,20100928,4235,4259,4225,4245,4199,4232,4204,-27,-55,1434,6028.85,2408
2011,a1201,20100929,4232,4204,4182,4198,4153,4171,4176,-33,-28,366,1528.5,2418
2012,a1201,20100930,4171,4176,4175,4175,4155,4165,4166,-11,-10,230,958.41,2402
2013,a1201,20101008,4165,4166,4132,4174,4121,4150,4158,-16,-8,194,806.69,2430
2014,a1201,20101011,4150,4158,4324,4324,4324,4324,4324,166,166,60,259.44,2436
2015,a1201,20101012,4324,4324,4302,4373,4282,4370,4349,46,25,1320,5741.37,1932
2016,a1201,20101013,4370,4349,4431,4431,4369,4395,4383,46,34,450,1972.55,1996
2017,a1201,20101014,4395,4383,4392,4415,4388,4405,4401,22,18,228,1003.55,1956
2018,a1201,20101015,4405,4401,4429,4439,4369,4439,4411,38,10,368,1623.35,1996
2019,a1201,20101018,4439,4411,4393,4406,4355,4370,4377,-41,-34,796,3484.7,2268
2020,a1201,20101019,4370,4377,4377,4404,4377,4391,4392,14,15,284,1247.37,2250
2021,a1201,20101020,4391,4392,4355,4417,4341,4408,4382,16,-10,1648,7222.24,2374
2022,a1201,20101021,4408,4382,4459,4523,4459,4471,4489,89,107,1118,5019.13,2628
2023,a1201,20101022,4471,4489,4488,4516,4478,4502,4498,13,9,604,2717.18,2912
2024,a1201,20101025,4502,4498,4550,4605,4539,4589,4570,91,72,1238,5658.86,3306
2025,a1201,20101026,4589,4570,4610,4610,4535,4550,4550,-20,-20,2344,10667.01,5012
2026,a1201,20101027,4550,4550,4579,4610,4420,4459,4510,-91,-40,1974,8904.46,5988
2027,a1201,20101028,4459,4510,4475,4508,4470,4499,4490,-11,-20,1014,4553.22,6436
2028,a1201,20101029,4499,4490,4477,4483,4420,4434,4447,-56,-43,666,2962.03,6612
2029,a1201,20101101,4434,4447,4449,4547,4449,4532,4525,85,78,1688,7638.48,7232
2030,a1201,20101102,4532,4525,4532,4532,4489,4489,4505,-36,-20,3414,15380.87,9048
2031,a1201,20101103,4489,4505,4499,4516,4471,4479,4502,-26,-3,2332,10500.72,9896
2032,a1201,20101104,4479,4502,4500,4556,4500,4556,4528,54,26,2416,10940.5,9540
2033,a1201,20101105,4556,4528,4608,4709,4608,4709,4690,181,162,2212,10376.32,10554
2034,a1201,20101108,4709,4690,4648,4761,4648,4701,4705,11,15,4534,21336.25,12714
2035,a1201,20101109,4701,4705,4690,4761,4677,4745,4708,40,3,5704,26858.48,15994
2036,a1201,20101110,4745,4708,4781,4892,4781,4809,4832,101,124,4340,20974.03,16772
2037,a1201,20101111,4809,4832,4800,4884,4781,4839,4842,7,10,3226,15623.38,17254
2038,a1201,20101112,4839,4842,4859,4859,4649,4649,4692,-193,-150,3354,15738.27,17434
2039,a1201,20101115,4649,4692,4580,4698,4505,4571,4594,-121,-98,14870,68315.93,24140
2040,a1201,20101116,4571,4594,4595,4600,4421,4428,4504,-166,-90,29778,134124.82,43294
2041,a1201,20101117,4428,4504,4324,4326,4324,4324,4324,-180,-180,11208,48463.44,43646
2042,a1201,20101118,4324,4324,4350,4362,4230,4301,4303,-23,-21,15002,64558.48,48206
2043,a1201,20101119,4301,4303,4355,4358,4268,4320,4312,17,9,12662,54599.25,51358
2044,a1201,20101122,4320,4312,4290,4315,4240,4277,4287,-35,-25,9600,41161.57,53352
2045,a1201,20101123,4277,4287,4308,4338,4275,4315,4313,28,26,13120,56587.76,55386
2046,a1201,20101124,4315,4313,4340,4375,4330,4362,4359,49,46,9408,41012.19,55604
2047,a1201,20101125,4362,4359,4370,4375,4327,4327,4353,-32,-6,28988,126190.7,70228
2048,a1201,20101126,4327,4353,4340,4342,4253,4284,4299,-69,-54,28894,124216.19,81844
2049,a1201,20101129,4284,4299,4278,4292,4221,4288,4254,-11,-45,30862,131306.13,88484
2050,a1201,20101130,4288,4254,4275,4275,4220,4261,4248,7,-6,16518,70175.59,88442
2051,a1201,20101201,4261,4248,4248,4285,4241,4280,4269,32,21,8336,35588.22,88748
2052,a1201,20101202,4280,4269,4340,4368,4325,4354,4344,85,75,22308,96926.75,85010
2053,a1201,20101203,4354,4344,4348,4384,4339,4370,4360,26,16,18936,82566.23,86246
2054,a1201,20101206,4370,4360,4396,4403,4352,4365,4377,5,17,28132,123161.52,93510
2055,a1201,20101207,4365,4377,4350,4372,4337,4371,4355,-6,-22,15646,68145.82,96214
2056,a1201,20101208,4371,4355,4330,4338,4290,4291,4320,-64,-35,18704,80802,96966
2057,a1201,20101209,4291,4320,4319,4399,4298,4310,4321,-10,1,21180,91533.43,101160
2058,a1201,20101210,4310,4321,4305,4312,4285,4311,4299,-10,-22,14280,61394.05,104200
2059,a1201,20101213,4311,4299,4297,4366,4280,4352,4339,53,40,25770,111834.88,106168
2060,a1201,20101214,4352,4339,4360,4391,4357,4380,4373,41,34,25262,110490.3,107638
2061,a1201,20101215,4380,4373,4378,4443,4371,4381,4403,8,30,43454,191364.13,109262
2062,a1201,20101216,4381,4403,4388,4418,4379,4405,4401,2,-2,37144,163471.18,114582
2063,a1201,20101217,4405,4401,4400,4414,4391,4402,4400,1,-1,30136,132613.65,124182
2064,a1201,20101220,4402,4400,4437,4450,4381,4405,4422,5,22,58312,257910.67,131714
2065,a1201,20101221,4405,4422,4420,4442,4406,4440,4426,18,4,31574,139770.04,130942
2066,a1201,20101222,4440,4426,4455,4458,4406,4411,4429,-15,3,42000,186048.1,141256
2067,a1201,20101223,4411,4429,4419,4488,4418,4483,4459,54,30,87062,388234.58,162534
2068,a1201,20101224,4483,4459,4502,4556,4494,4536,4526,77,67,111690,505597.99,162858
2069,a1201,20101227,4536,4526,4503,4563,4502,4544,4537,18,11,87046,394951.34,175686
2070,a1201,20101228,4544,4537,4580,4613,4541,4545,4573,8,36,130436,596488.31,207966
2071,a1201,20101229,4545,4573,4557,4557,4465,4481,4497,-92,-76,114096,513167.98,204486
2072,a1201,20101230,4481,4497,4472,4509,4456,4507,4486,10,-11,78320,351347,208218
2073,a1201,20101231,4507,4486,4486,4523,4474,4505,4502,19,16,78594,353850.11,211736
2074,a1203,20100915,,4057,0,0,0,4057,4057,0,0,0,0,0
2075,a1203,20100916,4057,4057,0,0,0,4057,4057,0,0,0,0,0
2076,a1203,20100917,4057,4057,0,0,0,4057,4057,0,0,0,0,0
2077,a1203,20100920,4057,4057,4355,4355,4355,4355,4355,298,298,2,8.71,2
2078,a1203,20100921,4355,4355,0,0,0,4355,4355,0,0,0,0,2
2079,a1203,20100927,4355,4355,4292,4292,4268,4268,4283,-87,-72,6,25.7,4
2080,a1203,20100928,4268,4283,0,0,0,4283,4283,0,0,0,0,4
2081,a1203,20100929,4283,4283,0,0,0,4283,4283,0,0,0,0,4
2082,a1203,20100930,4283,4283,0,0,0,4283,4283,0,0,0,0,4
2083,a1203,20101008,4283,4283,0,0,0,4283,4283,0,0,0,0,4
2084,a1203,20101011,4283,4283,4448,4454,4380,4451,4425,168,142,834,3690.72,554
2085,a1203,20101012,4451,4425,4432,4432,4315,4384,4359,-41,-66,440,1918.09,428
2086,a1203,20101013,4384,4359,4387,4416,4374,4405,4401,46,42,156,686.66,300
2087,a1203,20101014,4405,4401,4395,4420,4395,4411,4414,10,13,76,335.47,256
2088,a1203,20101015,4411,4414,4401,4430,4383,4420,4416,6,2,70,309.12,226
2089,a1203,20101018,4420,4416,4400,4400,4355,4382,4382,-34,-34,26,113.95,232
2090,a1203,20101019,4382,4382,4400,4402,4391,4402,4395,20,13,44,193.42,206
2091,a1203,20101020,4402,4395,4397,4420,4397,4410,4409,15,14,20,88.19,190
2092,a1203,20101021,4410,4409,4469,4532,4448,4480,4488,71,79,106,475.8,210
2093,a1203,20101022,4480,4488,4500,4510,4500,4500,4508,12,20,44,198.36,168
2094,a1203,20101025,4500,4508,4538,4615,4538,4615,4612,107,104,234,1079.38,388
2095,a1203,20101026,4615,4612,4562,4568,4555,4556,4563,-56,-49,36,164.3,402
2096,a1203,20101027,4556,4563,4570,4570,4485,4515,4540,-48,-23,66,299.7,406
2097,a1203,20101028,4515,4540,4462,4510,4462,4509,4502,-31,-38,14,63.03,398
2098,a1203,20101029,4509,4502,0,0,0,4502,4502,0,0,0,0,398
2099,a1203,20101101,4502,4502,4529,4555,4511,4555,4531,53,29,26,117.82,378
2100,a1203,20101102,4555,4531,4516,4516,4515,4515,4515,-16,-16,4,18.06,382
2101,a1203,20101103,4515,4515,4501,4501,4501,4501,4501,-14,-14,2,9,382
2102,a1203,20101104,4501,4501,4510,4586,4510,4586,4548,85,47,4,18.19,378
2103,a1203,20101105,4586,4548,4729,4729,4701,4729,4715,181,167,12,56.58,372
2104,a1203,20101108,4729,4715,4717,4717,4717,4717,4717,2,2,2,9.43,372
2105,a1203,20101109,4717,4717,4710,4766,4710,4748,4724,31,7,114,538.64,444
2106,a1203,20101110,4748,4724,4817,4884,4817,4843,4855,119,131,162,786.64,518
2107,a1203,20101111,4843,4855,4849,4906,4849,4866,4882,11,27,38,185.54,520
2108,a1203,20101112,4866,4882,4866,4866,4687,4687,4751,-195,-131,72,342.1,534
2109,a1203,20101115,4687,4751,4631,4671,4561,4566,4602,-185,-149,66,303.74,534
2110,a1203,20101116,4566,4602,4602,4656,4465,4465,4564,-137,-38,38,173.44,556
2111,a1203,20101117,4465,4564,4382,4382,4382,4382,4382,-182,-182,4,17.53,556
2112,a1203,20101118,4382,4382,4355,4355,4270,4350,4321,-32,-61,230,993.89,358
2113,a1203,20101119,4350,4321,4340,4385,4330,4369,4352,48,31,22,95.75,360
2114,a1203,20101122,4369,4352,4226,4350,4226,4320,4322,-32,-30,24,103.74,374
2115,a1203,20101123,4320,4322,4341,4355,4320,4345,4346,23,24,34,147.77,350
2116,a1203,20101124,4345,4346,4426,4427,4382,4390,4390,44,44,210,922.01,152
2117,a1203,20101125,4390,4390,4398,4398,4391,4391,4396,1,6,8,35.17,146
2118,a1203,20101126,4391,4396,4355,4355,4345,4345,4350,-51,-46,4,17.4,146
2119,a1203,20101129,4345,4350,4295,4320,4295,4318,4309,-32,-41,10,43.1,150
2120,a1203,20101130,4318,4309,4275,4327,4275,4327,4288,18,-21,24,102.91,140
2121,a1203,20101201,4327,4288,4336,4336,4336,4336,4336,48,48,4,17.34,140
2122,a1203,20101202,4336,4336,0,0,0,4336,4336,0,0,0,0,140
2123,a1203,20101203,4336,4336,4419,4419,4402,4410,4411,74,75,48,211.74,134
2124,a1203,20101206,4410,4411,4462,4462,4398,4398,4440,-13,29,6,26.64,132
2125,a1203,20101207,4398,4440,4386,4420,4386,4411,4403,-29,-37,160,704.58,132
2126,a1203,20101208,4411,4403,4379,4397,4350,4350,4374,-53,-29,26,113.74,130
2127,a1203,20101209,4350,4374,4476,4476,4338,4338,4386,-36,12,14,61.41,134
2128,a1203,20101210,4338,4386,4370,4375,4330,4375,4354,-11,-32,16,69.66,134
2129,a1203,20101213,4375,4354,4368,4447,4368,4408,4408,54,54,12,52.9,132
2130,a1203,20101214,4408,4408,4420,4420,4420,4420,4420,12,12,2,8.84,130
2131,a1203,20101215,4420,4420,4475,4475,4433,4433,4441,13,21,10,44.41,120
2132,a1203,20101216,4433,4441,4451,4452,4451,4452,4451,11,10,4,17.81,118
2133,a1203,20101217,4452,4451,4449,4449,4435,4435,4442,-16,-9,4,17.77,118
2134,a1203,20101220,4435,4442,0,0,0,4442,4442,0,0,0,0,118
2135,a1203,20101221,4442,4442,4442,4479,4441,4479,4459,37,17,50,222.97,116
2136,a1203,20101222,4479,4459,0,0,0,4459,4459,0,0,0,0,116
2137,a1203,20101223,4459,4459,4466,4530,4466,4530,4501,71,42,22,99.03,116
2138,a1203,20101224,4530,4501,4578,4578,4565,4565,4571,64,70,4,18.29,116
2139,a1203,20101227,4565,4571,0,0,0,4571,4571,0,0,0,0,116
2140,a1203,20101228,4571,4571,4571,4571,4571,4571,4571,0,0,4,18.28,118
2141,a1203,20101229,4571,4571,4543,4543,4525,4525,4537,-46,-34,6,27.22,116
2142,a1203,20101230,4525,4537,0,0,0,4537,4537,0,0,0,0,116
2143,a1203,20101231,4537,4537,0,0,0,4537,4537,0,0,0,0,116
2144,a1205,20101115,,4649,4671,4822,4620,4670,4674,21,25,26,121.54,18
2145,a1205,20101116,4670,4674,4649,4649,4490,4499,4537,-175,-137,124,562.65,136
2146,a1205,20101117,4499,4537,4360,4382,4356,4356,4357,-181,-180,198,862.85,254
2147,a1205,20101118,4356,4357,4370,4436,4303,4361,4373,4,16,216,944.67,258
2148,a1205,20101119,4361,4373,4455,4455,4351,4399,4396,26,23,190,835.3,336
2149,a1205,20101122,4399,4396,4320,4399,4320,4370,4370,-26,-26,142,620.68,356
2150,a1205,20101123,4370,4370,4397,4498,4366,4414,4427,44,57,304,1345.95,454
2151,a1205,20101124,4414,4427,4478,4487,4430,4470,4465,43,38,118,526.96,476
2152,a1205,20101125,4470,4465,4486,4517,4458,4458,4484,-7,19,352,1578.38,602
2153,a1205,20101126,4458,4484,4478,4478,4381,4399,4409,-85,-75,260,1146.47,544
2154,a1205,20101129,4399,4409,4361,4419,4360,4406,4383,-3,-26,86,377,574
2155,a1205,20101130,4406,4383,4372,4397,4351,4385,4369,2,-14,106,463.2,574
2156,a1205,20101201,4385,4369,4420,4420,4361,4401,4402,32,33,174,766.02,628
2157,a1205,20101202,4401,4402,4436,4485,4436,4472,4464,70,62,282,1259,654
2158,a1205,20101203,4472,4464,4478,4503,4473,4482,4483,18,19,60,269.02,670
2159,a1205,20101206,4482,4483,4499,4525,4481,4490,4499,7,16,74,332.96,658
2160,a1205,20101207,4490,4499,4470,4573,4464,4480,4500,-19,1,22,99,662
2161,a1205,20101208,4480,4500,4432,4466,4420,4420,4443,-80,-57,138,613.26,696
2162,a1205,20101209,4420,4443,4457,4463,4425,4437,4448,-6,5,42,186.82,676
2163,a1205,20101210,4437,4448,4437,4494,4415,4434,4429,-14,-19,74,327.8,690
2164,a1205,20101213,4434,4429,4443,4494,4440,4485,4472,56,43,110,491.97,670
2165,a1205,20101214,4485,4472,4491,4510,4483,4504,4498,32,26,116,521.78,642
2166,a1205,20101215,4504,4498,4488,4551,4488,4496,4517,-2,19,138,623.37,642
2167,a1205,20101216,4496,4517,4518,4527,4515,4525,4524,8,7,72,325.76,648
2168,a1205,20101217,4525,4524,4525,4567,4505,4515,4528,-9,4,148,670.2,654
2169,a1205,20101220,4515,4528,4568,4568,4522,4527,4531,-1,3,296,1341.2,600
2170,a1205,20101221,4527,4531,4550,4561,4533,4561,4546,30,15,264,1200.35,398
2171,a1205,20101222,4561,4546,4552,4563,4520,4520,4539,-26,-7,42,190.68,392
2172,a1205,20101223,4520,4539,4549,4595,4541,4595,4575,56,36,74,338.61,390
2173,a1205,20101224,4595,4575,4606,4680,4603,4656,4640,81,65,80,371.25,370
2174,a1205,20101227,4656,4640,4660,4668,4628,4636,4654,-4,14,188,874.98,408
2175,a1205,20101228,4636,4654,4669,4703,4660,4670,4680,16,26,36,168.51,424
2176,a1205,20101229,4670,4680,4632,4648,4585,4600,4600,-80,-80,64,294.45,452
2177,a1205,20101230,4600,4600,4590,4613,4585,4611,4597,11,-3,70,321.84,466
2178,a1205,20101231,4611,4597,4600,4638,4600,4628,4619,31,22,48,221.73,460
1,a1101,20110104,4050,4040,3993,4120,3993,4120,4020,80,-20,106,4261700,148
2,a1101,20110105,4120,4020,4018,4018,4018,4018,4018,-2,-2,4,160720,148
3,a1101,20110106,4018,4018,4015,4015,4015,4015,4015,-3,-3,6,240900,146
4,a1101,20110107,4015,4015,4020,4020,4015,4015,4017,0,2,12,482100,158
5,a1101,20110110,4015,4017,4020,4020,4001,4001,4016,-16,-1,18,722920,54
6,a1101,20110111,4001,4016,0,0,0,4016,4016,0,0,0,0,54
7,a1101,20110112,4016,4016,3950,4000,3950,4000,3985,-16,-31,50,1992900,54
8,a1101,20110113,4000,3985,0,0,0,3985,3985,0,0,0,0,54
9,a1101,20110114,3985,3985,0,0,0,3985,3985,0,0,0,0,54
10,a1101,20110117,3985,3985,0,0,0,3985,4010,0,25,0,0,0
11,a1103,20110104,4129,4117,4110,4135,4110,4128,4123,11,6,10,412380,216
12,a1103,20110105,4128,4123,4122,4122,4085,4091,4101,-32,-22,36,1476420,210
13,a1103,20110106,4091,4101,4091,4091,4091,4091,4091,-10,-10,2,81820,210
14,a1103,20110107,4091,4091,4065,4095,4048,4048,4071,-43,-20,32,1302820,198
15,a1103,20110110,4048,4071,4051,4074,4051,4064,4066,-7,-5,26,1057180,180
16,a1103,20110111,4064,4066,4057,4060,4050,4050,4054,-16,-12,8,324340,180
17,a1103,20110112,4050,4054,4050,4070,4050,4070,4065,16,11,28,1138200,154
18,a1103,20110113,4070,4065,4095,4099,4045,4081,4082,16,17,28,1143140,152
19,a1103,20110114,4081,4082,4055,4088,4049,4085,4068,3,-14,22,895000,148
20,a1103,20110117,4085,4068,4093,4100,4093,4095,4097,27,29,24,983320,154
21,a1103,20110118,4095,4097,4051,4130,4051,4085,4088,-12,-9,6,245320,152
22,a1103,20110119,4085,4088,4090,4118,4090,4105,4109,17,21,16,657460,154
23,a1103,20110120,4105,4109,4080,4108,4080,4108,4095,-1,-14,16,655200,154
24,a1103,20110121,4108,4095,4070,4145,4070,4144,4115,49,20,60,2469400,160
25,a1103,20110124,4144,4115,4148,4179,4102,4159,4158,44,43,36,1496880,156
26,a1103,20110125,4159,4158,4106,4189,4106,4130,4132,-28,-26,16,661140,156
27,a1103,20110126,4130,4132,4055,4125,4050,4068,4086,-64,-46,34,1389280,154
28,a1103,20110127,4068,4086,4056,4075,4050,4075,4062,-11,-24,44,1787380,152
29,a1103,20110128,4075,4062,4051,4051,4050,4050,4050,-12,-12,10,405020,152
30,a1103,20110131,4050,4050,4077,4077,4051,4062,4062,12,12,10,406200,152
31,a1103,20110201,4062,4062,4000,4069,4000,4037,4051,-25,-11,18,729200,152
32,a1103,20110209,4037,4051,4049,4049,4049,4049,4049,-2,-2,2,80980,152
33,a1103,20110210,4049,4049,4050,4139,4050,4110,4088,61,39,64,2616400,152
34,a1103,20110211,4110,4088,4100,4149,4075,4148,4111,60,23,28,1151220,156
35,a1103,20110214,4148,4111,4140,4150,4140,4150,4148,39,37,14,580760,154
36,a1103,20110215,4150,4148,0,0,0,4148,4148,0,0,0,0,154
37,a1103,20110216,4148,4148,4200,4200,4050,4130,4143,-18,-5,48,1989020,152
38,a1103,20110217,4130,4143,4139,4139,4060,4060,4093,-83,-50,20,818660,152
39,a1103,20110218,4060,4093,4139,4140,4073,4135,4115,42,22,124,5102800,194
40,a1103,20110221,4135,4115,4148,4256,4148,4193,4178,78,63,172,7187300,226
41,a1103,20110222,4193,4178,4185,4280,4081,4215,4232,37,54,58,2454700,220
42,a1103,20110223,4215,4232,4111,4205,4111,4200,4166,-32,-66,10,416640,218
43,a1103,20110224,4200,4166,0,0,0,4166,4166,0,0,0,0,218
44,a1103,20110225,4166,4166,4350,4350,4181,4185,4245,19,79,20,849160,224
45,a1103,20110228,4185,4245,4062,4250,4062,4250,4178,5,-67,42,1755120,218
46,a1103,20110301,4250,4178,4050,4170,3928,4100,4012,-78,-166,22,882640,216
47,a1103,20110302,4100,4012,0,0,0,4012,4012,0,0,0,0,216
48,a1103,20110303,4012,4012,0,0,0,4012,4012,0,0,0,0,216
49,a1103,20110304,4012,4012,0,0,0,4012,4012,0,0,0,0,164
50,a1103,20110307,4012,4012,4100,4100,4100,4100,4100,88,88,2,82000,166
51,a1103,20110308,4100,4100,3900,4100,3900,4100,4000,0,-100,4,160000,166
52,a1103,20110309,4100,4000,4100,4100,3800,3800,3950,-200,-50,6,237000,0
53,a1103,20110310,3800,3950,0,0,0,3950,3950,0,0,0,0,0
54,a1103,20110311,3950,3950,0,0,0,3950,3950,0,0,0,0,0
55,a1103,20110314,3950,3950,0,0,0,3950,4004,0,54,0,0,0
56,a1105,20110104,4361,4362,4355,4382,4355,4367,4372,5,10,2208,96553060,17532
57,a1105,20110105,4367,4372,4360,4360,4311,4311,4319,-61,-53,1012,43713760,17576
58,a1105,20110106,4311,4319,4323,4360,4323,4352,4345,33,26,894,38852560,17364
59,a1105,20110107,4352,4345,4283,4330,4267,4267,4295,-78,-50,4400,188981360,17014
60,a1105,20110110,4267,4295,4275,4294,4272,4274,4282,-21,-13,730,31264880,16986
61,a1105,20110111,4274,4282,4298,4298,4280,4286,4285,4,3,364,15600100,16930
62,a1105,20110112,4286,4285,4279,4288,4265,4273,4275,-12,-10,606,25908720,16842
63,a1105,20110113,4273,4275,4366,4388,4315,4316,4340,41,65,684,29690500,16780
64,a1105,20110114,4316,4340,4320,4337,4306,4332,4328,-8,-12,1244,53842700,16136
65,a1105,20110117,4332,4328,4330,4359,4329,4344,4350,16,22,1622,70559480,16704
66,a1105,20110118,4344,4350,4335,4374,4332,4374,4356,24,6,1812,78932360,17064
67,a1105,20110119,4374,4356,4388,4396,4363,4392,4384,36,28,774,33934840,16858
68,a1105,20110120,4392,4384,4381,4393,4357,4372,4381,-12,-3,1516,66420820,17528
69,a1105,20110121,4372,4381,4361,4379,4360,4370,4369,-11,-12,2060,90010780,17616
70,a1105,20110124,4370,4369,4375,4398,4371,4384,4387,15,18,552,24217720,17446
71,a1105,20110125,4384,4387,4387,4387,4339,4343,4356,-44,-31,1274,55502760,16992
72,a1105,20110126,4343,4356,4322,4339,4273,4292,4291,-64,-65,2198,94327240,15146
73,a1105,20110127,4292,4291,4312,4316,4292,4295,4301,4,10,114,4903140,15136
74,a1105,20110128,4295,4301,4300,4304,4290,4291,4296,-10,-5,212,9108760,15074
75,a1105,20110131,4291,4296,4280,4316,4275,4316,4309,20,13,386,16633200,14852
76,a1105,20110201,4316,4309,4317,4344,4317,4344,4329,35,20,548,23723020,14762
77,a1105,20110209,4344,4329,4330,4380,4290,4375,4361,46,32,970,42305200,14816
78,a1105,20110210,4375,4361,4389,4430,4384,4408,4415,47,54,888,39212240,14964
79,a1105,20110211,4408,4415,4396,4435,4394,4420,4418,5,3,748,33049600,15202
80,a1105,20110214,4420,4418,4425,4585,4413,4458,4482,40,64,1352,60602780,15524
81,a1105,20110215,4458,4482,4458,4458,4417,4417,4439,-65,-43,292,12962160,15518
82,a1105,20110216,4417,4439,4408,4408,4380,4395,4395,-44,-44,550,24177180,15196
83,a1105,20110217,4395,4395,4300,4410,4300,4374,4385,-21,-10,218,9560700,15134
84,a1105,20110218,4374,4385,4403,4411,4384,4384,4404,-1,19,148,6518320,15078
85,a1105,20110221,4384,4404,4373,4373,4340,4349,4356,-55,-48,260,11325920,14958
86,a1105,20110222,4349,4356,4357,4400,4320,4343,4344,-13,-12,398,17291340,14836
87,a1105,20110223,4343,4344,4250,4294,4217,4266,4264,-78,-80,610,26014420,14844
88,a1105,20110224,4266,4264,4300,4300,4238,4240,4253,-24,-11,130,5529620,14868
89,a1105,20110225,4240,4253,4240,4273,4240,4273,4259,20,6,54,2300280,14840
90,a1105,20110228,4273,4259,4286,4365,4280,4307,4298,48,39,802,34476180,14946
91,a1105,20110301,4307,4298,4310,4310,4280,4285,4297,-13,-1,278,11947240,15060
92,a1105,20110302,4285,4297,4283,4346,4282,4339,4317,42,20,634,27373140,15018
93,a1105,20110303,4339,4317,4339,4373,4306,4311,4323,-6,6,224,9685460,15008
94,a1105,20110304,4311,4323,4348,4366,4315,4326,4335,3,12,380,16474280,15114
95,a1105,20110307,4326,4335,4322,4333,4314,4327,4325,-8,-10,82,3546740,15102
96,a1105,20110308,4327,4325,4294,4300,4260,4264,4275,-61,-50,154,6583860,15024
97,a1105,20110309,4264,4275,4264,4278,4264,4268,4267,-7,-8,292,12460340,15002
98,a1105,20110310,4268,4267,4288,4288,4225,4227,4237,-40,-30,180,7626900,14962
99,a1105,20110311,4227,4237,4221,4241,4218,4219,4220,-18,-17,434,18315400,14906
100,a1105,20110314,4219,4220,4226,4248,4171,4177,4207,-43,-13,368,15484380,14950
101,a1105,20110315,4177,4207,4198,4239,4171,4234,4211,27,4,652,27456020,15220
102,a1105,20110316,4234,4211,4198,4210,4131,4204,4182,-7,-29,252,10539660,15158
103,a1105,20110317,4204,4182,4210,4230,4186,4224,4209,42,27,332,13975740,15326
104,a1105,20110318,4224,4209,4265,4265,4225,4225,4233,16,24,366,15494260,15456
105,a1105,20110321,4225,4233,4268,4450,4232,4305,4292,72,59,3854,165430180,17470
106,a1105,20110322,4305,4292,4308,4326,4304,4306,4311,14,19,906,39063580,17504
107,a1105,20110323,4306,4311,4292,4317,4291,4317,4311,6,0,392,16902380,17512
108,a1105,20110324,4317,4311,4302,4312,4292,4292,4307,-19,-4,1688,72713420,17474
109,a1105,20110325,4292,4307,4301,4324,4301,4312,4305,5,-2,352,15155880,17708
110,a1105,20110328,4312,4305,4318,4360,4306,4356,4343,51,38,1786,77576540,18972
111,a1105,20110329,4356,4343,4348,4375,4332,4365,4344,22,1,10790,468723760,19090
112,a1105,20110330,4365,4344,4389,4389,4360,4360,4368,16,24,764,33377380,19330
113,a1105,20110331,4360,4368,4352,4375,4320,4328,4336,-40,-32,360,15610120,19388
114,a1105,20110401,4328,4336,4350,4378,4333,4336,4350,0,14,640,27840520,19506
115,a1105,20110406,4336,4350,4318,4380,4316,4347,4344,-3,-6,1114,48401660,19926
116,a1105,20110407,4347,4344,4340,4343,4327,4327,4333,-17,-11,266,11526820,19750
117,a1105,20110408,4327,4333,4314,4326,4308,4320,4321,-13,-12,280,12100280,19736
118,a1105,20110411,4320,4321,4333,4380,4333,4340,4357,19,36,1274,55510440,20572
119,a1105,20110412,4340,4357,4304,4320,4295,4302,4309,-55,-48,690,29733160,20068
120,a1105,20110413,4302,4309,4299,4299,4259,4288,4273,-21,-36,524,22391000,20152
121,a1105,20110414,4288,4273,4270,4270,4250,4252,4254,-21,-19,316,13443320,20070
122,a1105,20110415,4252,4254,4236,4253,4223,4233,4237,-21,-17,402,17034460,20132
123,a1105,20110418,4233,4237,4240,4252,4235,4247,4242,10,5,422,17902420,20080
124,a1105,20110419,4247,4242,4255,4264,4236,4236,4249,-6,7,180,7648760,20072
125,a1105,20110420,4236,4249,4251,4251,4240,4241,4246,-8,-3,108,4586060,20102
126,a1105,20110421,4241,4246,4241,4249,4237,4238,4240,-8,-6,286,12126580,20230
127,a1105,20110422,4238,4240,4265,4269,4235,4247,4249,7,9,396,16828820,20392
128,a1105,20110425,4247,4249,4251,4251,4230,4231,4239,-18,-10,206,8733260,20384
129,a1105,20110426,4231,4239,4206,4233,4206,4221,4223,-18,-16,198,8362940,20342
130,a1105,20110427,4221,4223,4227,4254,4210,4210,4219,-13,-4,226,9536520,20282
131,a1105,20110428,4210,4219,4200,4214,4199,4210,4201,-9,-18,1618,67979340,20270
132,a1105,20110429,4210,4201,4162,4185,4153,4160,4168,-41,-33,458,19093060,20186
133,a1105,20110503,4160,4168,4130,4150,4130,4130,4131,-38,-37,206,8510680,5480
134,a1105,20110504,4130,4131,4130,4150,4120,4120,4138,-11,7,352,14568220,4354
135,a1105,20110505,4120,4138,4109,4120,4105,4120,4113,-18,-25,234,9626180,2736
136,a1105,20110506,4120,4113,4105,4105,4050,4060,4080,-53,-33,174,7100020,2230
137,a1105,20110509,4060,4080,4045,4060,4045,4055,4055,-25,-25,48,1946760,1852
138,a1105,20110510,4055,4055,4060,4060,4060,4060,4060,5,5,12,487200,1864
139,a1105,20110511,4060,4060,4060,4060,4060,4060,4060,0,0,38,1542800,1884
140,a1105,20110512,4060,4060,4055,4057,4049,4050,4052,-10,-8,92,3728220,1880
141,a1105,20110513,4050,4052,0,0,0,4052,4052,0,0,0,0,1276
142,a1105,20110516,4052,4052,4088,4088,3900,4000,4107,-52,55,20,799760,0
143,a1107,20110104,4448,4449,4460,4460,4444,4444,4451,-5,2,6,267080,744
144,a1107,20110105,4444,4451,4393,4404,4391,4397,4396,-54,-55,38,1670660,728
145,a1107,20110106,4397,4396,4435,4444,4431,4444,4434,48,38,20,886860,716
146,a1107,20110107,4444,4434,4399,4399,4399,4399,4399,-35,-35,6,263940,710
147,a1107,20110110,4399,4399,0,0,0,4399,4399,0,0,0,0,710
148,a1107,20110111,4399,4399,4399,4399,4345,4365,4366,-34,-33,42,1833940,704
149,a1107,20110112,4365,4366,4352,4367,4327,4351,4352,-15,-14,14,609300,698
150,a1107,20110113,4351,4352,4399,4431,4391,4391,4406,39,54,56,2467800,686
151,a1107,20110114,4391,4406,4403,4444,4403,4444,4416,38,10,10,441660,688
152,a1107,20110117,4444,4416,4498,4498,4402,4416,4426,0,10,36,1593480,670
153,a1107,20110118,4416,4426,4415,4455,4415,4436,4432,10,6,34,1507120,670
154,a1107,20110119,4436,4432,4470,4480,4456,4480,4462,48,30,34,1517080,670
155,a1107,20110120,4480,4462,4480,4505,4455,4470,4479,8,17,16,716740,672
156,a1107,20110121,4470,4479,4457,4457,4430,4455,4445,-24,-34,14,622300,670
157,a1107,20110124,4455,4445,4480,4480,4456,4460,4467,15,22,18,804100,666
158,a1107,20110125,4460,4467,4471,4471,4430,4460,4452,-7,-15,10,445240,664
159,a1107,20110126,4460,4452,4345,4389,4337,4351,4356,-101,-96,24,1045620,666
160,a1107,20110127,4351,4356,4367,4387,4367,4387,4377,31,21,4,175080,668
161,a1107,20110128,4387,4377,4398,4398,4398,4398,4398,21,21,2,87960,670
162,a1107,20110131,4398,4398,4369,4393,4369,4388,4381,-10,-17,34,1489740,662
163,a1107,20110201,4388,4381,4400,4400,4385,4396,4391,15,10,22,966120,654
164,a1107,20110209,4396,4391,4430,4470,4422,4470,4441,79,50,14,621740,652
165,a1107,20110210,4470,4441,4446,4526,4443,4500,4456,59,15,128,5704320,648
166,a1107,20110211,4500,4456,4500,4516,4480,4516,4496,60,40,24,1079120,656
167,a1107,20110214,4516,4496,4474,4556,4474,4524,4508,28,12,26,1172160,658
168,a1107,20110215,4524,4508,4540,4540,4497,4515,4513,7,5,8,361080,656
169,a1107,20110216,4515,4513,4421,4515,4421,4515,4463,2,-50,24,1071180,646
170,a1107,20110217,4515,4463,4466,4485,4465,4485,4477,22,14,10,447720,646
171,a1107,20110218,4485,4477,0,0,0,4477,4477,0,0,0,0,646
172,a1107,20110221,4477,4477,4430,4440,4419,4419,4425,-58,-52,24,1062060,634
173,a1107,20110222,4419,4425,4422,4422,4422,4422,4422,-3,-3,2,88440,634
174,a1107,20110223,4422,4422,0,0,0,4422,4422,0,0,0,0,634
175,a1107,20110224,4422,4422,0,0,0,4422,4422,0,0,0,0,634
176,a1107,20110225,4422,4422,0,0,0,4422,4422,0,0,0,0,634
177,a1107,20110228,4422,4422,4411,4411,4359,4366,4388,-56,-34,164,7196420,632
178,a1107,20110301,4366,4388,0,0,0,4388,4388,0,0,0,0,632
179,a1107,20110302,4388,4388,4400,4455,4353,4430,4382,42,-6,44,1928460,630
180,a1107,20110303,4430,4382,4420,4420,4393,4393,4404,11,22,8,352340,626
181,a1107,20110304,4393,4404,4450,4450,4407,4420,4420,16,16,10,442000,628
182,a1107,20110307,4420,4420,4391,4435,4391,4435,4407,15,-13,14,617060,634
183,a1107,20110308,4435,4407,4372,4372,4305,4350,4341,-57,-66,10,434140,632
184,a1107,20110309,4350,4341,4350,4360,4350,4353,4354,12,13,6,261260,632
185,a1107,20110310,4353,4354,4315,4315,4300,4300,4304,-54,-50,18,774740,622
186,a1107,20110311,4300,4304,4260,4307,4260,4290,4284,-14,-20,20,856940,612
187,a1107,20110314,4290,4284,4308,4310,4251,4269,4286,-15,2,12,514420,612
188,a1107,20110315,4269,4286,4261,4315,4261,4314,4296,28,10,28,1202980,612
189,a1107,20110316,4314,4296,4266,4296,4263,4296,4272,0,-24,14,598160,606
190,a1107,20110317,4296,4272,4290,4310,4290,4310,4298,38,26,38,1633380,596
191,a1107,20110318,4310,4298,4325,4325,4325,4325,4325,27,27,2,86500,596
192,a1107,20110321,4325,4325,4328,4380,4301,4380,4329,55,4,28,1212140,598
193,a1107,20110322,4380,4329,4389,4389,4329,4365,4371,36,42,34,1486160,602
194,a1107,20110323,4365,4371,4439,4439,4419,4419,4429,48,58,4,177160,604
195,a1107,20110324,4419,4429,4377,4397,4356,4380,4375,-49,-54,20,875140,602
196,a1107,20110325,4380,4375,4401,4428,4380,4410,4403,35,28,54,2377760,614
197,a1107,20110328,4410,4403,4429,4450,4407,4450,4431,47,28,24,1063660,618
198,a1107,20110329,4450,4431,4459,4459,4415,4445,4432,14,1,34,1507200,620
199,a1107,20110330,4445,4432,4441,4441,4434,4434,4434,2,2,32,1419040,608
200,a1107,20110331,4434,4434,4462,4462,4410,4420,4421,-14,-13,80,3537380,658
201,a1107,20110401,4420,4421,4431,4431,4383,4430,4414,9,-7,18,794600,656
202,a1107,20110406,4430,4414,4430,4450,4430,4450,4436,36,22,6,266200,658
203,a1107,20110407,4450,4436,4425,4425,4424,4424,4424,-12,-12,8,353980,650
204,a1107,20110408,4424,4424,4405,4415,4400,4415,4406,-9,-18,22,969320,642
205,a1107,20110411,4415,4406,4460,4460,4430,4444,4444,38,38,20,888800,640
206,a1107,20110412,4444,4444,4390,4391,4370,4390,4377,-54,-67,40,1750940,632
207,a1107,20110413,4390,4377,4382,4382,4352,4365,4359,-12,-18,16,697480,632
208,a1107,20110414,4365,4359,4331,4350,4329,4337,4334,-22,-25,30,1300260,616
209,a1107,20110415,4337,4334,4312,4312,4312,4312,4312,-22,-22,4,172480,614
210,a1107,20110418,4312,4312,4338,4366,4310,4322,4324,10,12,24,1037800,622
211,a1107,20110419,4322,4324,4326,4326,4304,4310,4314,-14,-10,44,1898260,608
212,a1107,20110420,4310,4314,4300,4327,4300,4321,4321,7,7,30,1296300,606
213,a1107,20110421,4321,4321,4313,4323,4311,4316,4316,-5,-5,38,1640200,616
214,a1107,20110422,4316,4316,4329,4329,4314,4319,4318,3,2,36,1554560,618
215,a1107,20110425,4319,4318,4330,4334,4300,4310,4326,-8,8,56,2423080,596
216,a1107,20110426,4310,4326,4300,4310,4281,4310,4297,-16,-29,12,515700,594
217,a1107,20110427,4310,4297,4292,4300,4271,4300,4284,3,-13,26,1114060,602
218,a1107,20110428,4300,4284,4271,4295,4271,4295,4281,11,-3,42,1798080,590
219,a1107,20110429,4295,4281,4208,4250,4203,4213,4217,-68,-64,176,7422560,672
220,a1107,20110503,4213,4217,4189,4230,4189,4209,4211,-8,-6,22,926500,668
221,a1107,20110504,4209,4211,4171,4199,4162,4167,4180,-44,-31,92,3845780,670
222,a1107,20110505,4167,4180,0,0,0,4180,4180,0,0,0,0,670
223,a1107,20110506,4180,4180,4105,4110,4090,4105,4103,-75,-77,26,1066840,666
224,a1107,20110509,4105,4103,4097,4105,4090,4105,4096,2,-7,74,3031720,698
225,a1107,20110510,4105,4096,4100,4126,4100,4124,4111,28,15,170,6989180,702
226,a1107,20110511,4124,4111,4140,4140,4120,4120,4125,9,14,24,990220,700
227,a1107,20110512,4120,4125,4110,4110,4110,4110,4110,-15,-15,6,246600,694
228,a1107,20110513,4110,4110,4130,4130,4130,4130,4130,20,20,2,82600,694
229,a1107,20110516,4130,4130,4094,4110,4094,4110,4101,-20,-29,56,2296640,726
230,a1107,20110517,4110,4101,4137,4137,4067,4100,4097,-1,-4,14,573680,728
231,a1107,20110518,4100,4097,4134,4134,4090,4090,4103,-7,6,422,17316480,858
232,a1107,20110519,4090,4103,4116,4125,4116,4120,4122,17,19,20,824460,854
233,a1107,20110520,4120,4122,4121,4121,4121,4121,4121,-1,-1,2,82420,854
234,a1107,20110523,4121,4121,4168,4168,4131,4131,4146,10,25,28,1160960,848
235,a1107,20110524,4131,4146,4194,4194,4078,4134,4130,-12,-16,20,826060,842
236,a1107,20110525,4134,4130,4158,4158,4134,4134,4139,4,9,28,1159000,838
237,a1107,20110526,4134,4139,4158,4173,4158,4173,4160,34,21,144,5990540,718
238,a1107,20110527,4173,4160,4182,4182,4150,4164,4166,4,6,8,333320,720
239,a1107,20110530,4164,4166,4142,4169,4142,4164,4159,-2,-7,32,1331100,714
240,a1107,20110531,4164,4159,4170,4179,4153,4167,4165,8,6,124,5164920,738
241,a1107,20110601,4167,4165,4161,4165,4152,4161,4159,-4,-6,44,1830360,720
242,a1107,20110602,4161,4159,4161,4175,4150,4167,4164,8,5,32,1332700,720
243,a1107,20110603,4167,4164,4199,4200,4170,4200,4192,36,28,38,1593020,724
244,a1107,20110607,4200,4192,4180,4180,4180,4180,4180,-12,-12,2,83600,722
245,a1107,20110608,4180,4180,4176,4176,4170,4170,4172,-10,-8,16,667620,708
246,a1107,20110609,4170,4172,4191,4192,4185,4185,4190,13,18,28,1173240,714
247,a1107,20110610,4185,4190,4195,4220,4160,4178,4182,-12,-8,18,752820,718
248,a1107,20110613,4178,4182,4113,4188,4113,4174,4155,-8,-27,26,1080440,710
249,a1107,20110614,4174,4155,0,0,0,4155,4155,0,0,0,0,710
250,a1107,20110615,4155,4155,4150,4155,4150,4155,4152,0,-3,8,332200,706
251,a1107,20110616,4155,4152,4195,4195,4195,4195,4195,43,43,8,335600,708
252,a1107,20110617,4195,4195,0,0,0,4195,4195,0,0,0,0,708
253,a1107,20110620,4195,4195,4160,4200,4160,4160,4172,-35,-23,154,6425960,584
254,a1107,20110621,4160,4172,4184,4184,4157,4160,4166,-12,-6,28,1166540,566
255,a1107,20110622,4160,4166,4160,4160,4150,4150,4156,-16,-10,86,3574620,486
256,a1107,20110623,4150,4156,4069,4140,4069,4125,4120,-31,-36,24,988920,482
257,a1107,20110624,4125,4120,4179,4179,4050,4131,4126,11,6,46,1898280,472
258,a1107,20110627,4131,4126,4115,4125,4050,4120,4103,-6,-23,40,1641540,458
259,a1107,20110628,4120,4103,4109,4139,4095,4095,4111,-8,8,18,740020,454
260,a1107,20110629,4095,4111,4111,4111,4110,4110,4110,-1,-1,36,1479860,430
261,a1107,20110630,4110,4110,4117,4137,4100,4100,4116,-10,6,52,2140740,390
262,a1107,20110701,4100,4116,0,0,0,4116,4116,0,0,0,0,390
263,a1107,20110704,4116,4116,4199,4233,4199,4200,4210,84,94,36,1515780,374
264,a1107,20110705,4200,4210,0,0,0,4210,4210,0,0,0,0,372
265,a1107,20110706,4210,4210,0,0,0,4210,4210,0,0,0,0,372
266,a1107,20110707,4210,4210,4249,4250,4248,4250,4249,40,39,68,2889860,294
267,a1107,20110708,4250,4249,0,0,0,4249,4249,0,0,0,0,294
268,a1107,20110711,4249,4249,0,0,0,4249,4249,0,0,0,0,294
269,a1107,20110712,4249,4249,0,0,0,4249,4249,0,0,0,0,294
270,a1107,20110713,4249,4249,4250,4250,4250,4250,4250,1,1,10,425000,10
271,a1107,20110714,4250,4250,0,0,0,4250,4237,0,-13,6,254220,0
272,a1109,20110104,4528,4531,4528,4545,4520,4537,4535,6,4,110524,5012343740,206650
273,a1109,20110105,4537,4535,4498,4500,4471,4477,4485,-58,-50,99710,4472004160,200044
274,a1109,20110106,4477,4485,4506,4538,4500,4529,4522,44,37,103762,4693072120,200400
275,a1109,20110107,4529,4522,4480,4496,4421,4424,4462,-98,-60,111956,4996036000,182260
276,a1109,20110110,4424,4462,4441,4458,4430,4439,4446,-23,-16,69038,3069895300,171810
277,a1109,20110111,4439,4446,4460,4465,4439,4449,4450,3,4,36778,1636907100,169328
278,a1109,20110112,4449,4450,4426,4455,4425,4434,4438,-16,-12,64900,2880897040,164122
279,a1109,20110113,4434,4438,4520,4560,4477,4479,4503,41,65,61998,2792305380,160530
280,a1109,20110114,4479,4503,4472,4505,4468,4499,4491,-4,-12,49164,2208092760,153554
281,a1109,20110117,4499,4491,4480,4520,4480,4507,4507,16,16,70212,3164482540,146142
282,a1109,20110118,4507,4507,4499,4538,4491,4536,4516,29,9,72872,3291482080,139904
283,a1109,20110119,4536,4516,4541,4564,4525,4560,4546,44,30,63422,2883756600,131084
284,a1109,20110120,4560,4546,4549,4549,4518,4531,4531,-15,-15,33248,1506681720,130816
285,a1109,20110121,4531,4531,4508,4537,4508,4518,4524,-13,-7,24612,1113471180,128356
286,a1109,20110124,4518,4524,4510,4559,4510,4542,4544,18,20,30674,1393831160,124248
287,a1109,20110125,4542,4544,4520,4537,4490,4491,4510,-53,-34,19470,878100020,121148
288,a1109,20110126,4491,4510,4450,4450,4402,4428,4420,-82,-90,33774,1492946920,114562
289,a1109,20110127,4428,4420,4445,4455,4418,4426,4432,6,12,16588,735297660,113170
290,a1109,20110128,4426,4432,4400,4428,4400,4410,4418,-22,-14,14502,640739700,110834
291,a1109,20110131,4410,4418,4418,4456,4410,4454,4436,36,18,13776,611139700,110700
292,a1109,20110201,4454,4436,4456,4468,4452,4465,4458,29,22,9356,417156880,110034
293,a1109,20110209,4465,4458,4480,4545,4468,4539,4521,81,63,29372,1328023400,103226
294,a1109,20110210,4539,4521,4551,4600,4546,4588,4587,67,66,42282,1939582360,97584
295,a1109,20110211,4588,4587,4580,4610,4572,4589,4591,2,4,24690,1133541060,96036
296,a1109,20110214,4589,4591,4593,4606,4572,4598,4594,7,3,21932,1007675640,93506
297,a1109,20110215,4598,4594,4580,4582,4538,4546,4566,-48,-28,13586,620372260,89450
298,a1109,20110216,4546,4566,4500,4532,4495,4522,4516,-44,-50,14926,674153820,85362
299,a1109,20110217,4522,4516,4522,4536,4498,4498,4521,-18,5,14372,649800420,80650
300,a1109,20110218,4498,4521,4532,4550,4501,4503,4520,-18,-1,13206,597017300,75718
301,a1109,20110221,4503,4520,4525,4525,4468,4474,4484,-46,-36,9676,433932520,73970
302,a1109,20110222,4474,4484,4486,4508,4436,4493,4478,9,-6,11752,526350940,73162
303,a1109,20110223,4493,4478,4390,4390,4322,4388,4369,-90,-109,19352,845669620,72264
304,a1109,20110224,4388,4369,4402,4404,4336,4343,4372,-26,3,21280,930409300,61768
305,a1109,20110225,4343,4372,4396,4396,4355,4375,4370,3,-2,13852,605337140,55342
306,a1109,20110228,4375,4370,4418,4426,4398,4419,4410,49,40,13114,578347900,50664
307,a1109,20110301,4419,4410,4414,4426,4402,4418,4413,8,3,6886,303897800,46954
308,a1109,20110302,4418,4413,4420,4520,4409,4509,4476,96,63,20298,908544240,38558
309,a1109,20110303,4509,4476,4503,4512,4463,4465,4483,-11,7,13278,595255760,32822
310,a1109,20110304,4465,4483,4499,4544,4484,4502,4508,19,25,8526,384377980,31716
311,a1109,20110307,4502,4508,4493,4506,4475,4499,4492,-9,-16,4264,191554500,30572
312,a1109,20110308,4499,4492,4478,4478,4413,4420,4442,-72,-50,7578,336654180,28402
313,a1109,20110309,4420,4442,4428,4431,4400,4416,4419,-26,-23,5712,252413340,28950
314,a1109,20110310,4416,4419,4396,4396,4368,4370,4378,-49,-41,5130,224625820,27182
315,a1109,20110311,4370,4378,4371,4386,4352,4359,4373,-19,-5,3014,131819520,26854
316,a1109,20110314,4359,4373,4375,4410,4320,4343,4360,-30,-13,7270,317043680,25722
317,a1109,20110315,4343,4360,4356,4412,4341,4406,4382,46,22,7294,319661660,23746
318,a1109,20110316,4406,4382,4280,4382,4280,4370,4345,-12,-37,9874,429056580,20934
319,a1109,20110317,4370,4345,4370,4415,4358,4400,4396,55,51,7228,317801940,20474
320,a1109,20110318,4400,4396,4440,4440,4403,4411,4417,15,21,4254,187908200,19982
321,a1109,20110321,4411,4417,4430,4452,4406,4442,4439,25,22,10336,458824920,21498
322,a1109,20110322,4442,4439,4440,4460,4430,4446,4453,7,14,4092,182235620,21832
323,a1109,20110323,4446,4453,4453,4477,4450,4477,4467,24,14,4762,212731320,22712
324,a1109,20110324,4477,4467,4476,4480,4433,4450,4459,-17,-8,2642,117828440,22298
325,a1109,20110325,4450,4459,4463,4504,4463,4503,4490,44,31,9828,441294780,25548
326,a1109,20110328,4503,4490,4490,4539,4471,4521,4519,31,29,10532,475987940,28124
327,a1109,20110329,4521,4519,4512,4548,4494,4541,4519,22,0,10538,476310360,31014
328,a1109,20110330,4541,4519,4549,4554,4520,4526,4535,7,16,4390,199095020,30068
329,a1109,20110331,4526,4535,4532,4548,4490,4501,4515,-34,-20,3948,178254420,30286
330,a1109,20110401,4501,4515,4540,4544,4508,4517,4527,2,12,3654,165428260,31482
331,a1109,20110406,4517,4527,4500,4534,4488,4529,4519,2,-8,6236,281819600,34626
332,a1109,20110407,4529,4519,4530,4530,4509,4511,4517,-8,-2,2066,93331480,34940
333,a1109,20110408,4511,4517,4497,4510,4485,4509,4498,-8,-19,4750,213698660,35968
334,a1109,20110411,4509,4498,4520,4565,4516,4518,4536,20,38,16386,743398080,46114
335,a1109,20110412,4518,4536,4497,4497,4465,4468,4480,-68,-56,5792,259500340,44358
336,a1109,20110413,4468,4480,4416,4458,4416,4451,4444,-29,-36,4370,194220260,43512
337,a1109,20110414,4451,4444,4478,4478,4400,4400,4421,-44,-23,2734,120896240,42772
338,a1109,20110415,4400,4421,4421,4422,4402,4405,4411,-16,-10,5376,237151460,40582
339,a1109,20110418,4405,4411,4375,4430,4375,4416,4419,5,8,3180,140533200,41064
340,a1109,20110419,4416,4419,4425,4430,4403,4405,4413,-14,-6,2110,93123860,39924
341,a1109,20110420,4405,4413,4445,4445,4420,4428,4426,15,13,2492,110307080,40794
342,a1109,20110421,4428,4426,4435,4435,4411,4415,4420,-11,-6,1738,76827840,40346
343,a1109,20110422,4415,4420,4425,4441,4411,4426,4428,6,8,2296,101677540,40552
344,a1109,20110425,4426,4428,4418,4437,4400,4406,4411,-22,-17,2494,110025920,40536
345,a1109,20110426,4406,4411,4385,4400,4376,4376,4387,-35,-24,2032,89144980,40000
346,a1109,20110427,4376,4387,4386,4395,4368,4374,4381,-13,-6,2712,118829140,38836
347,a1109,20110428,4374,4381,4376,4397,4376,4392,4384,11,3,2598,113916720,38830
348,a1109,20110429,4392,4384,4370,4370,4317,4319,4336,-65,-48,2572,111539800,37750
349,a1109,20110503,4319,4336,4350,4350,4327,4331,4334,-5,-2,554,24012620,37686
350,a1109,20110504,4331,4334,4308,4320,4268,4270,4282,-64,-52,2950,126344960,38748
351,a1109,20110505,4270,4282,4253,4285,4244,4273,4271,-9,-11,2276,97221280,39670
352,a1109,20110506,4273,4271,4250,4250,4201,4208,4219,-63,-52,2462,103891820,39254
353,a1109,20110509,4208,4219,4215,4226,4214,4222,4219,3,0,1346,56800200,39228
354,a1109,20110510,4222,4219,4225,4249,4222,4246,4232,27,13,1058,44784380,39208
355,a1109,20110511,4246,4232,4251,4258,4239,4242,4246,10,14,1756,74575940,38822
356,a1109,20110512,4242,4246,4215,4256,4200,4208,4229,-38,-17,1746,73843760,38812
357,a1109,20110513,4208,4229,4238,4250,4222,4246,4238,17,9,1550,65696680,39120
358,a1109,20110516,4246,4238,4228,4240,4222,4222,4231,-16,-7,458,19380680,39178
359,a1109,20110517,4222,4231,4222,4222,4171,4199,4196,-32,-35,2512,105427740,38284
360,a1109,20110518,4199,4196,4210,4223,4206,4207,4215,11,19,964,40638420,38350
361,a1109,20110519,4207,4215,4224,4245,4224,4229,4236,14,21,886,37537700,38444
362,a1109,20110520,4229,4236,4232,4245,4229,4244,4239,8,3,696,29508220,38556
363,a1109,20110523,4244,4239,4254,4267,4234,4242,4254,3,15,2002,85171380,39402
364,a1109,20110524,4242,4254,4240,4251,4220,4249,4228,-5,-26,14390,608442540,32950
365,a1109,20110525,4249,4228,4242,4259,4242,4251,4249,23,21,936,39773480,33106
366,a1109,20110526,4251,4249,4258,4284,4256,4275,4267,26,18,4036,172236740,34024
367,a1109,20110527,4275,4267,4282,4283,4256,4269,4270,2,3,1428,60982840,33972
368,a1109,20110530,4269,4270,4262,4283,4253,4275,4269,5,-1,818,34922580,33770
369,a1109,20110531,4275,4269,4276,4285,4261,4268,4270,-1,1,518,22118640,33790
370,a1109,20110601,4268,4270,4268,4271,4255,4260,4265,-10,-5,480,20475040,33722
371,a1109,20110602,4260,4265,4263,4288,4258,4286,4273,21,8,1962,83838240,33276
372,a1109,20110603,4286,4273,4299,4316,4293,4305,4301,32,28,7316,314663220,31600
373,a1109,20110607,4305,4301,4283,4283,4269,4277,4276,-24,-25,2838,121353340,30772
374,a1109,20110608,4277,4276,4292,4295,4283,4284,4285,8,9,3326,142549500,31330
375,a1109,20110609,4284,4285,4298,4300,4283,4284,4292,-1,7,478,20517680,31432
376,a1109,20110610,4284,4292,4292,4292,4266,4271,4275,-21,-17,840,35913160,30964
377,a1109,20110613,4271,4275,4271,4281,4268,4273,4272,-2,-3,566,24180820,30700
378,a1109,20110614,4273,4272,4275,4280,4272,4277,4276,5,4,192,8210460,30598
379,a1109,20110615,4277,4276,4271,4276,4263,4267,4269,-9,-7,642,27407200,30660
380,a1109,20110616,4267,4269,4270,4270,4247,4251,4261,-18,-8,524,22329440,30530
381,a1109,20110617,4251,4261,4246,4246,4212,4217,4224,-44,-37,656,27710400,30488
382,a1109,20110620,4217,4224,4232,4232,4202,4206,4214,-18,-10,1202,50656900,30130
383,a1109,20110621,4206,4214,4219,4231,4215,4231,4221,17,7,406,17137980,30120
384,a1109,20110622,4231,4221,4232,4240,4226,4233,4232,12,11,640,27087200,29748
385,a1109,20110623,4233,4232,4235,4235,4192,4207,4202,-25,-30,558,23452000,29564
386,a1109,20110624,4207,4202,4202,4230,4202,4226,4217,24,15,1036,43691060,29580
387,a1109,20110627,4226,4217,4205,4220,4192,4197,4204,-20,-13,1196,50285240,29358
388,a1109,20110628,4197,4204,4205,4233,4205,4226,4221,22,17,764,32249160,29100
389,a1109,20110629,4226,4221,4228,4235,4225,4230,4230,9,9,776,32825360,28572
390,a1109,20110630,4230,4230,4233,4244,4233,4244,4238,14,8,610,25854780,28094
391,a1109,20110701,4244,4238,4222,4222,4206,4218,4222,-20,-16,324,13679500,27836
392,a1109,20110704,4218,4222,4232,4249,4223,4246,4236,24,14,472,19998000,27562
393,a1109,20110705,4246,4236,4245,4260,4238,4251,4250,15,14,988,41993360,26762
394,a1109,20110706,4251,4250,4243,4251,4235,4235,4247,-15,-3,572,24293140,26296
395,a1109,20110707,4235,4247,4239,4243,4233,4240,4237,-7,-10,478,20253820,26018
396,a1109,20110708,4240,4237,4251,4269,4251,4269,4257,32,20,1784,75962220,24412
397,a1109,20110711,4269,4257,4270,4275,4263,4266,4265,9,8,872,37197840,24310
398,a1109,20110712,4266,4265,4266,4266,4235,4246,4242,-19,-23,512,21724120,24226
399,a1109,20110713,4246,4242,4259,4277,4259,4275,4269,33,27,1556,66426240,23542
400,a1109,20110714,4275,4269,4303,4305,4281,4282,4286,13,17,580,24864420,23646
401,a1109,20110715,4282,4286,4282,4282,4265,4265,4283,-21,-3,866,37096500,22986
402,a1109,20110718,4265,4283,4268,4279,4249,4250,4266,-33,-17,526,22442880,22740
403,a1109,20110719,4250,4266,4254,4260,4240,4259,4253,-7,-13,628,26714640,22324
404,a1109,20110720,4259,4253,4252,4264,4250,4263,4259,10,6,6884,293236580,22082
405,a1109,20110721,4263,4259,4250,4265,4249,4258,4259,-1,0,314,13375260,21970
406,a1109,20110722,4258,4259,4261,4265,4258,4264,4261,5,2,556,23691860,21482
407,a1109,20110725,4264,4261,4253,4253,4238,4240,4246,-21,-15,1234,52401680,21014
408,a1109,20110726,4240,4246,4230,4251,4230,4243,4245,-3,-1,112,4754640,20962
409,a1109,20110727,4243,4245,4251,4263,4249,4260,4260,15,15,356,15166860,20826
410,a1109,20110728,4260,4260,4248,4253,4242,4249,4248,-11,-12,124,5267820,20732
411,a1109,20110729,4249,4248,4238,4250,4232,4232,4242,-16,-6,566,24013840,20230
412,a1109,20110801,4232,4242,4237,4270,4237,4270,4248,28,6,330,14020400,19938
413,a1109,20110802,4270,4248,4267,4270,4255,4268,4264,20,16,1232,52540980,19584
414,a1109,20110803,4268,4264,4268,4280,4258,4258,4272,-6,8,1420,60667840,19404
415,a1109,20110804,4258,4272,4253,4261,4241,4241,4259,-31,-13,728,31008080,18708
416,a1109,20110805,4241,4259,4225,4254,4113,4184,4201,-75,-58,2952,124022140,16124
417,a1109,20110808,4184,4201,4142,4240,4142,4188,4183,-13,-18,2086,87277740,14232
418,a1109,20110809,4188,4183,4136,4180,4117,4175,4162,-8,-21,2918,121466720,11712
419,a1109,20110810,4175,4162,4179,4179,4163,4170,4169,8,7,886,36945200,10852
420,a1109,20110811,4170,4169,4150,4193,4150,4184,4178,15,9,926,38692280,9990
421,a1109,20110812,4184,4178,4188,4203,4180,4190,4185,12,7,766,32062120,9734
422,a1109,20110815,4190,4185,4187,4208,4187,4203,4202,18,17,872,36645960,9384
423,a1109,20110816,4203,4202,4199,4199,4168,4173,4183,-29,-19,44,1840600,9350
424,a1109,20110817,4173,4183,4188,4188,4176,4180,4180,-3,-3,314,13125820,9038
425,a1109,20110818,4180,4180,4189,4200,4166,4178,4183,-2,3,1058,44264560,8306
426,a1109,20110819,4178,4183,4164,4178,4164,4176,4171,-7,-12,94,3921280,8242
427,a1109,20110822,4176,4171,4198,4230,4180,4180,4192,9,21,140,5869280,8198
428,a1109,20110823,4180,4192,4181,4210,4181,4208,4202,16,10,236,9918720,8214
429,a1109,20110824,4208,4202,4200,4209,4191,4202,4199,0,-3,116,4870960,8166
430,a1109,20110825,4202,4199,4185,4200,4177,4181,4182,-18,-17,80,3345980,8142
431,a1109,20110826,4181,4182,4190,4194,4170,4170,4174,-12,-8,34,1419320,8134
432,a1109,20110829,4170,4174,4218,4280,4217,4280,4231,106,57,624,26401520,8544
433,a1109,20110830,4280,4231,4285,4300,4277,4298,4292,67,61,220,9442940,8522
434,a1109,20110831,4298,4292,4240,4320,4240,4283,4293,-9,1,182,7813380,8488
435,a1109,20110901,4283,4293,4285,4300,4281,4281,4287,-12,-6,1304,55907020,2906
436,a1109,20110902,4281,4287,4270,4278,4270,4278,4271,-9,-16,56,2392000,1786
437,a1109,20110905,4278,4271,4320,4320,4320,4320,4320,49,49,8,345600,1790
438,a1109,20110906,4320,4320,0,0,0,4320,4320,0,0,0,0,1670
439,a1109,20110907,4320,4320,4295,4295,4290,4290,4292,-30,-28,4,171700,960
440,a1109,20110908,4290,4292,4262,4262,4262,4262,4262,-30,-30,2,85240,962
441,a1109,20110909,4262,4262,4281,4288,4269,4269,4274,7,12,100,4274520,772
442,a1109,20110913,4269,4274,4210,4234,4200,4201,4206,-73,-68,266,11189140,598
443,a1109,20110914,4201,4206,4204,4204,4180,4180,4197,-26,-9,144,6043680,64
444,a1109,20110915,4180,4197,0,0,0,4197,4267,0,70,0,0,0
445,a1111,20110104,4530,4521,0,0,0,4521,4521,0,0,0,0,240
446,a1111,20110105,4521,4521,4499,4504,4481,4486,4489,-35,-32,50,2244760,234
447,a1111,20110106,4486,4489,4515,4531,4515,4531,4523,42,34,16,723680,232
448,a1111,20110107,4531,4523,4466,4482,4430,4433,4461,-90,-62,56,2498460,232
449,a1111,20110110,4433,4461,4450,4468,4445,4468,4450,7,-11,28,1246080,230
450,a1111,20110111,4468,4450,4461,4461,4446,4452,4453,2,3,18,801620,222
451,a1111,20110112,4452,4453,0,0,0,4453,4453,0,0,0,0,222
452,a1111,20110113,4453,4453,0,0,0,4453,4453,0,0,0,0,222
453,a1111,20110114,4453,4453,4491,4516,4491,4516,4500,63,47,6,270040,224
454,a1111,20110117,4516,4500,4571,4571,4474,4522,4517,22,17,90,4065420,234
455,a1111,20110118,4522,4517,4520,4555,4520,4555,4536,38,19,60,2721720,218
456,a1111,20110119,4555,4536,4560,4560,4560,4560,4560,24,24,2,91200,218
457,a1111,20110120,4560,4560,4557,4557,4553,4554,4554,-6,-6,8,364380,212
458,a1111,20110121,4554,4554,4571,4571,4530,4530,4541,-24,-13,18,817400,212
459,a1111,20110124,4530,4541,4568,4578,4552,4552,4571,11,30,14,640000,200
460,a1111,20110125,4552,4571,4535,4558,4520,4520,4539,-51,-32,18,817140,198
461,a1111,20110126,4520,4539,4440,4440,4420,4426,4430,-113,-109,24,1063200,198
462,a1111,20110127,4426,4430,0,0,0,4430,4430,0,0,0,0,198
463,a1111,20110128,4430,4430,4436,4475,4436,4440,4451,10,21,14,623220,198
464,a1111,20110131,4440,4451,4456,4489,4456,4465,4471,14,20,10,447100,198
465,a1111,20110201,4465,4471,4486,4497,4480,4480,4488,9,17,12,538620,192
466,a1111,20110209,4480,4488,4550,4551,4531,4551,4541,63,53,10,454180,184
467,a1111,20110210,4551,4541,0,0,0,4541,4541,0,0,0,0,184
468,a1111,20110211,4541,4541,0,0,0,4541,4541,0,0,0,0,184
469,a1111,20110214,4541,4541,4676,4676,4600,4600,4646,59,105,86,3996060,222
470,a1111,20110215,4600,4646,4559,4619,4559,4580,4566,-66,-80,42,1918060,210
471,a1111,20110216,4580,4566,4530,4577,4530,4560,4551,-6,-15,34,1547540,220
472,a1111,20110217,4560,4551,4535,4570,4535,4535,4556,-16,5,10,455600,220
473,a1111,20110218,4535,4556,4535,4535,4535,4535,4535,-21,-21,2,90700,220
474,a1111,20110221,4535,4535,4530,4530,4503,4503,4517,-32,-18,8,361360,220
475,a1111,20110222,4503,4517,4503,4530,4490,4490,4508,-27,-9,42,1893480,212
476,a1111,20110223,4490,4508,4410,4411,4404,4404,4408,-104,-100,10,440800,218
477,a1111,20110224,4404,4408,4393,4393,4350,4350,4378,-58,-30,6,262720,218
478,a1111,20110225,4350,4378,4428,4428,4376,4400,4404,22,26,14,616680,222
479,a1111,20110228,4400,4404,4419,4440,4419,4440,4428,36,24,28,1239840,206
480,a1111,20110301,4440,4428,4420,4420,4420,4420,4420,-8,-8,2,88400,206
481,a1111,20110302,4420,4420,4431,4553,4431,4553,4467,133,47,36,1608320,204
482,a1111,20110303,4553,4467,4486,4486,4486,4486,4486,19,19,2,89720,202
483,a1111,20110304,4486,4486,4454,4581,4454,4457,4488,-29,2,20,897600,204
484,a1111,20110307,4457,4488,0,0,0,4488,4488,0,0,0,0,204
485,a1111,20110308,4488,4488,4488,4488,4431,4431,4467,-57,-21,28,1250880,192
486,a1111,20110309,4431,4467,4440,4440,4440,4440,4440,-27,-27,8,355200,196
487,a1111,20110310,4440,4440,4425,4425,4380,4380,4405,-60,-35,46,2026320,216
488,a1111,20110311,4380,4405,4361,4400,4361,4361,4373,-44,-32,18,787300,216
489,a1111,20110314,4361,4373,4463,4463,4370,4370,4404,-3,31,18,792840,214
490,a1111,20110315,4370,4404,4410,4430,4365,4430,4404,26,0,30,1321260,200
491,a1111,20110316,4430,4404,0,0,0,4404,4404,0,0,0,0,200
492,a1111,20110317,4404,4404,4420,4481,4415,4425,4430,21,26,26,1151980,200
493,a1111,20110318,4425,4430,0,0,0,4430,4430,0,0,0,0,200
494,a1111,20110321,4430,4430,4435,4441,4435,4441,4438,11,8,4,177520,198
495,a1111,20110322,4441,4438,4502,4502,4481,4481,4491,43,53,4,179660,198
496,a1111,20110323,4481,4491,0,0,0,4491,4491,0,0,0,0,198
497,a1111,20110324,4491,4491,4510,4510,4480,4480,4487,-11,-4,8,359000,198
498,a1111,20110325,4480,4487,4575,4581,4526,4538,4564,51,77,18,821680,208
499,a1111,20110328,4538,4564,4494,4600,4494,4581,4571,17,7,166,7588480,250
500,a1111,20110329,4581,4571,4615,4615,4555,4590,4580,19,9,58,2656500,264
501,a1111,20110330,4590,4580,4566,4583,4550,4550,4573,-30,-7,24,1097740,250
502,a1111,20110331,4550,4573,4570,4570,4550,4550,4560,-23,-13,8,364800,252
503,a1111,20110401,4550,4560,4590,4598,4551,4551,4584,-9,24,42,1925340,278
504,a1111,20110406,4551,4584,0,0,0,4584,4584,0,0,0,0,278
505,a1111,20110407,4584,4584,4628,4628,4560,4560,4588,-24,4,16,734220,288
506,a1111,20110408,4560,4588,4540,4580,4537,4572,4560,-16,-28,24,1094560,288
507,a1111,20110411,4572,4560,4624,4635,4590,4590,4621,30,61,92,4251400,278
508,a1111,20110412,4590,4621,4574,4574,4550,4550,4559,-71,-62,32,1459160,268
509,a1111,20110413,4550,4559,4529,4529,4506,4529,4523,-30,-36,8,361860,266
510,a1111,20110414,4529,4523,4496,4499,4470,4470,4494,-53,-29,26,1168520,250
511,a1111,20110415,4470,4494,4460,4460,4460,4460,4460,-34,-34,2,89200,250
512,a1111,20110418,4460,4460,0,0,0,4460,4460,0,0,0,0,250
513,a1111,20110419,4460,4460,4486,4490,4479,4488,4485,28,25,10,448580,246
514,a1111,20110420,4488,4485,4515,4574,4490,4510,4523,25,38,86,3890580,268
515,a1111,20110421,4510,4523,4500,4500,4471,4471,4497,-52,-26,38,1709060,284
516,a1111,20110422,4471,4497,4555,4555,4494,4499,4510,2,13,26,1172840,276
517,a1111,20110425,4499,4510,4481,4481,4481,4481,4481,-29,-29,2,89620,276
518,a1111,20110426,4481,4481,4482,4482,4450,4450,4460,-31,-21,6,267640,276
519,a1111,20110427,4450,4460,4460,4483,4418,4450,4440,-10,-20,70,3108300,292
520,a1111,20110428,4450,4440,4450,4450,4450,4450,4450,10,10,2,89000,290
521,a1111,20110429,4450,4450,4450,4450,4371,4382,4388,-68,-62,22,965460,296
522,a1111,20110503,4382,4388,4430,4430,4371,4405,4392,17,4,32,1405720,290
523,a1111,20110504,4405,4392,4388,4395,4323,4323,4378,-69,-14,52,2277060,288
524,a1111,20110505,4323,4378,4347,4369,4347,4360,4357,-18,-21,14,610000,294
525,a1111,20110506,4360,4357,4299,4329,4270,4270,4303,-87,-54,10,430380,298
526,a1111,20110509,4270,4303,4239,4290,4239,4285,4271,-18,-32,6,256280,298
527,a1111,20110510,4285,4271,4300,4300,4300,4300,4300,29,29,2,86000,296
528,a1111,20110511,4300,4300,4330,4330,4330,4330,4330,30,30,2,86600,296
529,a1111,20110512,4330,4330,4321,4335,4305,4305,4320,-25,-10,10,432020,296
530,a1111,20110513,4305,4320,4290,4290,4290,4290,4290,-30,-30,2,85800,296
531,a1111,20110516,4290,4290,4320,4320,4290,4290,4314,0,24,10,431400,298
532,a1111,20110517,4290,4314,4280,4280,4280,4280,4280,-34,-34,2,85600,298
533,a1111,20110518,4280,4280,4290,4305,4280,4280,4290,0,10,12,514900,290
534,a1111,20110519,4280,4290,4376,4376,4300,4300,4327,10,37,10,432720,288
535,a1111,20110520,4300,4327,0,0,0,4327,4327,0,0,0,0,288
536,a1111,20110523,4327,4327,4343,4343,4300,4300,4321,-27,-6,6,259260,286
537,a1111,20110524,4300,4321,4322,4332,4322,4332,4325,11,4,6,259520,284
538,a1111,20110525,4332,4325,0,0,0,4325,4325,0,0,0,0,284
539,a1111,20110526,4325,4325,4388,4388,4350,4376,4374,51,49,34,1487420,302
540,a1111,20110527,4376,4374,4360,4370,4360,4360,4360,-14,-14,26,1133800,302
541,a1111,20110530,4360,4360,4387,4387,4341,4369,4365,9,5,24,1047720,308
542,a1111,20110531,4369,4365,4350,4350,4350,4350,4350,-15,-15,12,522000,318
543,a1111,20110601,4350,4350,4364,4365,4350,4361,4361,11,11,12,523340,318
544,a1111,20110602,4361,4361,4370,4380,4353,4380,4362,19,1,116,5061000,274
545,a1111,20110603,4380,4362,4399,4399,4399,4399,4399,37,37,6,263940,268
546,a1111,20110607,4399,4399,4362,4388,4362,4385,4378,-14,-21,12,525420,266
547,a1111,20110608,4385,4378,4421,4429,4368,4379,4392,1,14,20,878520,266
548,a1111,20110609,4379,4392,4398,4398,4388,4388,4390,-4,-2,34,1492720,246
549,a1111,20110610,4388,4390,4375,4389,4358,4358,4371,-32,-19,10,437160,246
550,a1111,20110613,4358,4371,0,0,0,4371,4371,0,0,0,0,246
551,a1111,20110614,4371,4371,0,0,0,4371,4371,0,0,0,0,246
552,a1111,20110615,4371,4371,0,0,0,4371,4371,0,0,0,0,246
553,a1111,20110616,4371,4371,4340,4340,4340,4340,4340,-31,-31,2,86800,246
554,a1111,20110617,4340,4340,4310,4310,4310,4310,4310,-30,-30,2,86200,246
555,a1111,20110620,4310,4310,4329,4329,4309,4315,4314,5,4,22,949180,236
556,a1111,20110621,4315,4314,4319,4319,4319,4319,4319,5,5,6,259140,230
557,a1111,20110622,4319,4319,4356,4356,4330,4330,4338,11,19,6,260320,230
558,a1111,20110623,4330,4338,4370,4370,4296,4296,4333,-42,-5,8,346640,234
559,a1111,20110624,4296,4333,4316,4325,4295,4325,4316,-8,-17,62,2676280,278
560,a1111,20110627,4325,4316,4280,4280,4280,4280,4280,-36,-36,2,85600,278
561,a1111,20110628,4280,4280,0,0,0,4280,4280,0,0,0,0,278
562,a1111,20110629,4280,4280,4356,4356,4332,4332,4335,52,55,14,606960,268
563,a1111,20110630,4332,4335,0,0,0,4335,4335,0,0,0,0,268
564,a1111,20110701,4335,4335,4300,4300,4300,4300,4300,-35,-35,2,86000,268
565,a1111,20110704,4300,4300,4336,4345,4336,4342,4340,42,40,26,1128440,248
566,a1111,20110705,4342,4340,0,0,0,4340,4340,0,0,0,0,248
567,a1111,20110706,4340,4340,4338,4338,4338,4338,4338,-2,-2,20,867600,228
568,a1111,20110707,4338,4338,4349,4349,4345,4345,4346,7,8,8,347680,222
569,a1111,20110708,4345,4346,0,0,0,4346,4346,0,0,0,0,222
570,a1111,20110711,4346,4346,4397,4400,4367,4367,4377,21,31,28,1225780,212
571,a1111,20110712,4367,4377,4350,4351,4343,4343,4349,-34,-28,10,434920,212
572,a1111,20110713,4343,4349,4373,4373,4373,4373,4373,24,24,2,87460,210
573,a1111,20110714,4373,4373,4382,4387,4382,4387,4385,14,12,22,964720,196
574,a1111,20110715,4387,4385,4399,4438,4387,4387,4406,2,21,18,793140,204
575,a1111,20110718,4387,4406,4369,4385,4350,4385,4372,-21,-34,22,961920,200
576,a1111,20110719,4385,4372,4360,4360,4330,4358,4339,-14,-33,12,520760,196
577,a1111,20110720,4358,4339,4370,4370,4352,4358,4360,19,21,6,261600,194
578,a1111,20110721,4358,4360,4359,4360,4359,4360,4359,0,-1,4,174380,192
579,a1111,20110722,4360,4359,4370,4370,4370,4370,4370,11,11,2,87400,194
580,a1111,20110725,4370,4370,4335,4335,4335,4335,4335,-35,-35,2,86700,194
581,a1111,20110726,4335,4335,0,0,0,4335,4335,0,0,0,0,194
582,a1111,20110727,4335,4335,0,0,0,4335,4335,0,0,0,0,194
583,a1111,20110728,4335,4335,4343,4350,4341,4350,4343,15,8,16,694940,190
584,a1111,20110729,4350,4343,4333,4333,4333,4333,4333,-10,-10,2,86660,188
585,a1111,20110801,4333,4333,0,0,0,4333,4333,0,0,0,0,188
586,a1111,20110802,4333,4333,0,0,0,4333,4333,0,0,0,0,188
587,a1111,20110803,4333,4333,4419,4419,4378,4378,4398,45,65,4,175940,190
588,a1111,20110804,4378,4398,4380,4380,4346,4346,4364,-52,-34,14,610960,192
589,a1111,20110805,4346,4364,4323,4323,4219,4279,4263,-85,-101,56,2387420,184
590,a1111,20110808,4279,4263,4202,4274,4202,4265,4240,2,-23,18,763360,186
591,a1111,20110809,4265,4240,4252,4291,4201,4213,4239,-27,-1,8,339140,186
592,a1111,20110810,4213,4239,4326,4326,4230,4230,4291,-9,52,6,257500,188
593,a1111,20110811,4230,4291,4227,4317,4227,4270,4269,-21,-22,48,2049560,156
594,a1111,20110812,4270,4269,4270,4328,4270,4296,4293,27,24,8,343480,160
595,a1111,20110815,4296,4293,0,0,0,4293,4293,0,0,0,0,160
596,a1111,20110816,4293,4293,4249,4289,4249,4285,4277,-8,-16,8,342160,156
597,a1111,20110817,4285,4277,4320,4320,4295,4295,4307,18,30,4,172300,156
598,a1111,20110818,4295,4307,0,0,0,4307,4307,0,0,0,0,156
599,a1111,20110819,4307,4307,4290,4290,4290,4290,4290,-17,-17,16,686400,154
600,a1111,20110822,4290,4290,0,0,0,4290,4290,0,0,0,0,154
601,a1111,20110823,4290,4290,4350,4350,4340,4350,4347,60,57,8,347800,158
602,a1111,20110824,4350,4347,4394,4394,4300,4305,4320,-42,-27,46,1987380,164
603,a1111,20110825,4305,4320,4285,4285,4270,4270,4279,-50,-41,12,513520,164
604,a1111,20110826,4270,4279,0,0,0,4279,4279,0,0,0,0,164
605,a1111,20110829,4279,4279,4370,4380,4370,4380,4375,101,96,20,875000,174
606,a1111,20110830,4380,4375,4450,4593,4336,4367,4405,-8,30,174,7664900,206
607,a1111,20110831,4367,4405,4393,4398,4385,4395,4390,-10,-15,16,702440,208
608,a1111,20110901,4395,4390,4380,4380,4362,4371,4367,-19,-23,60,2620680,182
609,a1111,20110902,4371,4367,4390,4390,4364,4364,4376,-3,9,14,612640,182
610,a1111,20110905,4364,4376,4406,4418,4360,4360,4401,-16,25,34,1496580,178
611,a1111,20110906,4360,4401,4333,4333,4296,4315,4308,-86,-93,10,430880,184
612,a1111,20110907,4315,4308,4347,4350,4312,4343,4336,35,28,36,1560960,182
613,a1111,20110908,4343,4336,4336,4368,4336,4344,4342,8,6,36,1563360,190
614,a1111,20110909,4344,4342,0,0,0,4342,4342,0,0,0,0,190
615,a1111,20110913,4342,4342,4301,4330,4277,4300,4299,-42,-43,22,945860,194
616,a1111,20110914,4300,4299,4271,4287,4241,4245,4266,-54,-33,22,938640,188
617,a1111,20110915,4245,4266,4250,4250,4250,4250,4250,-16,-16,94,3995000,96
618,a1111,20110916,4250,4250,4201,4250,4201,4250,4222,0,-28,18,760100,92
619,a1111,20110919,4250,4222,0,0,0,4222,4222,0,0,0,0,92
620,a1111,20110920,4222,4222,4185,4185,4185,4185,4185,-37,-37,2,83700,92
621,a1111,20110921,4185,4185,0,0,0,4185,4185,0,0,0,0,92
622,a1111,20110922,4185,4185,4140,4199,4130,4178,4168,-7,-17,40,1667260,94
623,a1111,20110923,4178,4168,4149,4160,4000,4065,4120,-103,-48,60,2472520,118
624,a1111,20110926,4065,4120,4090,4090,3980,3980,4011,-140,-109,318,12755320,296
625,a1111,20110927,3980,4011,4129,4129,4005,4075,4044,64,33,48,1941400,288
626,a1111,20110928,4075,4044,4021,4050,4020,4036,4036,-8,-8,124,5005240,380
627,a1111,20110929,4036,4036,3950,4055,3950,4020,4006,-16,-30,274,10977020,438
628,a1111,20110930,4020,4006,4021,4059,4021,4041,4038,35,32,26,1049980,450
629,a1111,20111010,4041,4038,3890,4070,3890,4069,4029,31,-9,68,2740140,474
630,a1111,20111011,4069,4029,4053,4096,4020,4096,4090,67,61,278,11371100,490
631,a1111,20111012,4096,4090,4177,4226,4145,4187,4179,97,89,26,1086780,488
632,a1111,20111013,4187,4179,4189,4189,4120,4164,4157,-15,-22,86,3575300,468
633,a1111,20111014,4164,4157,4179,4193,4136,4193,4171,36,14,164,6841160,468
634,a1111,20111017,4193,4171,4149,4190,4125,4140,4162,-31,-9,32,1332020,462
635,a1111,20111018,4140,4162,4150,4150,4076,4100,4141,-62,-21,106,4389560,458
636,a1111,20111019,4100,4141,4055,4130,4055,4085,4072,-56,-69,86,3502480,458
637,a1111,20111020,4085,4072,4048,4051,4018,4050,4040,-22,-32,142,5737500,492
638,a1111,20111021,4050,4040,4085,4120,4060,4082,4096,42,56,88,3605280,492
639,a1111,20111024,4082,4096,4000,4170,4000,4170,4104,74,8,106,4351000,500
640,a1111,20111025,4170,4104,4149,4150,4040,4045,4092,-59,-12,16,654840,502
641,a1111,20111026,4045,4092,4090,4093,4035,4055,4074,-37,-18,92,3748680,502
642,a1111,20111027,4055,4074,4050,4090,4022,4090,4049,16,-25,158,6398300,622
643,a1111,20111028,4090,4049,4080,4090,4049,4049,4064,0,15,268,10892840,706
644,a1111,20111031,4049,4064,4020,4021,4000,4000,4015,-64,-49,90,3613780,792
645,a1111,20111101,4000,4015,4025,4030,4003,4003,4016,-12,1,80,3212840,0
646,a1111,20111102,4003,4016,0,0,0,4016,4016,0,0,0,0,0
647,a1111,20111103,4016,4016,0,0,0,4016,4016,0,0,0,0,0
648,a1111,20111104,4016,4016,0,0,0,4016,4016,0,0,0,0,0
649,a1111,20111107,4016,4016,0,0,0,4016,4016,0,0,0,0,0
650,a1111,20111108,4016,4016,0,0,0,4016,4016,0,0,0,0,0
651,a1111,20111109,4016,4016,0,0,0,4016,4016,0,0,0,0,0
652,a1111,20111110,4016,4016,0,0,0,4016,4016,0,0,0,0,0
653,a1111,20111111,4016,4016,0,0,0,4016,4016,0,0,0,0,0
654,a1111,20111114,4016,4016,0,0,0,4016,4016,0,0,0,0,0
655,a1201,20110104,4505,4502,4491,4534,4491,4524,4516,22,14,82586,3730057700,224194
656,a1201,20110105,4524,4516,4500,4500,4463,4475,4480,-41,-36,84692,3794393960,232410
657,a1201,20110106,4475,4480,4500,4545,4500,4540,4529,60,49,112312,5086758140,237712
658,a1201,20110107,4540,4529,4500,4510,4423,4439,4475,-90,-54,138008,6175951640,242780
659,a1201,20110110,4439,4475,4452,4470,4432,4445,4456,-30,-19,85642,3816310840,243922
660,a1201,20110111,4445,4456,4471,4479,4443,4459,4459,3,3,84768,3780131120,236842
661,a1201,20110112,4459,4459,4448,4472,4435,4450,4454,-9,-5,125408,5585877320,238136
662,a1201,20110113,4450,4454,4550,4566,4502,4503,4519,49,65,124344,5620335440,230016
663,a1201,20110114,4503,4519,4501,4536,4493,4531,4519,12,0,105114,4750631700,231832
664,a1201,20110117,4531,4519,4530,4555,4518,4546,4538,27,19,155782,7070809380,243754
665,a1201,20110118,4546,4538,4540,4604,4529,4601,4565,63,27,263230,12018632140,265312
666,a1201,20110119,4601,4565,4601,4624,4588,4609,4609,44,44,241638,11137223260,284234
667,a1201,20110120,4609,4609,4590,4597,4558,4565,4575,-44,-34,163760,7492157440,283130
668,a1201,20110121,4565,4575,4550,4570,4519,4541,4551,-34,-24,111902,5093250540,276698
669,a1201,20110124,4541,4551,4554,4603,4548,4580,4582,29,31,165042,7563521860,278062
670,a1201,20110125,4580,4582,4555,4576,4525,4526,4547,-56,-35,98358,4472590700,277200
671,a1201,20110126,4526,4547,4496,4496,4402,4443,4440,-104,-107,134668,5980605560,272598
672,a1201,20110127,4443,4440,4474,4475,4438,4453,4454,13,14,70682,3148605080,269286
673,a1201,20110128,4453,4454,4450,4470,4438,4450,4454,-4,0,63512,2829388660,268180
674,a1201,20110131,4450,4454,4455,4498,4451,4489,4479,35,25,70966,3179260620,265128
675,a1201,20110201,4489,4479,4508,4517,4490,4516,4502,37,23,57864,2605421260,265718
676,a1201,20110209,4516,4502,4531,4598,4516,4591,4574,89,72,147266,6737100800,260242
677,a1201,20110210,4591,4574,4610,4681,4600,4646,4653,72,79,209642,9756605420,272682
678,a1201,20110211,4646,4653,4632,4692,4622,4669,4662,16,9,216196,10079294880,270754
679,a1201,20110214,4669,4662,4671,4706,4656,4682,4681,20,19,151160,7077107180,278920
680,a1201,20110215,4682,4681,4652,4665,4622,4633,4645,-48,-36,148576,6901796180,287692
681,a1201,20110216,4633,4645,4581,4615,4572,4614,4595,-31,-50,133734,6145932880,297958
682,a1201,20110217,4614,4595,4615,4635,4574,4576,4608,-19,13,132204,6092721440,295662
683,a1201,20110218,4576,4608,4623,4630,4581,4583,4608,-25,0,123416,5687670820,290840
684,a1201,20110221,4583,4608,4560,4580,4550,4553,4562,-55,-46,94268,4301421060,291002
685,a1201,20110222,4553,4562,4572,4597,4511,4575,4558,13,-4,129234,5890978240,287872
686,a1201,20110223,4575,4558,4440,4449,4400,4425,4430,-133,-128,136488,6047457400,287764
687,a1201,20110224,4425,4430,4445,4447,4361,4368,4404,-62,-26,127166,5601208020,287190
688,a1201,20110225,4368,4404,4383,4418,4378,4414,4400,10,-4,94384,4153061260,276856
689,a1201,20110228,4414,4400,4451,4463,4432,4450,4445,50,45,83708,3720880000,271956
690,a1201,20110301,4450,4445,4445,4464,4432,4453,4446,8,1,61416,2731131760,273276
691,a1201,20110302,4453,4446,4450,4575,4442,4553,4525,107,79,289912,13120798140,290962
692,a1201,20110303,4553,4525,4555,4555,4501,4506,4528,-19,3,156890,7104556580,286940
693,a1201,20110304,4506,4528,4550,4593,4521,4545,4549,17,21,220484,10030976720,285242
694,a1201,20110307,4545,4549,4531,4543,4508,4536,4529,-13,-20,84960,3848227360,285042
695,a1201,20110308,4536,4529,4500,4508,4441,4453,4475,-76,-54,117096,5241033500,284766
696,a1201,20110309,4453,4475,4463,4468,4438,4453,4454,-22,-21,76580,3411195180,279168
697,a1201,20110310,4453,4454,4425,4435,4402,4408,4419,-46,-35,81412,3598280720,278682
698,a1201,20110311,4408,4419,4416,4432,4392,4399,4413,-20,-6,68820,3037385640,277548
699,a1201,20110314,4399,4413,4390,4445,4370,4392,4401,-21,-12,145374,6398041120,278316
700,a1201,20110315,4392,4401,4403,4467,4384,4456,4435,55,34,250716,11120449440,301918
701,a1201,20110316,4456,4435,4380,4440,4380,4429,4411,-6,-24,233620,10306803880,305424
702,a1201,20110317,4429,4411,4429,4477,4408,4466,4448,55,37,201944,8982527840,311918
703,a1201,20110318,4466,4448,4496,4497,4459,4466,4474,18,26,152268,6812567160,304110
704,a1201,20110321,4466,4474,4480,4518,4461,4500,4494,26,20,229348,10307701480,309020
705,a1201,20110322,4500,4494,4494,4527,4485,4508,4512,14,18,192612,8691634480,314016
706,a1201,20110323,4508,4512,4513,4554,4507,4552,4537,40,25,197034,8941327620,317466
707,a1201,20110324,4552,4537,4541,4550,4501,4514,4526,-23,-11,151062,6838208640,310266
708,a1201,20110325,4514,4526,4527,4612,4526,4609,4584,83,58,330448,15149767520,337118
709,a1201,20110328,4609,4584,4604,4660,4574,4639,4625,55,41,651610,30142136420,380680
710,a1201,20110329,4639,4625,4619,4659,4603,4651,4633,26,8,560460,25970678080,410378
711,a1201,20110330,4651,4633,4660,4669,4610,4625,4635,-8,2,402524,18659325480,381244
712,a1201,20110331,4625,4635,4633,4650,4588,4610,4618,-25,-17,326380,15073594980,370812
713,a1201,20110401,4610,4618,4650,4659,4620,4635,4640,17,22,294540,13667499180,351632
714,a1201,20110406,4635,4640,4616,4674,4613,4670,4644,30,4,292128,13568489280,369762
715,a1201,20110407,4670,4644,4652,4666,4641,4649,4653,5,9,184194,8572087380,361580
716,a1201,20110408,4649,4653,4636,4656,4606,4654,4631,1,-22,292424,13542166780,359458
717,a1201,20110411,4654,4631,4684,4744,4674,4679,4705,48,74,542036,25507478560,430008
718,a1201,20110412,4679,4705,4632,4654,4613,4616,4632,-89,-73,312148,14460681500,393734
719,a1201,20110413,4616,4632,4575,4605,4575,4600,4590,-32,-42,284598,13065413200,392654
720,a1201,20110414,4600,4590,4584,4590,4531,4534,4562,-56,-28,264396,12064044520,384272
721,a1201,20110415,4534,4562,4556,4565,4525,4529,4547,-33,-15,219042,9961855760,359352
722,a1201,20110418,4529,4547,4520,4568,4505,4562,4548,15,1,262108,11922546120,378234
723,a1201,20110419,4562,4548,4565,4575,4540,4545,4554,-3,6,213548,9725746400,367640
724,a1201,20110420,4545,4554,4561,4582,4560,4579,4572,25,18,244278,11170448180,405398
725,a1201,20110421,4579,4572,4577,4580,4557,4563,4568,-9,-4,178426,8151692840,380266
726,a1201,20110422,4563,4568,4590,4593,4555,4573,4574,5,6,171572,7848315320,379768
727,a1201,20110425,4573,4574,4589,4590,4543,4553,4564,-21,-10,146452,6684953120,382010
728,a1201,20110426,4553,4564,4527,4541,4517,4517,4528,-47,-36,119958,5432593280,371606
729,a1201,20110427,4517,4528,4528,4543,4507,4516,4525,-12,-3,145702,6594054800,370974
730,a1201,20110428,4516,4525,4522,4548,4522,4544,4536,19,11,130726,5930005760,374842
731,a1201,20110429,4544,4536,4505,4508,4451,4458,4475,-78,-61,171006,7652666560,372664
732,a1201,20110503,4458,4475,4490,4494,4464,4475,4474,0,-1,84900,3799273760,370578
733,a1201,20110504,4475,4474,4453,4461,4419,4424,4434,-50,-40,135020,5987721400,382388
734,a1201,20110505,4424,4434,4412,4447,4396,4433,4428,-1,-6,188568,8350198700,395130
735,a1201,20110506,4433,4428,4390,4395,4350,4357,4370,-71,-58,213106,9313513400,386878
736,a1201,20110509,4357,4370,4380,4382,4366,4380,4374,10,4,92834,4061322680,383622
737,a1201,20110510,4380,4374,4378,4405,4375,4403,4391,29,17,132522,5819101520,382192
738,a1201,20110511,4403,4391,4408,4420,4394,4396,4405,5,14,130770,5760782280,384072
739,a1201,20110512,4396,4405,4397,4422,4360,4366,4397,-39,-8,211358,9295144980,388658
740,a1201,20110513,4366,4397,4396,4414,4382,4412,4397,15,0,168030,7389056820,389330
741,a1201,20110516,4412,4397,4400,4405,4386,4387,4393,-10,-4,107164,4708565220,383436
742,a1201,20110517,4387,4393,4381,4389,4326,4355,4355,-38,-38,178486,7774563040,393884
743,a1201,20110518,4355,4355,4380,4388,4364,4371,4376,16,21,124430,5445429420,400234
744,a1201,20110519,4371,4376,4405,4415,4389,4390,4400,14,24,134956,5938536260,401510
745,a1201,20110520,4390,4400,4395,4415,4389,4413,4404,13,4,146124,6435922620,401716
746,a1201,20110523,4413,4404,4425,4448,4407,4413,4427,9,23,168280,7451434260,382504
747,a1201,20110524,4413,4427,4420,4440,4413,4437,4424,10,-3,120116,5314008280,383772
748,a1201,20110525,4437,4424,4430,4449,4428,4436,4436,12,12,116152,5153632640,384612
749,a1201,20110526,4436,4436,4448,4465,4445,4462,4457,26,21,108412,4831993180,379774
750,a1201,20110527,4462,4457,4470,4473,4441,4454,4456,-3,-1,115210,5134436780,373342
751,a1201,20110530,4454,4456,4450,4472,4436,4460,4455,4,-1,178260,7942526520,375028
752,a1201,20110531,4460,4455,4465,4475,4446,4454,4458,-1,3,105376,4698558000,377928
753,a1201,20110601,4454,4458,4460,4464,4443,4448,4454,-10,-4,75168,3348310820,382446
754,a1201,20110602,4448,4454,4450,4479,4449,4478,4466,24,12,167340,7473956800,384834
755,a1201,20110603,4478,4466,4493,4519,4486,4518,4499,52,33,145932,6566231620,377990
756,a1201,20110607,4518,4499,4489,4489,4466,4475,4477,-24,-22,110540,4949538160,348222
757,a1201,20110608,4475,4477,4488,4490,4460,4473,4476,-4,-1,92072,4121598700,346642
758,a1201,20110609,4473,4476,4486,4493,4471,4472,4483,-4,7,90492,4057565980,335136
759,a1201,20110610,4472,4483,4475,4479,4447,4459,4464,-24,-19,85372,3811419740,325930
760,a1201,20110613,4459,4464,4451,4468,4448,4463,4459,-1,-5,73118,3260863500,330906
761,a1201,20110614,4463,4459,4454,4470,4454,4469,4463,10,4,59878,2672849880,326426
762,a1201,20110615,4469,4463,4469,4469,4446,4458,4458,-5,-5,69470,3097592880,321806
763,a1201,20110616,4458,4458,4451,4460,4434,4437,4446,-21,-12,70578,3138265660,321362
764,a1201,20110617,4437,4446,4432,4432,4400,4407,4413,-39,-33,101962,4500365260,312964
765,a1201,20110620,4407,4413,4400,4406,4390,4394,4397,-19,-16,52748,2319805680,311832
766,a1201,20110621,4394,4397,4405,4419,4403,4417,4410,20,13,42842,1889446400,308600
767,a1201,20110622,4417,4410,4420,4430,4412,4418,4419,8,9,51544,2278182080,310652
768,a1201,20110623,4418,4419,4414,4414,4379,4396,4391,-23,-28,54738,2403966940,307070
769,a1201,20110624,4396,4391,4388,4423,4376,4416,4407,25,16,78042,3439580800,311360
770,a1201,20110627,4416,4407,4403,4414,4380,4391,4395,-16,-12,106434,4678621900,320604
771,a1201,20110628,4391,4395,4410,4430,4404,4414,4416,19,21,107512,4748720460,335036
772,a1201,20110629,4414,4416,4430,4430,4418,4421,4424,5,8,54054,2391411860,334814
773,a1201,20110630,4421,4424,4420,4435,4418,4432,4428,8,4,71644,3172840160,331286
774,a1201,20110701,4432,4428,4398,4409,4392,4404,4402,-24,-26,60458,2661493760,321244
775,a1201,20110704,4404,4402,4413,4440,4412,4434,4427,32,25,89452,3960447260,307340
776,a1201,20110705,4434,4427,4437,4452,4427,4440,4439,13,12,85984,3816948100,292034
777,a1201,20110706,4440,4439,4437,4444,4421,4423,4430,-16,-9,50196,2223843000,284112
778,a1201,20110707,4423,4430,4419,4433,4419,4428,4427,-2,-3,36552,1618266660,279220
779,a1201,20110708,4428,4427,4443,4460,4441,4460,4451,33,24,85366,3799864120,266156
780,a1201,20110711,4460,4451,4462,4470,4455,4456,4460,5,9,44174,1970189600,267296
781,a1201,20110712,4456,4460,4457,4458,4410,4440,4440,-20,-20,52296,2322154860,247160
782,a1201,20110713,4440,4440,4453,4476,4453,4474,4468,34,28,76246,3407387960,209428
783,a1201,20110714,4474,4468,4500,4500,4473,4478,4484,10,16,48708,2184262060,204234
784,a1201,20110715,4478,4484,4475,4476,4463,4466,4470,-18,-14,30604,1368171200,202032
785,a1201,20110718,4466,4470,4470,4475,4446,4448,4464,-22,-6,37020,1652639420,198436
786,a1201,20110719,4448,4464,4454,4454,4432,4453,4446,-11,-18,19892,884462460,195712
787,a1201,20110720,4453,4446,4453,4458,4440,4455,4450,9,4,16570,737508140,192778
788,a1201,20110721,4455,4450,4448,4462,4443,4455,4455,5,5,30936,1378258240,179230
789,a1201,20110722,4455,4455,4459,4460,4452,4453,4454,-2,-1,10736,478286260,174464
790,a1201,20110725,4453,4454,4444,4444,4416,4418,4425,-36,-29,27712,1226389320,160314
791,a1201,20110726,4418,4425,4422,4430,4416,4430,4424,5,-1,9432,417288440,159696
792,a1201,20110727,4430,4424,4438,4455,4435,4447,4445,23,21,18508,822791340,160210
793,a1201,20110728,4447,4445,4434,4437,4426,4431,4433,-14,-12,7180,318314440,156956
794,a1201,20110729,4431,4433,4440,4446,4421,4427,4433,-6,0,12540,556019820,152990
795,a1201,20110801,4427,4433,4435,4466,4430,4463,4445,30,12,14932,663763880,154736
796,a1201,20110802,4463,4445,4455,4468,4444,4455,4456,10,11,18828,839128860,153088
797,a1201,20110803,4455,4456,4468,4478,4451,4453,4465,-3,9,18862,842329220,149018
798,a1201,20110804,4453,4465,4461,4461,4426,4429,4442,-36,-23,22242,988143560,144266
799,a1201,20110805,4429,4442,4396,4396,4306,4359,4363,-83,-79,56608,2470036600,113206
800,a1201,20110808,4359,4363,4347,4364,4321,4347,4345,-16,-18,16448,714766460,105360
801,a1201,20110809,4347,4345,4306,4332,4290,4327,4316,-18,-29,36168,1561272860,88804
802,a1201,20110810,4327,4316,4352,4355,4325,4336,4338,20,22,9304,403664600,86930
803,a1201,20110811,4336,4338,4328,4359,4320,4350,4346,12,8,7748,336753900,85520
804,a1201,20110812,4350,4346,4360,4376,4355,4358,4367,12,21,4614,201517520,84846
805,a1201,20110815,4358,4367,4370,4408,4370,4398,4396,31,29,7620,335015320,85414
806,a1201,20110816,4398,4396,4403,4404,4366,4366,4380,-30,-16,7440,325901840,83140
807,a1201,20110817,4366,4380,4379,4391,4373,4376,4379,-4,-1,5560,243493400,82178
808,a1201,20110818,4376,4379,4382,4391,4372,4375,4380,-4,1,4170,182685680,81024
809,a1201,20110819,4375,4380,4360,4371,4342,4365,4362,-15,-18,6584,287196680,77798
810,a1201,20110822,4365,4362,4383,4396,4375,4375,4386,13,24,5926,259929880,77896
811,a1201,20110823,4375,4386,4390,4408,4390,4403,4399,17,13,6370,280224180,78778
812,a1201,20110824,4403,4399,4408,4408,4386,4390,4391,-9,-8,6582,289063220,80034
813,a1201,20110825,4390,4391,4395,4395,4373,4381,4381,-10,-10,3612,158255280,79646
814,a1201,20110826,4381,4381,4386,4390,4365,4369,4376,-12,-5,2650,115987280,79342
815,a1201,20110829,4369,4376,4410,4484,4405,4475,4437,99,61,27234,1208527700,77318
816,a1201,20110830,4475,4437,4452,4498,4452,4467,4478,30,41,12746,570883480,75904
817,a1201,20110831,4467,4478,4480,4496,4471,4481,4485,3,7,8364,375155480,74836
818,a1201,20110901,4481,4485,4486,4497,4463,4471,4480,-14,-5,5330,238812880,74394
819,a1201,20110902,4471,4480,4460,4475,4454,4470,4463,-10,-17,6354,283614720,76596
820,a1201,20110905,4470,4463,4466,4546,4449,4453,4507,-10,44,14210,640567780,76518
821,a1201,20110906,4453,4507,4410,4457,4408,4445,4425,-62,-82,10904,482597800,71314
822,a1201,20110907,4445,4425,4455,4488,4448,4487,4461,62,36,6248,278771300,73242
823,a1201,20110908,4487,4461,4481,4481,4451,4464,4464,3,3,3064,136777600,73176
824,a1201,20110909,4464,4464,4464,4486,4453,4485,4471,21,7,4458,199341360,73292
825,a1201,20110913,4485,4471,4412,4438,4388,4391,4402,-80,-69,10738,472743380,67038
826,a1201,20110914,4391,4402,4392,4408,4352,4356,4368,-46,-34,9136,399095880,62536
827,a1201,20110915,4356,4368,4363,4370,4345,4353,4361,-15,-7,3264,142347480,61782
828,a1201,20110916,4353,4361,4343,4354,4317,4352,4337,-9,-24,4240,183908900,60868
829,a1201,20110919,4352,4337,4347,4347,4287,4292,4310,-45,-27,9716,418835020,56598
830,a1201,20110920,4292,4310,4298,4319,4298,4310,4309,0,-1,2626,113174560,56490
831,a1201,20110921,4310,4309,4285,4315,4280,4306,4293,-3,-16,2980,127943160,56138
832,a1201,20110922,4306,4293,4260,4281,4246,4259,4263,-34,-30,11164,476001340,52762
833,a1201,20110923,4259,4263,4205,4235,4050,4097,4153,-166,-110,21956,911987000,43098
834,a1201,20110926,4097,4153,4100,4113,4029,4035,4077,-118,-76,16176,659544260,42430
835,a1201,20110927,4035,4077,4080,4157,4078,4137,4114,60,37,4638,190830840,42400
836,a1201,20110928,4137,4114,4115,4122,4088,4115,4099,1,-15,5910,242302600,41966
837,a1201,20110929,4115,4099,4050,4065,3980,4044,4032,-55,-67,5188,209183300,40698
838,a1201,20110930,4044,4032,4067,4117,4060,4108,4084,76,52,4390,179330000,38990
839,a1201,20111010,4108,4084,4099,4134,4011,4088,4095,4,11,2614,107050280,39014
840,a1201,20111011,4088,4095,4112,4132,4090,4105,4113,10,18,3726,153276080,39586
841,a1201,20111012,4105,4113,4180,4180,4127,4159,4152,46,39,2432,100985440,39310
842,a1201,20111013,4159,4152,4161,4171,4148,4166,4160,14,8,1272,52920220,39072
843,a1201,20111014,4166,4160,4178,4183,4164,4174,4173,14,13,1142,47656800,38966
844,a1201,20111017,4174,4173,4179,4182,4144,4146,4159,-27,-14,764,31782040,38758
845,a1201,20111018,4146,4159,4122,4128,4078,4099,4106,-60,-53,1504,61768280,38782
846,a1201,20111019,4099,4106,4120,4142,4084,4100,4110,-6,4,1446,59441740,38654
847,a1201,20111020,4100,4110,4037,4051,4013,4043,4034,-67,-76,4142,167118920,38714
848,a1201,20111021,4043,4034,4051,4077,4051,4074,4066,40,32,768,31227040,38574
849,a1201,20111024,4074,4066,4121,4135,4050,4127,4101,61,35,1024,42001500,38492
850,a1201,20111025,4127,4101,4141,4150,4116,4128,4131,27,30,804,33216960,38464
851,a1201,20111026,4128,4131,4118,4142,4101,4132,4120,1,-11,1116,45984640,38458
852,a1201,20111027,4132,4120,4102,4157,4102,4154,4142,34,22,1280,53022580,38488
853,a1201,20111028,4154,4142,4163,4180,4135,4135,4160,-7,18,858,35695900,38452
854,a1201,20111031,4135,4160,4150,4150,4084,4088,4101,-72,-59,464,19029400,38488
855,a1201,20111101,4088,4101,4109,4126,4089,4107,4109,6,8,434,17834060,38458
856,a1201,20111102,4107,4109,4086,4132,4081,4132,4107,23,-2,290,11912740,38462
857,a1201,20111103,4132,4107,4122,4130,4101,4106,4115,-1,8,380,15640560,38382
858,a1201,20111104,4106,4115,4133,4145,4130,4137,4138,22,23,354,14651400,38396
859,a1201,20111107,4137,4138,4121,4128,4112,4113,4119,-25,-19,540,22247480,38388
860,a1201,20111108,4113,4119,4100,4110,4086,4103,4100,-16,-19,254,10416160,38438
861,a1201,20111109,4103,4100,4121,4121,4093,4099,4101,-1,1,410,16817460,38412
862,a1201,20111110,4099,4101,4057,4057,4030,4032,4043,-69,-58,596,24102200,38404
863,a1201,20111111,4032,4043,4043,4051,4026,4051,4043,8,0,194,7845060,38340
864,a1201,20111114,4051,4043,4059,4072,4050,4070,4063,27,20,232,9426340,38306
865,a1201,20111115,4070,4063,4092,4092,4051,4080,4071,17,8,154,6270040,38306
866,a1201,20111116,4080,4071,4085,4091,4057,4064,4071,-7,0,554,22554020,38080
867,a1201,20111117,4064,4071,4060,4089,4055,4085,4060,14,-11,8682,352552520,37920
868,a1201,20111118,4085,4060,4062,4078,4058,4078,4066,18,6,722,29361000,37720
869,a1201,20111121,4078,4066,4077,4085,4067,4070,4073,4,7,1004,40901940,37528
870,a1201,20111122,4070,4073,4042,4077,4042,4058,4064,-15,-9,502,20404400,37502
871,a1201,20111123,4058,4064,4058,4072,4032,4052,4051,-12,-13,646,26173360,37308
872,a1201,20111124,4052,4051,4030,4051,4014,4035,4035,-16,-16,1412,56977080,36826
873,a1201,20111125,4035,4035,4035,4035,4002,4005,4008,-30,-27,358,14349440,36826
874,a1201,20111128,4005,4008,4020,4020,4001,4006,4010,-2,2,496,19891760,36806
875,a1201,20111129,4006,4010,4024,4040,4013,4033,4025,23,15,2406,96847700,37038
876,a1201,20111130,4033,4025,4024,4037,4005,4008,4019,-17,-6,528,21224180,36972
877,a1201,20111201,4008,4019,4019,4058,4019,4058,4039,39,20,1486,60034000,36964
878,a1201,20111202,4058,4039,4039,4055,4038,4048,4045,9,6,240,9710100,36936
879,a1201,20111205,4048,4045,4048,4057,4044,4056,4048,11,3,466,18866220,36982
880,a1201,20111206,4056,4048,4039,4049,4039,4045,4040,-3,-8,180,7273220,36964
881,a1201,20111207,4045,4040,4056,4058,4048,4054,4054,14,14,240,9731540,36958
882,a1201,20111208,4054,4054,4054,4054,4021,4028,4028,-26,-26,2868,115534560,36880
883,a1201,20111209,4028,4028,4024,4044,4024,4040,4037,12,9,226,9123680,36862
884,a1201,20111212,4040,4037,4012,4027,4011,4013,4018,-24,-19,514,20653240,36816
885,a1201,20111213,4013,4018,4014,4037,4014,4031,4029,13,11,400,16117640,36752
886,a1201,20111214,4031,4029,4042,4068,4038,4040,4049,11,20,476,19275080,36690
887,a1201,20111215,4040,4049,4019,4066,4010,4046,4042,-3,-7,902,36465300,36422
888,a1201,20111216,4046,4042,4067,4068,4043,4052,4050,10,8,184,7453660,36410
889,a1201,20111219,4052,4050,4047,4062,4039,4060,4056,10,6,1804,73184700,34622
890,a1201,20111220,4060,4056,4041,4055,4041,4043,4044,-13,-12,546,22084380,34286
891,a1201,20111221,4043,4044,4050,4050,4040,4043,4045,-1,1,272,11004440,34146
892,a1201,20111222,4043,4045,4033,4049,4013,4049,4038,4,-7,646,26090820,34060
893,a1201,20111223,4049,4038,4036,4050,4034,4036,4040,-2,2,212,8566540,34130
894,a1201,20111226,4036,4040,4035,4056,4035,4050,4050,10,10,970,39289260,33458
895,a1201,20111227,4050,4050,4041,4058,4041,4052,4054,2,4,532,21569000,33286
896,a1201,20111228,4052,4054,4055,4075,4055,4068,4065,14,11,366,14879580,33280
897,a1201,20111229,4068,4065,4069,4082,4056,4074,4075,9,10,380,15485920,33274
898,a1201,20111230,4074,4075,4079,4084,4032,4070,4065,-5,-10,658,26750040,33184
899,a1203,20110104,4537,4537,0,0,0,4537,4537,0,0,0,0,116
900,a1203,20110105,4537,4537,4515,4559,4515,4538,4537,1,0,6,272240,116
901,a1203,20110106,4538,4537,4570,4570,4570,4570,4570,33,33,4,182800,112
902,a1203,20110107,4570,4570,0,0,0,4570,4570,0,0,0,0,112
903,a1203,20110110,4570,4570,4527,4527,4527,4527,4527,-43,-43,2,90540,112
904,a1203,20110111,4527,4527,4515,4515,4515,4515,4515,-12,-12,2,90300,112
905,a1203,20110112,4515,4515,0,0,0,4515,4515,0,0,0,0,112
906,a1203,20110113,4515,4515,4593,4593,4548,4548,4570,33,55,4,182820,114
907,a1203,20110114,4548,4570,0,0,0,4570,4570,0,0,0,0,114
908,a1203,20110117,4570,4570,0,0,0,4570,4570,0,0,0,0,114
909,a1203,20110118,4570,4570,4581,4581,4581,4581,4581,11,11,2,91620,116
910,a1203,20110119,4581,4581,4634,4634,4634,4634,4634,53,53,4,185360,116
911,a1203,20110120,4634,4634,4593,4619,4593,4619,4609,-15,-25,12,553140,116
912,a1203,20110121,4619,4609,4566,4623,4566,4588,4586,-21,-23,12,550340,122
913,a1203,20110124,4588,4586,4609,4615,4591,4615,4606,29,20,8,368500,116
914,a1203,20110125,4615,4606,0,0,0,4606,4610,0,4,2,92200,114
915,a1203,20110126,4606,4610,4521,4521,4470,4491,4519,-119,-91,20,903840,112
916,a1203,20110127,4491,4519,4499,4499,4499,4499,4499,-20,-20,8,359920,112
917,a1203,20110128,4499,4499,0,0,0,4499,4499,0,0,0,0,112
918,a1203,20110131,4499,4499,0,0,0,4499,4499,0,0,0,0,112
919,a1203,20110201,4499,4499,0,0,0,4499,4499,0,0,0,0,112
920,a1203,20110209,4499,4499,0,0,0,4499,4499,0,0,0,0,112
921,a1203,20110210,4499,4499,0,0,0,4499,4499,0,0,0,0,112
922,a1203,20110211,4499,4499,4693,4739,4660,4700,4699,201,200,50,2349540,124
923,a1203,20110214,4700,4699,4681,4716,4681,4716,4701,17,2,10,470180,118
924,a1203,20110215,4716,4701,4682,4683,4681,4683,4682,-18,-19,16,749120,116
925,a1203,20110216,4683,4682,4660,4660,4632,4632,4645,-50,-37,20,929180,120
926,a1203,20110217,4632,4645,4655,4726,4646,4646,4670,1,25,14,653840,120
927,a1203,20110218,4646,4670,4650,4650,4633,4633,4641,-37,-29,4,185660,120
928,a1203,20110221,4633,4641,4577,4605,4577,4605,4591,-36,-50,4,183640,122
929,a1203,20110222,4605,4591,4665,4665,4580,4580,4627,-11,36,54,2498640,140
930,a1203,20110223,4580,4627,4490,4490,4471,4471,4477,-156,-150,14,626860,150
931,a1203,20110224,4471,4477,4410,4410,4410,4410,4410,-67,-67,2,88200,150
932,a1203,20110225,4410,4410,4400,4446,4400,4446,4423,36,13,4,176920,150
933,a1203,20110228,4446,4423,0,0,0,4423,4423,0,0,0,0,150
934,a1203,20110301,4423,4423,4456,4520,4456,4520,4484,97,61,18,807140,144
935,a1203,20110302,4520,4484,4471,4558,4471,4558,4509,74,25,14,631260,138
936,a1203,20110303,4558,4509,4547,4547,4547,4547,4547,38,38,2,90940,136
937,a1203,20110304,4547,4547,4586,4653,4545,4590,4592,43,45,10,459280,142
938,a1203,20110307,4590,4592,0,0,0,4592,4592,0,0,0,0,142
939,a1203,20110308,4592,4592,4505,4511,4467,4511,4492,-81,-100,10,449260,140
940,a1203,20110309,4511,4492,4487,4496,4487,4487,4490,-5,-2,10,449040,140
941,a1203,20110310,4487,4490,4433,4433,4433,4433,4433,-57,-57,2,88660,140
942,a1203,20110311,4433,4433,4427,4427,4427,4427,4427,-6,-6,2,88540,140
943,a1203,20110314,4427,4427,4410,4410,4410,4410,4410,-17,-17,2,88200,140
944,a1203,20110315,4410,4410,4426,4527,4426,4527,4473,117,63,8,357860,140
945,a1203,20110316,4527,4473,4418,4458,4418,4458,4434,-15,-39,26,1152960,144
946,a1203,20110317,4458,4434,0,0,0,4434,4434,0,0,0,0,144
947,a1203,20110318,4434,4434,4473,4510,4473,4480,4491,46,57,8,359340,142
948,a1203,20110321,4480,4491,4548,4548,4509,4541,4535,50,44,8,362840,138
949,a1203,20110322,4541,4535,4514,4520,4514,4520,4517,-15,-18,4,180680,138
950,a1203,20110323,4520,4517,4513,4611,4513,4605,4561,88,44,38,1733460,156
951,a1203,20110324,4605,4561,4550,4550,4550,4550,4550,-11,-11,4,182000,152
952,a1203,20110325,4550,4550,0,0,0,4550,4550,0,0,0,0,152
953,a1203,20110328,4550,4550,4708,4708,4641,4662,4664,112,114,46,2145700,154
954,a1203,20110329,4662,4664,4650,4704,4650,4670,4669,6,5,56,2614800,160
955,a1203,20110330,4670,4669,4669,4689,4630,4640,4662,-29,-7,58,2704020,170
956,a1203,20110331,4640,4662,4685,4698,4630,4647,4653,-15,-9,34,1582020,162
957,a1203,20110401,4647,4653,4643,4675,4641,4668,4659,15,6,48,2236480,154
958,a1203,20110406,4668,4659,4690,4709,4641,4709,4671,50,12,486,22702580,260
959,a1203,20110407,4709,4671,4713,4713,4665,4685,4687,14,16,40,1874840,262
960,a1203,20110408,4685,4687,4680,4692,4680,4690,4689,3,2,24,1125400,262
961,a1203,20110411,4690,4689,4729,4775,4729,4744,4747,55,58,18,854620,266
962,a1203,20110412,4744,4747,4676,4683,4668,4668,4678,-79,-69,28,1310040,256
963,a1203,20110413,4668,4678,4669,4669,4617,4653,4639,-25,-39,30,1391960,244
964,a1203,20110414,4653,4639,4669,4669,4591,4600,4616,-39,-23,28,1292640,240
965,a1203,20110415,4600,4616,4590,4594,4585,4594,4589,-22,-27,36,1652380,230
966,a1203,20110418,4594,4589,0,0,0,4589,4589,0,0,0,0,230
967,a1203,20110419,4589,4589,0,0,0,4589,4589,0,0,0,0,230
968,a1203,20110420,4589,4589,4602,4620,4602,4615,4612,26,23,8,369020,232
969,a1203,20110421,4615,4612,4611,4616,4608,4611,4610,-1,-2,22,1014340,228
970,a1203,20110422,4611,4610,4612,4616,4609,4616,4612,6,2,12,553540,226
971,a1203,20110425,4616,4612,4577,4610,4577,4610,4593,-2,-19,4,183740,226
972,a1203,20110426,4610,4593,0,0,0,4593,4593,0,0,0,0,226
973,a1203,20110427,4593,4593,4570,4580,4570,4570,4572,-23,-21,8,365800,234
974,a1203,20110428,4570,4572,4590,4590,4585,4585,4588,13,16,8,367060,238
975,a1203,20110429,4585,4588,4505,4549,4505,4527,4526,-61,-62,28,1267340,234
976,a1203,20110503,4527,4526,4507,4530,4507,4529,4519,3,-7,74,3344740,210
977,a1203,20110504,4529,4519,4495,4495,4480,4483,4486,-36,-33,32,1435740,184
978,a1203,20110505,4483,4486,4463,4509,4463,4483,4476,-3,-10,12,537160,190
979,a1203,20110506,4483,4476,4415,4416,4411,4411,4414,-65,-62,32,1412740,176
980,a1203,20110509,4411,4414,4418,4418,4407,4407,4415,-7,1,8,353220,174
981,a1203,20110510,4407,4415,4443,4450,4443,4450,4444,35,29,14,622220,174
982,a1203,20110511,4450,4444,0,0,0,4444,4444,0,0,0,0,174
983,a1203,20110512,4444,4444,4444,4460,4435,4435,4447,-9,3,8,355780,174
984,a1203,20110513,4435,4447,0,0,0,4447,4447,0,0,0,0,174
985,a1203,20110516,4447,4447,4372,4452,4372,4420,4415,-27,-32,38,1677800,186
986,a1203,20110517,4420,4415,4420,4420,4409,4409,4413,-6,-2,22,971040,186
987,a1203,20110518,4409,4413,4414,4418,4409,4418,4414,5,1,8,353120,186
988,a1203,20110519,4418,4414,4468,4468,4443,4443,4455,29,41,4,178220,186
989,a1203,20110520,4443,4455,0,0,0,4455,4455,0,0,0,0,186
990,a1203,20110523,4455,4455,0,0,0,4455,4455,0,0,0,0,186
991,a1203,20110524,4455,4455,4446,4484,4446,4484,4466,29,11,22,982520,186
992,a1203,20110525,4484,4466,4480,4480,4470,4480,4476,14,10,6,268600,186
993,a1203,20110526,4480,4476,4439,4507,4439,4500,4487,24,11,18,807760,188
994,a1203,20110527,4500,4487,4499,4510,4481,4510,4496,23,9,6,269800,188
995,a1203,20110530,4510,4496,4508,4508,4508,4508,4508,12,12,6,270480,194
996,a1203,20110531,4508,4508,0,0,0,4508,4508,0,0,0,0,194
997,a1203,20110601,4508,4508,0,0,0,4508,4508,0,0,0,0,194
998,a1203,20110602,4508,4508,0,0,0,4508,4508,0,0,0,0,194
999,a1203,20110603,4508,4508,4550,4559,4538,4559,4550,51,42,26,1183140,190
1000,a1203,20110607,4559,4550,4549,4549,4540,4541,4544,-9,-6,10,454420,186
1001,a1203,20110608,4541,4544,0,0,0,4544,4544,0,0,0,0,186
1002,a1203,20110609,4544,4544,0,0,0,4544,4544,0,0,0,0,186
1003,a1203,20110610,4544,4544,0,0,0,4544,4544,0,0,0,0,186
1004,a1203,20110613,4544,4544,4512,4520,4505,4520,4514,-24,-30,32,1444560,170
1005,a1203,20110614,4520,4514,0,0,0,4514,4514,0,0,0,0,170
1006,a1203,20110615,4514,4514,0,0,0,4514,4514,0,0,0,0,170
1007,a1203,20110616,4514,4514,0,0,0,4514,4514,0,0,0,0,170
1008,a1203,20110617,4514,4514,0,0,0,4514,4514,0,0,0,0,170
1009,a1203,20110620,4514,4514,0,0,0,4514,4514,0,0,0,0,170
1010,a1203,20110621,4514,4514,0,0,0,4514,4514,0,0,0,0,170
1011,a1203,20110622,4514,4514,0,0,0,4514,4514,0,0,0,0,170
1012,a1203,20110623,4514,4514,4425,4440,4425,4436,4434,-78,-80,54,2394440,144
1013,a1203,20110624,4436,4434,0,0,0,4434,4434,0,0,0,0,144
1014,a1203,20110627,4434,4434,4463,4463,4439,4439,4450,5,16,8,356040,144
1015,a1203,20110628,4439,4450,0,0,0,4450,4450,0,0,0,0,144
1016,a1203,20110629,4450,4450,4450,4491,4450,4491,4470,41,20,4,178820,144
1017,a1203,20110630,4491,4470,4469,4470,4463,4470,4467,0,-3,12,536060,132
1018,a1203,20110701,4470,4467,0,0,0,4467,4467,0,0,0,0,132
1019,a1203,20110704,4467,4467,0,0,0,4467,4467,0,0,0,0,132
1020,a1203,20110705,4467,4467,4490,4490,4490,4490,4490,23,23,2,89800,132
1021,a1203,20110706,4490,4490,4453,4519,4453,4471,4479,-19,-11,14,627060,132
1022,a1203,20110707,4471,4479,4446,4499,4446,4465,4467,-14,-12,24,1072220,132
1023,a1203,20110708,4465,4467,4528,4572,4501,4501,4569,34,102,164,7493360,288
1024,a1203,20110711,4501,4569,4520,4522,4520,4522,4521,-47,-48,4,180840,286
1025,a1203,20110712,4522,4521,4505,4505,4501,4501,4503,-20,-18,4,180120,288
1026,a1203,20110713,4501,4503,4526,4530,4516,4530,4517,27,14,180,8131960,146
1027,a1203,20110714,4530,4517,0,0,0,4517,4517,0,0,0,0,146
1028,a1203,20110715,4517,4517,4583,4583,4545,4545,4564,28,47,8,365120,146
1029,a1203,20110718,4545,4564,4550,4581,4550,4550,4557,-14,-7,66,3007940,140
1030,a1203,20110719,4550,4557,0,0,0,4557,4557,0,0,0,0,140
1031,a1203,20110720,4557,4557,4533,4533,4533,4533,4533,-24,-24,2,90660,142
1032,a1203,20110721,4533,4533,4528,4549,4528,4549,4538,16,5,4,181540,142
1033,a1203,20110722,4549,4538,0,0,0,4538,4538,0,0,0,0,142
1034,a1203,20110725,4538,4538,4532,4532,4503,4505,4514,-33,-24,12,541780,144
1035,a1203,20110726,4505,4514,4530,4530,4530,4530,4530,16,16,2,90600,144
1036,a1203,20110727,4530,4530,4590,4590,4530,4530,4550,0,20,6,273000,144
1037,a1203,20110728,4530,4550,0,0,0,4550,4550,0,0,0,0,144
1038,a1203,20110729,4550,4550,0,0,0,4550,4550,0,0,0,0,144
1039,a1203,20110801,4550,4550,4560,4560,4560,4560,4560,10,10,10,456000,144
1040,a1203,20110802,4560,4560,4567,4576,4567,4576,4571,16,11,30,1371500,168
1041,a1203,20110803,4576,4571,4590,4590,4585,4585,4589,14,18,14,642460,180
1042,a1203,20110804,4585,4589,4575,4575,4550,4550,4560,-39,-29,24,1094480,176
1043,a1203,20110805,4550,4560,4469,4469,4403,4438,4444,-122,-116,32,1422240,148
1044,a1203,20110808,4438,4444,4367,4367,4367,4367,4367,-77,-77,2,87340,146
1045,a1203,20110809,4367,4367,4359,4400,4359,4395,4373,28,6,30,1312020,156
1046,a1203,20110810,4395,4373,4419,4435,4419,4420,4425,47,52,14,619620,154
1047,a1203,20110811,4420,4425,4445,4445,4445,4445,4445,20,20,2,88900,156
1048,a1203,20110812,4445,4445,4515,4562,4447,4447,4484,2,39,28,1255680,156
1049,a1203,20110815,4447,4484,4498,4499,4491,4491,4496,7,12,6,269760,154
1050,a1203,20110816,4491,4496,0,0,0,4496,4496,0,0,0,0,154
1051,a1203,20110817,4496,4496,4441,4503,4440,4483,4479,-13,-17,30,1343920,168
1052,a1203,20110818,4483,4479,4490,4490,4481,4481,4487,2,8,14,628240,164
1053,a1203,20110819,4481,4487,0,0,0,4487,4487,0,0,0,0,164
1054,a1203,20110822,4487,4487,4490,4497,4490,4497,4493,10,6,4,179740,166
1055,a1203,20110823,4497,4493,4505,4520,4501,4520,4508,27,15,90,4057900,238
1056,a1203,20110824,4520,4508,4502,4520,4502,4508,4504,0,-4,20,900900,254
1057,a1203,20110825,4508,4504,0,0,0,4504,4504,0,0,0,0,254
1058,a1203,20110826,4504,4504,4487,4487,4485,4485,4486,-19,-18,14,628040,260
1059,a1203,20110829,4485,4486,4528,4608,4520,4608,4558,122,72,116,5287600,364
1060,a1203,20110830,4608,4558,4630,4630,4582,4620,4598,62,40,30,1379420,384
1061,a1203,20110831,4620,4598,4620,4711,4581,4610,4615,12,17,210,9692480,424
1062,a1203,20110901,4610,4615,4595,4617,4592,4595,4600,-20,-15,82,3772520,460
1063,a1203,20110902,4595,4600,4595,4690,4585,4600,4611,0,11,216,9961560,488
1064,a1203,20110905,4600,4611,4610,4675,4585,4603,4627,-8,16,56,2591400,500
1065,a1203,20110906,4603,4627,4547,4569,4528,4568,4550,-59,-77,24,1092200,504
1066,a1203,20110907,4568,4550,4587,4615,4560,4615,4584,65,34,224,10268200,610
1067,a1203,20110908,4615,4584,4631,4631,4575,4587,4594,3,10,130,5973000,652
1068,a1203,20110909,4587,4594,4590,4609,4588,4609,4591,15,-3,88,4040800,702
1069,a1203,20110913,4609,4591,4552,4552,4512,4527,4536,-64,-55,26,1179580,708
1070,a1203,20110914,4527,4536,4511,4530,4490,4490,4504,-46,-32,44,1982180,728
1071,a1203,20110915,4490,4504,4470,4485,4470,4483,4479,-21,-25,56,2508360,726
1072,a1203,20110916,4483,4479,4441,4480,4426,4480,4451,1,-28,52,2314760,742
1073,a1203,20110919,4480,4451,4460,4460,4420,4425,4436,-26,-15,10,443600,744
1074,a1203,20110920,4425,4436,4435,4439,4435,4439,4437,3,1,4,177480,744
1075,a1203,20110921,4439,4437,4439,4439,4391,4435,4422,-2,-15,24,1061340,750
1076,a1203,20110922,4435,4422,4374,4415,4374,4390,4386,-32,-36,38,1666980,740
1077,a1203,20110923,4390,4386,4390,4390,4170,4219,4273,-167,-113,72,3076860,708
1078,a1203,20110926,4219,4273,4287,4288,4136,4136,4210,-137,-63,72,3031540,748
1079,a1203,20110927,4136,4210,4207,4260,4207,4260,4232,50,22,16,677260,750
1080,a1203,20110928,4260,4232,0,0,0,4232,4232,0,0,0,0,750
1081,a1203,20110929,4232,4232,4110,4196,4092,4130,4123,-102,-109,16,659760,754
1082,a1203,20110930,4130,4123,4160,4190,4160,4188,4177,65,54,108,4511920,728
1083,a1203,20111010,4188,4177,4106,4192,4106,4160,4160,-17,-17,58,2412980,696
1084,a1203,20111011,4160,4160,4203,4203,4172,4175,4178,15,18,84,3509860,650
1085,a1203,20111012,4175,4178,4236,4265,4221,4238,4240,60,62,14,593700,650
1086,a1203,20111013,4238,4240,4220,4270,4220,4240,4238,0,-2,110,4662180,714
1087,a1203,20111014,4240,4238,4254,4268,4254,4268,4256,30,18,18,766120,704
1088,a1203,20111017,4268,4256,4270,4270,4236,4248,4251,-8,-5,12,510180,706
1089,a1203,20111018,4248,4251,4185,4225,4167,4219,4199,-32,-52,8,335920,706
1090,a1203,20111019,4219,4199,4243,4243,4160,4181,4188,-18,-11,54,2261880,700
1091,a1203,20111020,4181,4188,4107,4119,4093,4119,4106,-69,-82,10,410600,698
1092,a1203,20111021,4119,4106,4188,4188,4141,4158,4162,52,56,10,416200,698
1093,a1203,20111024,4158,4162,4230,4230,4230,4230,4230,68,68,20,846000,698
1094,a1203,20111025,4230,4230,4250,4300,4228,4230,4278,0,48,154,6588920,724
1095,a1203,20111026,4230,4278,4260,4283,4221,4222,4233,-56,-45,68,2878980,702
1096,a1203,20111027,4222,4233,4237,4247,4223,4245,4239,12,6,32,1356600,696
1097,a1203,20111028,4245,4239,4244,4258,4226,4237,4241,-2,2,8,339300,696
1098,a1203,20111031,4237,4241,0,0,0,4241,4241,0,0,0,0,696
1099,a1203,20111101,4241,4241,4198,4227,4185,4185,4207,-56,-34,10,420700,696
1100,a1203,20111102,4185,4207,4176,4219,4176,4219,4191,12,-16,112,4694500,694
1101,a1203,20111103,4219,4191,4226,4226,4196,4196,4206,5,15,14,588940,694
1102,a1203,20111104,4196,4206,4233,4233,4208,4222,4221,16,15,30,1266520,690
1103,a1203,20111107,4222,4221,4190,4190,4190,4190,4190,-31,-31,42,1759800,648
1104,a1203,20111108,4190,4190,0,0,0,4190,4190,0,0,0,0,648
1105,a1203,20111109,4190,4190,4189,4190,4189,4190,4189,0,-1,4,167580,650
1106,a1203,20111110,4190,4189,4190,4203,4101,4112,4130,-77,-59,90,3717460,634
1107,a1203,20111111,4112,4130,4115,4118,4115,4118,4116,-12,-14,4,164660,634
1108,a1203,20111114,4118,4116,4160,4165,4160,4165,4162,49,46,4,166500,634
1109,a1203,20111115,4165,4162,4068,4190,4068,4166,4168,4,6,48,2000760,632
1110,a1203,20111116,4166,4168,4181,4181,4142,4142,4161,-26,-7,10,416100,628
1111,a1203,20111117,4142,4161,0,0,0,4161,4161,0,0,0,0,628
1112,a1203,20111118,4161,4161,4129,4151,4129,4151,4138,-10,-23,30,1241660,608
1113,a1203,20111121,4151,4138,4155,4185,4150,4165,4167,27,29,148,6167620,638
1114,a1203,20111122,4165,4167,4159,4159,4159,4159,4159,-8,-8,2,83180,638
1115,a1203,20111123,4159,4159,0,0,0,4159,4159,0,0,0,0,638
1116,a1203,20111124,4159,4159,0,0,0,4159,4159,0,0,0,0,638
1117,a1203,20111125,4159,4159,4159,4159,4159,4159,4159,0,0,4,166360,638
1118,a1203,20111128,4159,4159,0,0,0,4159,4159,0,0,0,0,638
1119,a1203,20111129,4159,4159,4116,4129,4115,4129,4120,-30,-39,12,494440,636
1120,a1203,20111130,4129,4120,4120,4130,4081,4105,4112,-15,-8,32,1315900,620
1121,a1203,20111201,4105,4112,4153,4159,4114,4159,4139,47,27,32,1324720,628
1122,a1203,20111202,4159,4139,0,0,0,4139,4139,0,0,0,0,628
1123,a1203,20111205,4139,4139,4160,4160,4114,4148,4143,9,4,28,1160280,622
1124,a1203,20111206,4148,4143,4148,4150,4130,4138,4143,-5,0,20,828600,620
1125,a1203,20111207,4138,4143,4125,4174,4125,4147,4142,4,-1,12,497080,618
1126,a1203,20111208,4147,4142,4145,4145,4115,4129,4127,-13,-15,14,577880,624
1127,a1203,20111209,4129,4127,4132,4132,4130,4130,4131,3,4,12,495720,612
1128,a1203,20111212,4130,4131,0,0,0,4131,4131,0,0,0,0,612
1129,a1203,20111213,4131,4131,4120,4143,4120,4130,4131,-1,0,10,413140,612
1130,a1203,20111214,4130,4131,4130,4144,4130,4130,4134,-1,3,6,248080,614
1131,a1203,20111215,4130,4134,4169,4169,4135,4160,4151,26,17,72,2989280,630
1132,a1203,20111216,4160,4151,4150,4170,4143,4170,4154,19,3,26,1080200,640
1133,a1203,20111219,4170,4154,4170,4170,4162,4162,4166,8,12,4,166640,640
1134,a1203,20111220,4162,4166,4150,4165,4150,4162,4156,-4,-10,8,332540,642
1135,a1203,20111221,4162,4156,4155,4156,4147,4152,4153,-4,-3,16,664540,646
1136,a1203,20111222,4152,4153,4149,4149,4146,4146,4147,-7,-6,6,248840,650
1137,a1203,20111223,4146,4147,4151,4151,4140,4140,4148,-7,1,48,1991340,614
1138,a1203,20111226,4140,4148,4153,4170,4136,4138,4150,-10,2,42,1743080,636
1139,a1203,20111227,4138,4150,4145,4145,4145,4145,4145,-5,-5,4,165800,632
1140,a1203,20111228,4145,4145,4175,4175,4161,4167,4167,22,22,16,666840,626
1141,a1203,20111229,4167,4167,4174,4185,4173,4173,4177,6,10,6,250640,624
1142,a1203,20111230,4173,4177,4162,4170,4160,4168,4163,-9,-14,24,999300,640
1143,a1205,20110104,4628,4619,4599,4648,4598,4634,4627,15,8,20,925520,458
1144,a1205,20110105,4634,4627,4634,4634,4578,4591,4597,-36,-30,56,2574560,450
1145,a1205,20110106,4591,4597,4667,4667,4621,4645,4650,48,53,54,2511480,444
1146,a1205,20110107,4645,4650,4614,4629,4551,4578,4605,-72,-45,132,6079300,524
1147,a1205,20110110,4578,4605,4590,4598,4555,4573,4584,-32,-21,80,3667420,550
1148,a1205,20110111,4573,4584,4600,4600,4575,4577,4582,-7,-2,82,3757480,572
1149,a1205,20110112,4577,4582,4577,4587,4560,4567,4572,-15,-10,90,4115280,606
1150,a1205,20110113,4567,4572,4651,4659,4619,4619,4639,47,67,158,7330800,594
1151,a1205,20110114,4619,4639,4628,4665,4622,4640,4636,1,-3,100,4636800,626
1152,a1205,20110117,4640,4636,4657,4676,4641,4655,4657,19,21,82,3819220,642
1153,a1205,20110118,4655,4657,4655,4703,4650,4703,4683,46,26,414,19390820,706
1154,a1205,20110119,4703,4683,4702,4726,4694,4714,4713,31,30,114,5373560,724
1155,a1205,20110120,4714,4713,4697,4698,4675,4682,4684,-31,-29,122,5715120,764
1156,a1205,20110121,4682,4684,4682,4682,4642,4665,4663,-19,-21,162,7554740,768
1157,a1205,20110124,4665,4663,4697,4722,4670,4680,4703,17,40,244,11475660,828
1158,a1205,20110125,4680,4703,4670,4680,4638,4638,4652,-65,-51,148,6885000,850
1159,a1205,20110126,4638,4652,4606,4606,4540,4567,4557,-85,-95,370,16863000,928
1160,a1205,20110127,4567,4557,4588,4600,4555,4565,4569,8,12,158,7220220,956
1161,a1205,20110128,4565,4569,4554,4578,4554,4558,4568,-11,-1,170,7767220,1036
1162,a1205,20110131,4558,4568,4569,4606,4569,4599,4594,31,26,96,4411020,1052
1163,a1205,20110201,4599,4594,4601,4627,4601,4627,4610,33,16,70,3227580,1026
1164,a1205,20110209,4627,4610,4667,4705,4667,4705,4690,95,80,82,3846380,1024
1165,a1205,20110210,4705,4690,4720,4778,4720,4742,4751,52,61,306,14538300,982
1166,a1205,20110211,4742,4751,4731,4787,4730,4765,4765,14,14,150,7148340,944
1167,a1205,20110214,4765,4765,4776,4799,4775,4787,4783,22,18,322,15402220,926
1168,a1205,20110215,4787,4783,4744,4773,4730,4742,4754,-41,-29,150,7132020,932
1169,a1205,20110216,4742,4754,4699,4722,4682,4720,4705,-34,-49,106,4987880,918
1170,a1205,20110217,4720,4705,4731,4736,4675,4675,4707,-30,2,674,31731260,976
1171,a1205,20110218,4675,4707,4713,4715,4688,4688,4703,-19,-4,74,3480240,982
1172,a1205,20110221,4688,4703,4646,4676,4645,4648,4665,-55,-38,1014,47304760,1442
1173,a1205,20110222,4648,4665,4675,4691,4601,4658,4659,-7,-6,1212,56478300,2274
1174,a1205,20110223,4658,4659,4540,4543,4500,4500,4544,-159,-115,2348,106708180,3448
1175,a1205,20110224,4500,4544,4500,4527,4450,4454,4493,-90,-51,1984,89142720,3818
1176,a1205,20110225,4454,4493,4468,4499,4468,4498,4483,5,-10,676,30311000,3942
1177,a1205,20110228,4498,4483,4525,4532,4508,4517,4514,34,31,1448,65365940,4362
1178,a1205,20110301,4517,4514,4526,4527,4510,4525,4516,11,2,520,23483400,4376
1179,a1205,20110302,4525,4516,4518,4640,4509,4630,4601,114,85,1242,57145080,4586
1180,a1205,20110303,4630,4601,4626,4640,4585,4590,4610,-11,9,2480,114335120,5808
1181,a1205,20110304,4590,4610,4610,4666,4600,4616,4617,6,7,1222,56419960,6438
1182,a1205,20110307,4616,4617,4610,4610,4581,4602,4596,-15,-21,622,28588120,6426
1183,a1205,20110308,4602,4596,4590,4590,4520,4551,4545,-45,-51,2632,119639940,8066
1184,a1205,20110309,4551,4545,4545,4559,4502,4509,4521,-36,-24,5930,268145620,10492
1185,a1205,20110310,4509,4521,4498,4498,4463,4477,4485,-44,-36,1498,67190540,11130
1186,a1205,20110311,4477,4485,4485,4497,4458,4466,4479,-19,-6,2638,118171420,12610
1187,a1205,20110314,4466,4479,4460,4501,4436,4453,4456,-26,-23,2294,102236820,13348
1188,a1205,20110315,4453,4456,4460,4530,4449,4528,4498,72,42,6106,274688280,15778
1189,a1205,20110316,4528,4498,4460,4498,4448,4488,4474,-10,-24,5054,226156900,18024
1190,a1205,20110317,4488,4474,4486,4521,4464,4515,4502,41,28,3852,173452220,17930
1191,a1205,20110318,4515,4502,4530,4543,4515,4525,4522,23,20,4046,182996360,19238
1192,a1205,20110321,4525,4522,4528,4563,4510,4550,4535,28,13,6428,291541940,22388
1193,a1205,20110322,4550,4535,4541,4570,4537,4563,4556,28,21,4358,198561180,23694
1194,a1205,20110323,4563,4556,4560,4622,4559,4621,4604,65,48,9518,438264320,28768
1195,a1205,20110324,4621,4604,4628,4628,4589,4606,4605,2,1,7120,327906040,31398
1196,a1205,20110325,4606,4605,4666,4704,4611,4690,4674,85,69,12468,582784140,38054
1197,a1205,20110328,4690,4674,4682,4728,4661,4711,4699,37,25,31994,1503531280,55370
1198,a1205,20110329,4711,4699,4691,4725,4681,4720,4705,21,6,16458,774472620,61446
1199,a1205,20110330,4720,4705,4730,4737,4675,4691,4699,-14,-6,20430,960067000,68484
1200,a1205,20110331,4691,4699,4690,4710,4660,4681,4685,-18,-14,9358,438427600,68564
1201,a1205,20110401,4681,4685,4718,4720,4659,4705,4706,20,21,10858,511077320,69400
1202,a1205,20110406,4705,4706,4690,4745,4686,4740,4709,34,3,19408,914110200,74286
1203,a1205,20110407,4740,4709,4735,4742,4724,4728,4733,19,24,9316,440963840,75678
1204,a1205,20110408,4728,4733,4721,4742,4701,4741,4719,8,-14,23566,1112214200,82822
1205,a1205,20110411,4741,4719,4770,4828,4760,4769,4784,50,65,41384,1979897640,103618
1206,a1205,20110412,4769,4784,4730,4748,4696,4698,4725,-86,-59,30270,1430401260,113688
1207,a1205,20110413,4698,4725,4667,4697,4667,4696,4683,-29,-42,27868,1305136220,117690
1208,a1205,20110414,4696,4683,4681,4683,4629,4630,4660,-53,-23,22242,1036489560,122696
1209,a1205,20110415,4630,4660,4660,4660,4622,4629,4646,-31,-14,15738,731277580,124964
1210,a1205,20110418,4629,4646,4623,4662,4607,4655,4644,9,-2,10480,486719920,126064
1211,a1205,20110419,4655,4644,4660,4665,4635,4636,4646,-8,2,14576,677291700,128490
1212,a1205,20110420,4636,4646,4667,4667,4652,4664,4659,18,13,18714,872035700,133664
1213,a1205,20110421,4664,4659,4666,4667,4647,4651,4655,-8,-4,9416,438353820,133548
1214,a1205,20110422,4651,4655,4665,4678,4648,4669,4665,14,10,17672,824546140,136092
1215,a1205,20110425,4669,4665,4676,4682,4642,4647,4655,-18,-10,12894,600286920,137054
1216,a1205,20110426,4647,4655,4635,4640,4615,4621,4628,-34,-27,16068,743667840,135132
1217,a1205,20110427,4621,4628,4639,4645,4613,4620,4630,-8,2,9414,435904180,133496
1218,a1205,20110428,4620,4630,4635,4656,4629,4649,4644,19,14,7446,345827420,133842
1219,a1205,20110429,4649,4644,4616,4623,4555,4560,4576,-84,-68,19738,903250220,136704
1220,a1205,20110503,4560,4576,4601,4601,4566,4572,4572,-4,-4,12640,578001940,140928
1221,a1205,20110504,4572,4572,4547,4557,4519,4526,4538,-46,-34,19430,881924480,138116
1222,a1205,20110505,4526,4538,4521,4547,4498,4529,4531,-9,-7,15942,722337480,137934
1223,a1205,20110506,4529,4531,4476,4485,4449,4452,4466,-79,-65,28556,1275421480,139424
1224,a1205,20110509,4452,4466,4475,4481,4457,4481,4470,15,4,9984,446308160,139788
1225,a1205,20110510,4481,4470,4480,4506,4475,4505,4492,35,22,11328,508921060,140052
1226,a1205,20110511,4505,4492,4499,4523,4495,4496,4506,4,14,14242,641835620,143218
1227,a1205,20110512,4496,4506,4484,4521,4456,4464,4496,-42,-10,27290,1226976180,140862
1228,a1205,20110513,4464,4496,4499,4514,4483,4511,4497,15,1,14320,644019180,139286
1229,a1205,20110516,4511,4497,4493,4503,4486,4490,4492,-7,-5,6804,305696040,139102
1230,a1205,20110517,4490,4492,4483,4488,4427,4453,4452,-39,-40,17442,776618200,144226
1231,a1205,20110518,4453,4452,4479,4483,4455,4458,4469,6,17,20416,912510600,147710
1232,a1205,20110519,4458,4469,4500,4500,4474,4474,4487,5,18,12546,563063260,148712
1233,a1205,20110520,4474,4487,4486,4502,4478,4501,4492,14,5,10704,480836400,149648
1234,a1205,20110523,4501,4492,4512,4538,4500,4503,4520,11,28,21316,963587040,151010
1235,a1205,20110524,4503,4520,4512,4542,4504,4541,4522,21,2,23528,1064148800,150514
1236,a1205,20110525,4541,4522,4535,4545,4521,4525,4531,3,9,19224,871179840,155702
1237,a1205,20110526,4525,4531,4535,4559,4535,4555,4548,24,17,14828,674469640,157442
1238,a1205,20110527,4555,4548,4568,4568,4540,4550,4551,2,3,15092,686984360,158106
1239,a1205,20110530,4550,4551,4545,4563,4538,4554,4551,3,0,21424,975198640,160316
1240,a1205,20110531,4554,4551,4560,4564,4540,4547,4550,-4,-1,12114,551285220,161272
1241,a1205,20110601,4547,4550,4556,4556,4540,4542,4548,-8,-2,8782,399478140,161790
1242,a1205,20110602,4542,4548,4548,4565,4542,4564,4551,16,3,26054,1185748140,168152
1243,a1205,20110603,4564,4551,4580,4614,4576,4613,4591,62,40,31024,1424373800,173978
1244,a1205,20110607,4613,4591,4583,4587,4567,4575,4574,-16,-17,27032,1236697680,174568
1245,a1205,20110608,4575,4574,4588,4588,4561,4566,4572,-8,-2,23314,1065965620,175052
1246,a1205,20110609,4566,4572,4582,4587,4567,4570,4578,-2,6,17166,785873680,176224
1247,a1205,20110610,4570,4578,4569,4578,4552,4557,4566,-21,-12,18552,847188040,171938
1248,a1205,20110613,4557,4566,4552,4572,4552,4569,4564,3,-2,13036,595056160,173492
1249,a1205,20110614,4569,4564,4562,4573,4561,4564,4566,0,2,9974,455451080,172276
1250,a1205,20110615,4564,4566,4558,4570,4554,4565,4562,-1,-4,9794,446860320,173752
1251,a1205,20110616,4565,4562,4562,4567,4529,4534,4549,-28,-13,13188,599954700,173264
1252,a1205,20110617,4534,4549,4525,4531,4495,4502,4508,-47,-41,21350,962559980,173514
1253,a1205,20110620,4502,4508,4488,4500,4485,4486,4491,-22,-17,9866,443164960,172644
1254,a1205,20110621,4486,4491,4500,4518,4495,4516,4506,25,15,8690,391598420,172894
1255,a1205,20110622,4516,4506,4519,4521,4506,4510,4512,4,6,6100,275275020,172720
1256,a1205,20110623,4510,4512,4498,4498,4475,4489,4486,-23,-26,13402,601241540,172162
1257,a1205,20110624,4489,4486,4478,4516,4476,4507,4495,21,9,14988,673760440,176364
1258,a1205,20110627,4507,4495,4490,4512,4475,4482,4490,-13,-5,32156,1443932440,183356
1259,a1205,20110628,4482,4490,4500,4517,4497,4506,4507,16,17,18914,852573660,185220
1260,a1205,20110629,4506,4507,4520,4523,4513,4516,4518,9,11,11696,528427720,184714
1261,a1205,20110630,4516,4518,4518,4535,4513,4535,4526,17,8,18202,823914880,184854
1262,a1205,20110701,4535,4526,4515,4516,4492,4505,4504,-21,-22,32560,1466557400,190066
1263,a1205,20110704,4505,4504,4514,4535,4510,4532,4526,28,22,29128,1318512940,186498
1264,a1205,20110705,4532,4526,4533,4568,4533,4539,4549,13,23,59104,2688841420,206890
1265,a1205,20110706,4539,4549,4541,4565,4527,4531,4541,-18,-8,64324,2921470840,227284
1266,a1205,20110707,4531,4541,4529,4552,4528,4548,4540,7,-1,35238,1600139540,229360
1267,a1205,20110708,4548,4540,4574,4592,4567,4588,4579,48,39,59822,2739702680,239744
1268,a1205,20110711,4588,4579,4589,4602,4584,4596,4594,17,15,55198,2536145560,243102
1269,a1205,20110712,4596,4594,4591,4593,4568,4577,4577,-17,-17,49536,2267526040,245876
1270,a1205,20110713,4577,4577,4603,4644,4600,4638,4623,61,46,94802,4382811760,244294
1271,a1205,20110714,4638,4623,4658,4676,4651,4670,4664,47,41,78032,3639866120,239910
1272,a1205,20110715,4670,4664,4621,4669,4621,4660,4661,-4,-3,65242,3041433700,235152
1273,a1205,20110718,4660,4661,4660,4678,4638,4640,4664,-21,3,83280,3884415520,239280
1274,a1205,20110719,4640,4664,4646,4655,4622,4650,4640,-14,-24,65124,3022354820,233342
1275,a1205,20110720,4650,4640,4651,4660,4633,4652,4648,12,8,88032,4092419520,216838
1276,a1205,20110721,4652,4648,4646,4675,4640,4659,4660,11,12,100770,4695949720,211636
1277,a1205,20110722,4659,4660,4662,4668,4655,4660,4660,0,0,34476,1606858820,211630
1278,a1205,20110725,4660,4660,4638,4646,4607,4611,4626,-49,-34,66186,3062070220,203190
1279,a1205,20110726,4611,4626,4607,4634,4607,4634,4624,8,-2,37976,1756323560,206934
1280,a1205,20110727,4634,4624,4648,4682,4641,4669,4667,45,43,72766,3396213320,212950
1281,a1205,20110728,4669,4667,4647,4658,4642,4646,4650,-21,-17,33548,1560183340,208982
1282,a1205,20110729,4646,4650,4638,4670,4631,4635,4652,-15,2,87904,4089844320,206776
1283,a1205,20110801,4635,4652,4632,4712,4632,4706,4678,54,26,140534,6575300040,240872
1284,a1205,20110802,4706,4678,4701,4725,4683,4703,4703,25,25,241146,11342034560,259328
1285,a1205,20110803,4703,4703,4729,4745,4705,4707,4724,4,21,200582,9477372000,272022
1286,a1205,20110804,4707,4724,4690,4716,4656,4659,4688,-65,-36,279316,13096223960,280034
1287,a1205,20110805,4659,4688,4601,4602,4472,4562,4554,-126,-134,288654,13147148880,222988
1288,a1205,20110808,4562,4554,4480,4575,4480,4532,4541,-22,-13,176198,8001802640,240450
1289,a1205,20110809,4532,4541,4468,4498,4428,4485,4461,-56,-80,236700,10560716960,256344
1290,a1205,20110810,4485,4461,4511,4529,4504,4517,4517,56,56,127178,5744635460,255420
1291,a1205,20110811,4517,4517,4510,4561,4490,4555,4529,38,12,179968,8151921800,267292
1292,a1205,20110812,4555,4529,4597,4598,4556,4558,4575,29,46,136690,6254488800,269000
1293,a1205,20110815,4558,4575,4584,4642,4580,4620,4620,45,45,294026,13586611940,319206
1294,a1205,20110816,4620,4620,4630,4630,4575,4578,4604,-42,-16,197484,9093028080,304878
1295,a1205,20110817,4578,4604,4599,4615,4590,4606,4604,2,0,155702,7169999620,312668
1296,a1205,20110818,4606,4604,4624,4625,4598,4602,4611,-2,7,116696,5381218440,317834
1297,a1205,20110819,4602,4611,4572,4597,4563,4585,4581,-26,-30,155022,7102661360,306516
1298,a1205,20110822,4585,4581,4600,4629,4600,4602,4615,21,34,276608,12766639080,328514
1299,a1205,20110823,4602,4615,4631,4650,4625,4649,4638,34,23,214084,9930517220,344150
1300,a1205,20110824,4649,4638,4646,4653,4631,4636,4638,-2,0,140196,6503457880,332516
1301,a1205,20110825,4636,4638,4632,4632,4611,4623,4620,-15,-18,126946,5865101660,324994
1302,a1205,20110826,4623,4620,4635,4640,4606,4613,4620,-7,0,126976,5866749140,319578
1303,a1205,20110829,4613,4620,4680,4761,4668,4747,4716,127,96,557444,26294301400,442772
1304,a1205,20110830,4747,4716,4748,4770,4719,4732,4746,16,30,625266,29680082240,496698
1305,a1205,20110831,4732,4746,4740,4767,4736,4748,4753,2,7,455168,21636295460,454794
1306,a1205,20110901,4748,4753,4750,4768,4728,4735,4747,-18,-6,331396,15731613640,445016
1307,a1205,20110902,4735,4747,4726,4750,4720,4743,4737,-4,-10,232882,11033343300,431092
1308,a1205,20110905,4743,4737,4742,4828,4720,4726,4772,-11,35,1104936,52729682980,483762
1309,a1205,20110906,4726,4772,4718,4727,4671,4712,4698,-60,-74,538862,25317288820,443596
1310,a1205,20110907,4712,4698,4725,4767,4718,4762,4736,64,38,343058,16248556980,463208
1311,a1205,20110908,4762,4736,4750,4755,4721,4737,4738,1,2,351744,16666886420,474892
1312,a1205,20110909,4737,4738,4733,4770,4729,4769,4750,31,12,465906,22130721560,524796
1313,a1205,20110913,4769,4750,4700,4714,4655,4665,4677,-85,-73,494558,23132015200,471920
1314,a1205,20110914,4665,4677,4676,4687,4615,4620,4647,-57,-30,420442,19540643160,443922
1315,a1205,20110915,4620,4647,4633,4641,4606,4624,4628,-23,-19,246288,11399932320,430004
1316,a1205,20110916,4624,4628,4594,4622,4580,4620,4600,-8,-28,299914,13798907180,441270
1317,a1205,20110919,4620,4600,4600,4603,4539,4542,4569,-58,-31,261558,11951426900,428936
1318,a1205,20110920,4542,4569,4560,4580,4542,4567,4569,-2,0,222402,10162565460,436170
1319,a1205,20110921,4567,4569,4550,4580,4522,4565,4556,-4,-13,265022,12074604700,440348
1320,a1205,20110922,4565,4556,4499,4522,4458,4488,4499,-68,-57,342774,15424005020,425102
1321,a1205,20110923,4488,4499,4431,4465,4277,4340,4376,-159,-123,556602,24359517960,392344
1322,a1205,20110926,4340,4376,4321,4356,4203,4219,4295,-157,-81,417808,17946545720,353990
1323,a1205,20110927,4219,4295,4299,4348,4282,4333,4315,38,20,287028,12385854340,341242
1324,a1205,20110928,4333,4315,4281,4299,4258,4280,4278,-35,-37,220922,9452835380,327402
1325,a1205,20110929,4280,4278,4151,4232,4134,4209,4185,-69,-93,286494,11990980200,316172
1326,a1205,20110930,4209,4185,4248,4285,4230,4279,4262,94,77,163582,6973263700,313510
1327,a1205,20111010,4279,4262,4200,4295,4189,4241,4248,-21,-14,316468,13446618880,345812
1328,a1205,20111011,4241,4248,4253,4293,4235,4244,4268,-4,20,339850,14507512600,360860
1329,a1205,20111012,4244,4268,4317,4341,4285,4330,4317,62,49,409674,17687563040,360480
1330,a1205,20111013,4330,4317,4330,4355,4324,4351,4338,34,21,227232,9859351500,359590
1331,a1205,20111014,4351,4338,4376,4376,4354,4360,4363,22,25,190330,8305395520,341562
1332,a1205,20111017,4360,4363,4375,4376,4331,4333,4348,-30,-15,200620,8724861600,338370
1333,a1205,20111018,4333,4348,4320,4320,4242,4256,4278,-92,-70,171358,7332146980,326082
1334,a1205,20111019,4256,4278,4280,4315,4260,4282,4289,4,11,157462,6754806580,318826
1335,a1205,20111020,4282,4289,4220,4222,4161,4212,4198,-77,-91,302140,12684433980,295674
1336,a1205,20111021,4212,4198,4242,4259,4216,4258,4249,60,51,146764,6236993420,288914
1337,a1205,20111024,4258,4249,4288,4347,4228,4318,4285,69,36,219120,9389406960,286072
1338,a1205,20111025,4318,4285,4318,4345,4299,4323,4323,38,38,166060,7180360280,294100
1339,a1205,20111026,4323,4323,4307,4333,4292,4315,4315,-8,-8,121550,5244938060,280094
1340,a1205,20111027,4315,4315,4300,4354,4299,4346,4333,31,18,149546,6480691660,267646
1341,a1205,20111028,4346,4333,4372,4378,4328,4329,4352,-4,19,89906,3913458980,267476
1342,a1205,20111031,4329,4352,4302,4325,4267,4280,4294,-72,-58,73538,3157941560,262598
1343,a1205,20111101,4280,4294,4295,4317,4282,4291,4301,-3,7,75006,3226130160,254070
1344,a1205,20111102,4291,4301,4275,4333,4267,4328,4298,27,-3,52978,2277157720,245402
1345,a1205,20111103,4328,4298,4296,4327,4293,4297,4306,-1,8,46288,1993548460,241666
1346,a1205,20111104,4297,4306,4325,4346,4321,4328,4331,22,25,47698,2065892380,238000
1347,a1205,20111107,4328,4331,4343,4343,4285,4289,4301,-42,-30,33638,1446962240,235182
1348,a1205,20111108,4289,4301,4289,4297,4264,4274,4276,-27,-25,28830,1232986280,234118
1349,a1205,20111109,4274,4276,4288,4295,4261,4268,4273,-8,-3,41432,1770450880,229288
1350,a1205,20111110,4268,4273,4230,4230,4181,4200,4204,-73,-69,43996,1849790000,225976
1351,a1205,20111111,4200,4204,4195,4225,4195,4215,4213,11,9,26436,1113881960,222250
1352,a1205,20111114,4215,4213,4233,4263,4227,4257,4244,44,31,28096,1192613300,217738
1353,a1205,20111115,4257,4244,4244,4278,4227,4270,4260,26,16,40000,1704147460,198622
1354,a1205,20111116,4270,4260,4285,4287,4239,4249,4257,-11,-3,20972,892904540,196164
1355,a1205,20111117,4249,4257,4244,4279,4225,4267,4260,10,3,20842,887959840,191528
1356,a1205,20111118,4267,4260,4245,4256,4217,4256,4243,-4,-17,19050,808354100,186394
1357,a1205,20111121,4256,4243,4242,4283,4236,4269,4266,26,23,25718,1097316920,177720
1358,a1205,20111122,4269,4266,4230,4274,4230,4257,4260,-9,-6,39036,1663047140,166234
1359,a1205,20111123,4257,4260,4262,4271,4225,4230,4242,-30,-18,46914,1990325180,154932
1360,a1205,20111124,4230,4242,4202,4239,4186,4214,4210,-28,-32,36900,1553798820,146388
1361,a1205,20111125,4214,4210,4200,4219,4176,4180,4193,-30,-17,23528,986726460,144142
1362,a1205,20111128,4180,4193,4210,4216,4190,4197,4200,4,7,11888,499412160,142128
1363,a1205,20111129,4197,4200,4208,4228,4196,4224,4215,24,15,16346,689040480,141076
1364,a1205,20111130,4224,4215,4229,4230,4189,4194,4205,-21,-10,10340,434872240,140916
1365,a1205,20111201,4194,4205,4229,4341,4229,4256,4256,51,51,22466,956306380,134738
1366,a1205,20111202,4256,4256,4245,4257,4240,4250,4249,-6,-7,7520,319566520,133320
1367,a1205,20111205,4250,4249,4260,4265,4250,4260,4255,11,6,16172,688247820,124214
1368,a1205,20111206,4260,4255,4251,4251,4236,4247,4243,-8,-12,4254,180533280,123430
1369,a1205,20111207,4247,4243,4259,4265,4250,4258,4255,15,12,5446,231763700,121438
1370,a1205,20111208,4258,4255,4250,4250,4231,4241,4238,-14,-17,8824,373983460,120470
1371,a1205,20111209,4241,4238,4238,4248,4225,4239,4241,1,3,4136,175414260,119976
1372,a1205,20111212,4239,4241,4300,4300,4217,4218,4227,-23,-14,6154,260180800,119796
1373,a1205,20111213,4218,4227,4229,4245,4222,4237,4237,10,10,5148,218146760,118210
1374,a1205,20111214,4237,4237,4242,4260,4236,4255,4247,18,10,13546,575403400,111206
1375,a1205,20111215,4255,4247,4249,4282,4231,4270,4261,23,14,28430,1211639920,96256
1376,a1205,20111216,4270,4261,4273,4285,4267,4281,4275,20,14,9878,422364280,90822
1377,a1205,20111219,4281,4275,4299,4299,4268,4285,4286,10,11,20220,866642140,75838
1378,a1205,20111220,4285,4286,4286,4289,4262,4267,4271,-19,-15,5266,224934840,75606
1379,a1205,20111221,4267,4271,4275,4280,4258,4259,4269,-12,-2,3216,137297320,74782
1380,a1205,20111222,4259,4269,4270,4275,4253,4265,4263,-4,-6,4386,186984460,74146
1381,a1205,20111223,4265,4263,4268,4275,4265,4268,4268,5,5,3322,141812880,72374
1382,a1205,20111226,4268,4268,4267,4287,4262,4274,4277,6,9,6008,257003260,70072
1383,a1205,20111227,4274,4277,4268,4288,4266,4266,4278,-11,1,4558,195002820,69320
1384,a1205,20111228,4266,4278,4299,4303,4288,4296,4294,18,16,6436,276417460,66704
1385,a1205,20111229,4296,4294,4294,4309,4285,4300,4298,6,4,11414,490627920,61488
1386,a1205,20111230,4300,4298,4298,4309,4288,4291,4299,-7,1,7788,334808460,57372
1387,a1207,20110119,4340,4340,4599,4600,4599,4600,4599,260,259,30,1379760,28
1388,a1207,20110120,4600,4599,4650,4720,4650,4696,4688,97,89,68,3188320,46
1389,a1207,20110121,4696,4688,4738,4738,4690,4700,4706,12,18,24,1129460,46
1390,a1207,20110124,4700,4706,4719,4730,4719,4730,4724,24,18,4,188980,46
1391,a1207,20110125,4730,4724,4576,4695,4576,4678,4653,-46,-71,26,1209940,42
1392,a1207,20110126,4678,4653,4615,4640,4581,4595,4608,-58,-45,62,2857360,28
1393,a1207,20110127,4595,4608,4633,4633,4610,4610,4621,2,13,4,184860,28
1394,a1207,20110128,4610,4621,4629,4669,4621,4621,4641,0,20,16,742600,26
1395,a1207,20110131,4621,4641,4660,4660,4610,4615,4635,-26,-6,8,370860,26
1396,a1207,20110201,4615,4635,0,0,0,4635,4635,0,0,0,0,26
1397,a1207,20110209,4635,4635,4690,4728,4672,4728,4705,93,70,20,941060,18
1398,a1207,20110210,4728,4705,4830,4830,4801,4801,4815,96,110,4,192620,16
1399,a1207,20110211,4801,4815,4800,4800,4800,4800,4800,-15,-15,2,96000,16
1400,a1207,20110214,4800,4800,0,0,0,4800,4800,0,0,0,0,16
1401,a1207,20110215,4800,4800,4800,4800,4800,4800,4800,0,0,2,96000,14
1402,a1207,20110216,4800,4800,0,0,0,4800,4800,0,0,0,0,14
1403,a1207,20110217,4800,4800,0,0,0,4800,4800,0,0,0,0,14
1404,a1207,20110218,4800,4800,0,0,0,4800,4800,0,0,0,0,14
1405,a1207,20110221,4800,4800,0,0,0,4800,4800,0,0,0,0,14
1406,a1207,20110222,4800,4800,4800,4800,4670,4696,4710,-104,-90,16,753600,12
1407,a1207,20110223,4696,4710,4580,4588,4560,4560,4579,-150,-131,16,732760,14
1408,a1207,20110224,4560,4579,4555,4555,4515,4515,4527,-64,-52,12,543340,18
1409,a1207,20110225,4515,4527,4521,4521,4521,4521,4521,-6,-6,2,90420,16
1410,a1207,20110228,4521,4521,0,0,0,4521,4521,0,0,0,0,16
1411,a1207,20110301,4521,4521,4540,4540,4540,4540,4540,19,19,4,181600,16
1412,a1207,20110302,4540,4540,4649,4666,4649,4666,4655,126,115,6,279300,14
1413,a1207,20110303,4666,4655,4650,4650,4631,4631,4643,-24,-12,6,278600,14
1414,a1207,20110304,4631,4643,4665,4680,4662,4680,4673,37,30,10,467340,16
1415,a1207,20110307,4680,4673,0,0,0,4673,4673,0,0,0,0,16
1416,a1207,20110308,4673,4673,4605,4608,4565,4608,4592,-65,-81,6,275560,16
1417,a1207,20110309,4608,4592,0,0,0,4592,4592,0,0,0,0,16
1418,a1207,20110310,4592,4592,4564,4564,4564,4564,4564,-28,-28,2,91280,16
1419,a1207,20110311,4564,4564,4546,4546,4546,4546,4546,-18,-18,2,90920,16
1420,a1207,20110314,4546,4546,4536,4536,4500,4500,4517,-46,-29,12,542080,18
1421,a1207,20110315,4500,4517,4512,4558,4505,4558,4520,41,3,8,361600,18
1422,a1207,20110316,4558,4520,0,0,0,4520,4520,0,0,0,0,18
1423,a1207,20110317,4520,4520,4510,4535,4510,4535,4522,15,2,4,180900,18
1424,a1207,20110318,4535,4522,4552,4558,4552,4558,4555,36,33,4,182200,18
1425,a1207,20110321,4558,4555,4545,4594,4545,4594,4579,39,24,14,641140,16
1426,a1207,20110322,4594,4579,0,0,0,4579,4579,0,0,0,0,16
1427,a1207,20110323,4579,4579,4641,4645,4641,4645,4643,66,64,4,185720,16
1428,a1207,20110324,4645,4643,0,0,0,4643,4643,0,0,0,0,16
1429,a1207,20110325,4643,4643,4711,4711,4708,4708,4710,65,67,6,282600,16
1430,a1207,20110328,4708,4710,4783,4783,4715,4779,4754,69,44,16,760720,18
1431,a1207,20110329,4779,4754,4750,4774,4735,4750,4756,-4,2,28,1331740,18
1432,a1207,20110330,4750,4756,4750,4750,4750,4750,4750,-6,-6,2,95000,20
1433,a1207,20110331,4750,4750,4711,4720,4711,4720,4715,-30,-35,8,377240,20
1434,a1207,20110401,4720,4715,4720,4720,4720,4720,4720,5,5,2,94400,18
1435,a1207,20110406,4720,4720,4715,4770,4715,4750,4745,30,25,28,1328860,26
1436,a1207,20110407,4750,4745,4752,4770,4750,4760,4758,15,13,26,1237140,42
1437,a1207,20110408,4760,4758,4764,4775,4743,4775,4759,17,1,20,951860,46
1438,a1207,20110411,4775,4759,4801,4863,4801,4830,4833,71,74,14,676640,54
1439,a1207,20110412,4830,4833,4830,4830,4751,4751,4771,-82,-62,52,2480960,28
1440,a1207,20110413,4751,4771,4741,4745,4731,4731,4740,-40,-31,36,1706600,46
1441,a1207,20110414,4731,4740,4722,4733,4682,4682,4711,-58,-29,18,848120,54
1442,a1207,20110415,4682,4711,4714,4714,4660,4660,4685,-51,-26,6,281100,54
1443,a1207,20110418,4660,4685,0,0,0,4685,4685,0,0,0,0,54
1444,a1207,20110419,4685,4685,0,0,0,4685,4685,0,0,0,0,54
1445,a1207,20110420,4685,4685,4701,4701,4701,4701,4701,16,16,2,94020,56
1446,a1207,20110421,4701,4701,4702,4703,4696,4696,4699,-5,-2,10,469980,58
1447,a1207,20110422,4696,4699,4705,4705,4705,4705,4705,6,6,4,188200,60
1448,a1207,20110425,4705,4705,4705,4705,4705,4705,4705,0,0,4,188200,60
1449,a1207,20110426,4705,4705,4685,4685,4680,4681,4682,-24,-23,8,374560,62
1450,a1207,20110427,4681,4682,4649,4699,4649,4675,4680,-7,-2,10,468060,62
1451,a1207,20110428,4675,4680,0,0,0,4680,4680,0,0,0,0,62
1452,a1207,20110429,4680,4680,4630,4630,4614,4614,4622,-66,-58,4,184880,62
1453,a1207,20110503,4614,4622,0,0,0,4622,4622,0,0,0,0,62
1454,a1207,20110504,4622,4622,4585,4585,4585,4585,4585,-37,-37,2,91700,62
1455,a1207,20110505,4585,4585,0,0,0,4585,4585,0,0,0,0,62
1456,a1207,20110506,4585,4585,4512,4512,4512,4512,4512,-73,-73,2,90240,62
1457,a1207,20110509,4512,4512,0,0,0,4512,4512,0,0,0,0,62
1458,a1207,20110510,4512,4512,0,0,0,4512,4512,0,0,0,0,62
1459,a1207,20110511,4512,4512,0,0,0,4512,4512,0,0,0,0,62
1460,a1207,20110512,4512,4512,4555,4555,4527,4527,4550,15,38,14,637120,74
1461,a1207,20110513,4527,4550,4565,4565,4565,4565,4565,15,15,2,91300,74
1462,a1207,20110516,4565,4565,0,0,0,4565,4565,0,0,0,0,74
1463,a1207,20110517,4565,4565,4533,4533,4501,4501,4517,-64,-48,4,180680,74
1464,a1207,20110518,4501,4517,4515,4515,4507,4507,4509,-10,-8,16,721480,86
1465,a1207,20110519,4507,4509,0,0,0,4509,4509,0,0,0,0,86
1466,a1207,20110520,4509,4509,0,0,0,4509,4509,0,0,0,0,86
1467,a1207,20110523,4509,4509,4509,4558,4509,4558,4545,49,36,8,363640,82
1468,a1207,20110524,4558,4545,4541,4541,4541,4541,4541,-4,-4,2,90820,82
1469,a1207,20110525,4541,4541,4541,4541,4530,4530,4532,-11,-9,30,1359620,84
1470,a1207,20110526,4530,4532,4567,4567,4567,4567,4567,35,35,2,91340,82
1471,a1207,20110527,4567,4567,0,0,0,4567,4567,0,0,0,0,82
1472,a1207,20110530,4567,4567,0,0,0,4567,4567,0,0,0,0,82
1473,a1207,20110531,4567,4567,4550,4550,4550,4550,4550,-17,-17,2,91000,82
1474,a1207,20110601,4550,4550,0,0,0,4550,4550,0,0,0,0,82
1475,a1207,20110602,4550,4550,0,0,0,4550,4550,0,0,0,0,82
1476,a1207,20110603,4550,4550,4597,4633,4597,4633,4614,83,64,14,646000,68
1477,a1207,20110607,4633,4614,4562,4607,4562,4595,4586,-19,-28,8,366880,68
1478,a1207,20110608,4595,4586,4593,4593,4592,4592,4592,6,6,12,551140,80
1479,a1207,20110609,4592,4592,4570,4593,4570,4593,4581,1,-11,4,183260,80
1480,a1207,20110610,4593,4581,4567,4612,4540,4560,4568,-21,-13,16,730900,80
1481,a1207,20110613,4560,4568,0,0,0,4568,4568,0,0,0,0,80
1482,a1207,20110614,4568,4568,4565,4565,4565,4565,4565,-3,-3,2,91300,82
1483,a1207,20110615,4565,4565,4589,4589,4589,4589,4589,24,24,2,91780,84
1484,a1207,20110616,4589,4589,4570,4576,4540,4540,4562,-49,-27,12,547520,86
1485,a1207,20110617,4540,4562,4520,4529,4517,4529,4522,-33,-40,6,271320,86
1486,a1207,20110620,4529,4522,4522,4522,4490,4490,4517,-32,-5,14,632420,96
1487,a1207,20110621,4490,4517,0,0,0,4517,4517,0,0,0,0,96
1488,a1207,20110622,4517,4517,0,0,0,4517,4517,0,0,0,0,96
1489,a1207,20110623,4517,4517,4495,4495,4495,4495,4495,-22,-22,2,89900,96
1490,a1207,20110624,4495,4495,4502,4529,4502,4529,4515,34,20,4,180620,96
1491,a1207,20110627,4529,4515,4480,4480,4480,4480,4480,-35,-35,2,89600,96
1492,a1207,20110628,4480,4480,0,0,0,4480,4480,0,0,0,0,96
1493,a1207,20110629,4480,4480,0,0,0,4480,4480,0,0,0,0,96
1494,a1207,20110630,4480,4480,0,0,0,4480,4480,0,0,0,0,96
1495,a1207,20110701,4480,4480,0,0,0,4480,4480,0,0,0,0,96
1496,a1207,20110704,4480,4480,0,0,0,4480,4480,0,0,0,0,96
1497,a1207,20110705,4480,4480,4578,4578,4560,4560,4572,80,92,6,274320,92
1498,a1207,20110706,4560,4572,4629,4629,4555,4555,4579,-17,7,12,549560,92
1499,a1207,20110707,4555,4579,0,0,0,4579,4579,0,0,0,0,92
1500,a1207,20110708,4579,4579,0,0,0,4579,4579,0,0,0,0,92
1501,a1207,20110711,4579,4579,0,0,0,4579,4579,0,0,0,0,92
1502,a1207,20110712,4579,4579,0,0,0,4579,4579,0,0,0,0,92
1503,a1207,20110713,4579,4579,4655,4666,4655,4666,4658,87,79,6,279520,92
1504,a1207,20110714,4666,4658,4689,4695,4689,4695,4690,37,32,10,469020,84
1505,a1207,20110715,4695,4690,0,0,0,4690,4690,0,0,0,0,84
1506,a1207,20110718,4690,4690,4680,4680,4650,4650,4665,-40,-25,4,186600,86
1507,a1207,20110719,4650,4665,4688,4688,4650,4650,4666,-15,1,6,279960,88
1508,a1207,20110720,4650,4666,4673,4686,4673,4685,4684,19,18,16,749460,84
1509,a1207,20110721,4685,4684,4700,4700,4688,4700,4694,16,10,8,375540,80
1510,a1207,20110722,4700,4694,0,0,0,4694,4694,0,0,0,0,80
1511,a1207,20110725,4694,4694,4650,4663,4650,4663,4655,-31,-39,12,558660,80
1512,a1207,20110726,4663,4655,4649,4669,4649,4669,4664,14,9,22,1026240,66
1513,a1207,20110727,4669,4664,4712,4712,4687,4700,4699,36,35,6,281980,64
1514,a1207,20110728,4700,4699,0,0,0,4699,4699,0,0,0,0,64
1515,a1207,20110729,4699,4699,0,0,0,4699,4699,0,0,0,0,64
1516,a1207,20110801,4699,4699,4721,4744,4721,4744,4732,45,33,14,662560,54
1517,a1207,20110802,4744,4732,0,0,0,4732,4732,0,0,0,0,54
1518,a1207,20110803,4732,4732,4795,4795,4761,4761,4772,29,40,6,286340,58
1519,a1207,20110804,4761,4772,4719,4732,4707,4732,4718,-40,-54,8,377500,60
1520,a1207,20110805,4732,4718,4638,4643,4605,4643,4628,-75,-90,24,1110720,62
1521,a1207,20110808,4643,4628,4566,4566,4566,4566,4566,-62,-62,2,91320,62
1522,a1207,20110809,4566,4566,4462,4519,4462,4519,4487,-47,-79,8,358960,58
1523,a1207,20110810,4519,4487,4584,4584,4519,4558,4549,71,62,36,1637920,66
1524,a1207,20110811,4558,4549,4655,4655,4548,4600,4595,51,46,22,1011100,66
1525,a1207,20110812,4600,4595,0,0,0,4595,4595,0,0,0,0,66
1526,a1207,20110815,4595,4595,4649,4674,4620,4662,4653,67,58,58,2698980,78
1527,a1207,20110816,4662,4653,4666,4666,4641,4641,4652,-12,-1,24,1116480,76
1528,a1207,20110817,4641,4652,4645,4655,4641,4655,4646,3,-6,8,371700,76
1529,a1207,20110818,4655,4646,4648,4655,4642,4655,4648,9,2,10,464820,76
1530,a1207,20110819,4655,4648,4605,4635,4605,4624,4621,-24,-27,20,924300,76
1531,a1207,20110822,4624,4621,0,0,0,4621,4621,0,0,0,0,76
1532,a1207,20110823,4621,4621,4723,4723,4646,4693,4677,72,56,10,467740,78
1533,a1207,20110824,4693,4677,0,0,0,4677,4677,0,0,0,0,78
1534,a1207,20110825,4677,4677,4668,4668,4668,4668,4668,-9,-9,2,93360,78
1535,a1207,20110826,4668,4668,0,0,0,4668,4668,0,0,0,0,78
1536,a1207,20110829,4668,4668,4689,4779,4689,4779,4726,111,58,50,2363100,76
1537,a1207,20110830,4779,4726,4830,4830,4705,4795,4767,69,41,196,9343840,86
1538,a1207,20110831,4795,4767,4792,4792,4792,4792,4792,25,25,2,95840,86
1539,a1207,20110901,4792,4792,4751,4802,4730,4781,4793,-11,1,222,10641560,98
1540,a1207,20110902,4781,4793,4789,4794,4789,4794,4791,1,-2,20,958220,110
1541,a1207,20110905,4794,4791,4818,4868,4772,4796,4815,5,24,20,963080,114
1542,a1207,20110906,4796,4815,4818,4818,4741,4759,4757,-56,-58,64,3044720,106
1543,a1207,20110907,4759,4757,4777,4809,4777,4809,4790,52,33,20,958160,98
1544,a1207,20110908,4809,4790,4790,4823,4781,4781,4801,-9,11,202,9699820,196
1545,a1207,20110909,4781,4801,0,0,0,4801,4801,0,0,0,0,196
1546,a1207,20110913,4801,4801,4743,4743,4730,4730,4733,-71,-68,10,473360,198
1547,a1207,20110914,4730,4733,4720,4720,4691,4691,4698,-42,-35,14,657720,188
1548,a1207,20110915,4691,4698,4681,4719,4681,4698,4697,0,-1,28,1315220,174
1549,a1207,20110916,4698,4697,4675,4675,4674,4674,4674,-23,-23,12,560960,174
1550,a1207,20110919,4674,4674,4661,4661,4582,4582,4621,-92,-53,46,2125760,200
1551,a1207,20110920,4582,4621,4556,4618,4556,4610,4595,-11,-26,18,827200,202
1552,a1207,20110921,4610,4595,4637,4637,4600,4609,4611,14,16,12,553320,202
1553,a1207,20110922,4609,4611,4549,4570,4532,4532,4543,-79,-68,10,454380,204
1554,a1207,20110923,4532,4543,4401,4524,4330,4382,4440,-161,-103,322,14299520,376
1555,a1207,20110926,4382,4440,4378,4389,4218,4218,4358,-222,-82,540,23535980,206
1556,a1207,20110927,4218,4358,4321,4375,4321,4375,4337,17,-21,32,1388080,208
1557,a1207,20110928,4375,4337,4327,4327,4260,4290,4300,-47,-37,56,2408420,226
1558,a1207,20110929,4290,4300,4193,4228,4193,4228,4210,-72,-90,12,505240,224
1559,a1207,20110930,4228,4210,4233,4309,4233,4301,4285,91,75,68,2914300,196
1560,a1207,20111010,4301,4285,4195,4281,4195,4270,4255,-15,-30,8,340460,192
1561,a1207,20111011,4270,4255,0,0,0,4255,4255,0,0,0,0,192
1562,a1207,20111012,4255,4255,4358,4358,4312,4350,4346,95,91,18,782340,182
1563,a1207,20111013,4350,4346,4399,4399,4342,4358,4366,12,20,6,261980,182
1564,a1207,20111014,4358,4366,4359,4397,4359,4390,4377,24,11,46,2013420,172
1565,a1207,20111017,4390,4377,4397,4397,4370,4370,4382,-7,5,8,350600,172
1566,a1207,20111018,4370,4382,4264,4299,4264,4299,4281,-83,-101,14,599440,172
1567,a1207,20111019,4299,4281,4309,4309,4309,4309,4309,28,28,2,86180,172
1568,a1207,20111020,4309,4309,4185,4239,4185,4239,4221,-70,-88,10,422160,168
1569,a1207,20111021,4239,4221,0,0,0,4221,4221,0,0,0,0,168
1570,a1207,20111024,4221,4221,0,0,0,4221,4221,0,0,0,0,168
1571,a1207,20111025,4221,4221,4369,4370,4327,4327,4359,106,138,8,348720,168
1572,a1207,20111026,4327,4359,4358,4358,4358,4358,4358,-1,-1,2,87160,168
1573,a1207,20111027,4358,4358,4360,4415,4360,4415,4384,57,26,8,350720,164
1574,a1207,20111028,4415,4384,4412,4412,4412,4412,4412,28,28,2,88240,164
1575,a1207,20111031,4412,4412,4356,4358,4349,4349,4354,-63,-58,26,1132200,178
1576,a1207,20111101,4349,4354,4342,4345,4342,4345,4343,-9,-11,14,608040,174
1577,a1207,20111102,4345,4343,4351,4362,4350,4362,4356,19,13,16,697020,168
1578,a1207,20111103,4362,4356,0,0,0,4356,4356,0,0,0,0,168
1579,a1207,20111104,4356,4356,0,0,0,4356,4356,0,0,0,0,168
1580,a1207,20111107,4356,4356,4320,4365,4320,4324,4341,-32,-15,38,1649620,160
1581,a1207,20111108,4324,4341,4330,4330,4330,4330,4330,-11,-11,22,952600,138
1582,a1207,20111109,4330,4330,4316,4378,4316,4325,4372,-5,42,212,9268820,322
1583,a1207,20111110,4325,4372,4272,4272,4241,4260,4258,-112,-114,8,340660,318
1584,a1207,20111111,4260,4258,4271,4271,4271,4271,4271,13,13,2,85420,318
1585,a1207,20111114,4271,4271,4293,4295,4288,4291,4292,20,21,208,8927500,138
1586,a1207,20111115,4291,4292,4314,4316,4314,4316,4315,24,23,4,172600,138
1587,a1207,20111116,4316,4315,4306,4306,4304,4304,4305,-11,-10,4,172200,134
1588,a1207,20111117,4304,4305,4307,4307,4306,4306,4306,1,1,4,172260,130
1589,a1207,20111118,4306,4306,0,0,0,4306,4306,0,0,0,0,130
1590,a1207,20111121,4306,4306,4288,4309,4266,4305,4291,-1,-15,26,1115820,134
1591,a1207,20111122,4305,4291,4281,4284,4262,4262,4279,-29,-12,32,1369460,144
1592,a1207,20111123,4262,4279,4263,4263,4253,4255,4256,-24,-23,10,425600,144
1593,a1207,20111124,4255,4256,4228,4230,4223,4223,4227,-33,-29,6,253620,148
1594,a1207,20111125,4223,4227,4200,4200,4193,4193,4197,-34,-30,6,251820,148
1595,a1207,20111128,4193,4197,4207,4207,4200,4200,4204,3,7,6,252280,144
1596,a1207,20111129,4200,4204,4219,4221,4219,4221,4220,17,16,6,253200,146
1597,a1207,20111130,4221,4220,4219,4219,4185,4185,4202,-35,-18,20,840400,146
1598,a1207,20111201,4185,4202,4258,4262,4258,4262,4260,60,58,6,255640,148
1599,a1207,20111202,4262,4260,0,0,0,4260,4260,0,0,0,0,148
1600,a1207,20111205,4260,4260,0,0,0,4260,4260,0,0,0,0,148
1601,a1207,20111206,4260,4260,0,0,0,4260,4260,0,0,0,0,148
1602,a1207,20111207,4260,4260,0,0,0,4260,4260,0,0,0,0,148
1603,a1207,20111208,4260,4260,0,0,0,4260,4260,0,0,0,0,148
1604,a1207,20111209,4260,4260,0,0,0,4260,4260,0,0,0,0,148
1605,a1207,20111212,4260,4260,4239,4239,4206,4206,4230,-54,-30,8,338460,148
1606,a1207,20111213,4206,4230,4206,4242,4206,4242,4228,12,-2,14,592020,148
1607,a1207,20111214,4242,4228,4241,4241,4234,4236,4237,8,9,14,593220,152
1608,a1207,20111215,4236,4237,4238,4262,4229,4262,4241,25,4,22,933140,162
1609,a1207,20111216,4262,4241,4275,4280,4275,4280,4277,39,36,12,513280,164
1610,a1207,20111219,4280,4277,4299,4299,4299,4299,4299,22,22,4,171960,164
1611,a1207,20111220,4299,4299,4287,4287,4287,4287,4287,-12,-12,20,857400,164
1612,a1207,20111221,4287,4287,4282,4282,4275,4275,4279,-12,-8,10,427960,154
1613,a1207,20111222,4275,4279,4268,4271,4268,4271,4270,-8,-9,30,1281120,128
1614,a1207,20111223,4271,4270,4280,4280,4280,4280,4280,10,10,4,171200,128
1615,a1207,20111226,4280,4280,4289,4293,4270,4281,4283,1,3,20,856600,124
1616,a1207,20111227,4281,4283,4273,4289,4273,4289,4277,6,-6,8,342160,124
1617,a1207,20111228,4289,4277,4303,4303,4299,4300,4301,23,24,10,430100,124
1618,a1207,20111229,4300,4301,4267,4309,4267,4301,4291,0,-10,18,772500,122
1619,a1207,20111230,4301,4291,4293,4324,4293,4295,4308,4,17,8,344680,122
1620,a1209,20110316,4585,4563,4509,4574,4409,4553,4537,-10,-26,78,3539340,32
1621,a1209,20110317,4553,4537,4512,4586,4512,4572,4564,35,27,72,3286380,24
1622,a1209,20110318,4572,4564,4576,4594,4576,4583,4583,19,19,26,1191720,26
1623,a1209,20110321,4583,4583,4573,4615,4573,4603,4598,20,15,44,2023380,44
1624,a1209,20110322,4603,4598,4632,4632,4615,4615,4621,17,23,10,462140,42
1625,a1209,20110323,4615,4621,4639,4687,4611,4680,4663,59,42,68,3171320,48
1626,a1209,20110324,4680,4663,4681,4681,4660,4675,4670,12,7,38,1774840,62
1627,a1209,20110325,4675,4670,4699,4771,4699,4770,4748,100,78,50,2374120,98
1628,a1209,20110328,4770,4748,4788,4806,4736,4780,4773,32,25,142,6778640,126
1629,a1209,20110329,4780,4773,4772,4839,4771,4800,4786,27,13,228,10912760,236
1630,a1209,20110330,4800,4786,4822,4824,4761,4768,4783,-18,-3,140,6696460,246
1631,a1209,20110331,4768,4783,4794,4794,4760,4772,4770,-11,-13,62,2957460,256
1632,a1209,20110401,4772,4770,4791,4793,4775,4785,4784,15,14,44,2105300,256
1633,a1209,20110406,4785,4784,4784,4825,4778,4825,4800,41,16,46,2208020,260
1634,a1209,20110407,4825,4800,4837,4837,4803,4806,4815,6,15,66,3178520,284
1635,a1209,20110408,4806,4815,4801,4834,4793,4828,4806,13,-9,174,8364080,328
1636,a1209,20110411,4828,4806,4870,4910,4830,4865,4898,59,92,1316,64466980,1426
1637,a1209,20110412,4865,4898,4841,4856,4792,4792,4828,-106,-70,288,13905060,1484
1638,a1209,20110413,4792,4828,4768,4800,4768,4798,4789,-30,-39,142,6800800,1520
1639,a1209,20110414,4798,4789,4773,4779,4736,4736,4758,-53,-31,164,7803220,1532
1640,a1209,20110415,4736,4758,4760,4768,4724,4727,4749,-31,-9,166,7884840,1582
1641,a1209,20110418,4727,4749,4712,4768,4712,4766,4749,17,0,136,6459240,1610
1642,a1209,20110419,4766,4749,4760,4763,4734,4734,4747,-15,-2,94,4462780,1602
1643,a1209,20110420,4734,4747,4750,4779,4750,4761,4763,14,16,96,4573280,1622
1644,a1209,20110421,4761,4763,4762,4773,4749,4750,4759,-13,-4,138,6568340,1628
1645,a1209,20110422,4750,4759,4761,4777,4755,4769,4766,10,7,80,3813020,1612
1646,a1209,20110425,4769,4766,4780,4780,4752,4756,4761,-10,-5,228,10855240,1726
1647,a1209,20110426,4756,4761,4733,4750,4723,4726,4737,-35,-24,162,7674120,1744
1648,a1209,20110427,4726,4737,4736,4752,4716,4716,4734,-21,-3,124,5871260,1782
1649,a1209,20110428,4716,4734,4736,4758,4736,4755,4750,21,16,100,4750400,1780
1650,a1209,20110429,4755,4750,4689,4713,4665,4665,4687,-85,-63,92,4312560,1788
1651,a1209,20110503,4665,4687,4700,4700,4682,4682,4686,-5,-1,50,2343400,1794
1652,a1209,20110504,4682,4686,4670,4670,4630,4630,4646,-56,-40,106,4924840,1846
1653,a1209,20110505,4630,4646,4625,4657,4609,4635,4637,-11,-9,96,4451760,1842
1654,a1209,20110506,4635,4637,4585,4600,4561,4561,4583,-76,-54,140,6416240,1884
1655,a1209,20110509,4561,4583,4576,4598,4574,4593,4587,10,4,60,2752220,1868
1656,a1209,20110510,4593,4587,4582,4605,4580,4594,4586,7,-1,462,21189200,1970
1657,a1209,20110511,4594,4586,4591,4609,4591,4593,4600,7,14,40,1840080,1970
1658,a1209,20110512,4593,4600,4600,4605,4559,4569,4582,-31,-18,202,9255800,2026
1659,a1209,20110513,4569,4582,4603,4619,4590,4613,4607,31,25,64,2948860,2028
1660,a1209,20110516,4613,4607,4602,4609,4591,4591,4598,-16,-9,50,2299320,2040
1661,a1209,20110517,4591,4598,4572,4572,4535,4550,4555,-48,-43,176,8017500,2098
1662,a1209,20110518,4550,4555,4568,4571,4535,4535,4551,-20,-4,3832,174420080,5084
1663,a1209,20110519,4535,4551,4578,4578,4414,4543,4545,-8,-6,924,42000860,5392
1664,a1209,20110520,4543,4545,4545,4566,4545,4560,4553,15,8,132,6011120,5384
1665,a1209,20110523,4560,4553,4573,4599,4571,4571,4585,18,32,482,22099820,5136
1666,a1209,20110524,4571,4585,4579,4606,4575,4606,4588,21,3,86,3946300,5118
1667,a1209,20110525,4606,4588,4604,4604,4565,4569,4572,-19,-16,6720,307289580,8160
1668,a1209,20110526,4569,4572,4583,4605,4579,4604,4596,32,24,1088,50007700,8174
1669,a1209,20110527,4604,4596,4613,4613,4590,4597,4599,1,3,1238,56942500,8792
1670,a1209,20110530,4597,4599,4599,4610,4588,4604,4600,5,1,554,25488960,8846
1671,a1209,20110531,4604,4600,4602,4603,4588,4590,4591,-10,-9,2190,100556240,10546
1672,a1209,20110601,4590,4591,4595,4598,4584,4586,4590,-5,-1,1398,64175280,11582
1673,a1209,20110602,4586,4590,4590,4608,4590,4608,4597,18,7,690,31721040,11594
1674,a1209,20110603,4608,4597,4612,4659,4612,4659,4636,62,39,1324,61391460,11614
1675,a1209,20110607,4659,4636,4621,4636,4620,4629,4627,-7,-9,2462,113924120,13196
1676,a1209,20110608,4629,4627,4629,4640,4610,4621,4616,-6,-11,2100,96954760,14192
1677,a1209,20110609,4621,4616,4632,4640,4610,4616,4619,0,3,5296,244656520,18188
1678,a1209,20110610,4616,4619,4609,4623,4596,4606,4610,-13,-9,2428,111954340,18940
1679,a1209,20110613,4606,4610,4605,4620,4596,4608,4603,-2,-7,5760,265185420,23350
1680,a1209,20110614,4608,4603,4602,4613,4600,4606,4603,3,0,2118,97492740,24202
1681,a1209,20110615,4606,4603,4585,4610,4585,4605,4604,2,1,684,31493600,24230
1682,a1209,20110616,4605,4604,4596,4603,4573,4576,4589,-28,-15,1196,54892540,24220
1683,a1209,20110617,4576,4589,4570,4572,4541,4545,4558,-44,-31,1138,51881280,24192
1684,a1209,20110620,4545,4558,4545,4545,4529,4532,4535,-26,-23,730,33105920,24340
1685,a1209,20110621,4532,4535,4535,4558,4535,4558,4545,23,10,1032,46910360,24206
1686,a1209,20110622,4558,4545,4560,4563,4548,4555,4553,10,8,818,37247700,24200
1687,a1209,20110623,4555,4553,4539,4540,4520,4537,4530,-16,-23,716,32437000,24222
1688,a1209,20110624,4537,4530,4527,4559,4521,4548,4546,18,16,692,31460600,24210
1689,a1209,20110627,4548,4546,4535,4554,4519,4526,4534,-20,-12,2044,92690420,24238
1690,a1209,20110628,4526,4534,4535,4558,4535,4543,4548,9,14,1744,79326220,24222
1691,a1209,20110629,4543,4548,4554,4564,4553,4559,4558,11,10,476,21700560,24236
1692,a1209,20110630,4559,4558,4558,4574,4558,4574,4568,16,10,374,17084380,24240
1693,a1209,20110701,4574,4568,4542,4554,4536,4552,4544,-16,-24,1092,49627820,24230
1694,a1209,20110704,4552,4544,4566,4585,4555,4585,4573,41,29,2066,94480420,23270
1695,a1209,20110705,4585,4573,4588,4617,4588,4597,4606,24,33,2172,100044680,23366
1696,a1209,20110706,4597,4606,4599,4624,4588,4590,4601,-16,-5,1444,66452140,23288
1697,a1209,20110707,4590,4601,4593,4615,4590,4613,4601,12,0,762,35059800,23290
1698,a1209,20110708,4613,4601,4625,4665,4525,4652,4637,51,36,4218,195599860,24452
1699,a1209,20110711,4652,4637,4652,4672,4649,4659,4660,22,23,2194,102257560,25448
1700,a1209,20110712,4659,4660,4650,4660,4631,4644,4646,-16,-14,2734,127048580,26558
1701,a1209,20110713,4644,4646,4662,4725,4662,4714,4692,68,46,3380,158610980,27048
1702,a1209,20110714,4714,4692,4727,4753,4726,4750,4734,58,42,2798,132463400,27232
1703,a1209,20110715,4750,4734,4744,4748,4728,4734,4733,0,-1,6638,314219300,30598
1704,a1209,20110718,4734,4733,4742,4755,4711,4716,4735,-17,2,3954,187226460,31588
1705,a1209,20110719,4716,4735,4726,4728,4703,4726,4716,-9,-19,1700,80185140,31582
1706,a1209,20110720,4726,4716,4723,4741,4708,4729,4725,13,9,1946,91958620,31772
1707,a1209,20110721,4729,4725,4720,4752,4720,4740,4738,15,13,1198,56766040,31794
1708,a1209,20110722,4740,4738,4748,4748,4738,4743,4741,5,3,720,34137520,31846
1709,a1209,20110725,4743,4741,4725,4728,4698,4700,4710,-41,-31,2616,123239440,31690
1710,a1209,20110726,4700,4710,4696,4723,4695,4722,4714,12,4,3066,144534860,32672
1711,a1209,20110727,4722,4714,4732,4762,4732,4762,4753,48,39,1478,70259180,32652
1712,a1209,20110728,4762,4753,4750,4750,4733,4737,4740,-16,-13,1212,57453920,32656
1713,a1209,20110729,4737,4740,4725,4748,4713,4720,4732,-20,-8,9478,448534500,38516
1714,a1209,20110801,4720,4732,4730,4794,4728,4792,4751,60,19,3786,179899900,39454
1715,a1209,20110802,4792,4751,4781,4803,4770,4784,4785,33,34,4846,231910760,39526
1716,a1209,20110803,4784,4785,4795,4830,4791,4794,4812,9,27,8994,432843420,41556
1717,a1209,20110804,4794,4812,4788,4800,4747,4747,4776,-65,-36,6692,319612220,41974
1718,a1209,20110805,4747,4776,4700,4701,4577,4639,4641,-137,-135,11554,536254720,44748
1719,a1209,20110808,4639,4641,4600,4655,4590,4611,4622,-30,-19,4762,220128600,44760
1720,a1209,20110809,4611,4622,4526,4570,4500,4558,4534,-64,-88,6226,282335800,45096
1721,a1209,20110810,4558,4534,4580,4605,4580,4594,4594,60,60,4674,214733200,47594
1722,a1209,20110811,4594,4594,4570,4655,4568,4650,4616,56,22,5596,258362180,48040
1723,a1209,20110812,4650,4616,4699,4699,4654,4656,4667,40,51,5544,258742480,47432
1724,a1209,20110815,4656,4667,4680,4728,4674,4712,4709,45,42,5314,250283420,47504
1725,a1209,20110816,4712,4709,4719,4719,4632,4661,4689,-48,-20,18008,844436480,55286
1726,a1209,20110817,4661,4689,4674,4695,4674,4689,4687,0,-2,3804,178307420,55234
1727,a1209,20110818,4689,4687,4710,4711,4681,4685,4691,-2,4,5258,246687540,57306
1728,a1209,20110819,4685,4691,4644,4679,4644,4673,4664,-18,-27,4018,187404420,57208
1729,a1209,20110822,4673,4664,4698,4714,4689,4693,4702,29,38,9198,432548100,57908
1730,a1209,20110823,4693,4702,4728,4738,4715,4738,4724,36,22,6804,321482020,57792
1731,a1209,20110824,4738,4724,4736,4738,4720,4724,4727,0,3,7432,351359140,58182
1732,a1209,20110825,4724,4727,4725,4725,4700,4715,4710,-12,-17,5656,266447500,58210
1733,a1209,20110826,4715,4710,4725,4727,4698,4705,4713,-5,3,5346,251960940,57650
1734,a1209,20110829,4705,4713,4756,4848,4751,4838,4799,125,86,28920,1388007820,68192
1735,a1209,20110830,4838,4799,4838,4858,4815,4826,4838,27,39,17374,840721300,70034
1736,a1209,20110831,4826,4838,4830,4866,4830,4852,4852,14,14,16086,780565360,71616
1737,a1209,20110901,4852,4852,4850,4876,4839,4843,4857,-9,5,14160,687771620,74724
1738,a1209,20110902,4843,4857,4855,4875,4832,4866,4863,9,6,34180,1662333680,89578
1739,a1209,20110905,4866,4863,4864,4942,4841,4853,4891,-10,28,49124,2402919560,96328
1740,a1209,20110906,4853,4891,4828,4851,4790,4828,4820,-63,-71,38220,1842372440,104504
1741,a1209,20110907,4828,4820,4845,4887,4836,4883,4856,63,36,32400,1573405180,110900
1742,a1209,20110908,4883,4856,4875,4876,4844,4858,4857,2,1,38516,1870919280,121328
1743,a1209,20110909,4858,4857,4850,4893,4849,4891,4871,34,14,32116,1564668140,126362
1744,a1209,20110913,4891,4871,4840,4840,4781,4787,4802,-84,-69,48870,2347002180,133068
1745,a1209,20110914,4787,4802,4798,4810,4726,4738,4762,-64,-40,41200,1962103740,133978
1746,a1209,20110915,4738,4762,4746,4760,4727,4745,4749,-17,-13,22332,1060677020,136988
1747,a1209,20110916,4745,4749,4700,4724,4698,4723,4708,-26,-41,34552,1626881140,139908
1748,a1209,20110919,4723,4708,4700,4707,4610,4615,4658,-93,-50,39380,1834493460,142584
1749,a1209,20110920,4615,4658,4625,4661,4625,4643,4649,-15,-9,27386,1273279440,149316
1750,a1209,20110921,4643,4649,4630,4652,4590,4640,4627,-9,-22,35258,1631668060,157596
1751,a1209,20110922,4640,4627,4559,4577,4520,4531,4552,-96,-75,78232,3561504060,185962
1752,a1209,20110923,4531,4552,4430,4507,4325,4380,4411,-172,-141,94670,4176353600,192734
1753,a1209,20110926,4380,4411,4375,4391,4230,4251,4333,-160,-78,91638,3970680780,205174
1754,a1209,20110927,4251,4333,4320,4378,4320,4363,4350,30,17,57656,2508561380,214730
1755,a1209,20110928,4363,4350,4328,4328,4290,4310,4309,-40,-41,38758,1670105420,215184
1756,a1209,20110929,4310,4309,4180,4249,4160,4242,4211,-67,-98,55608,2341773940,211292
1757,a1209,20110930,4242,4211,4256,4340,4256,4338,4301,127,90,46708,2009067180,203600
1758,a1209,20111010,4338,4301,4288,4346,4250,4291,4302,-10,1,68030,2926766060,219580
1759,a1209,20111011,4291,4302,4319,4341,4267,4279,4313,-23,11,89870,3876467080,251036
1760,a1209,20111012,4279,4313,4346,4383,4322,4373,4358,60,45,88062,3838071260,263958
1761,a1209,20111013,4373,4358,4360,4388,4359,4383,4372,25,14,54676,2390504440,275498
1762,a1209,20111014,4383,4372,4412,4419,4395,4410,4407,38,35,62878,2771399140,288456
1763,a1209,20111017,4410,4407,4425,4425,4378,4388,4396,-19,-11,63870,2808066760,291340
1764,a1209,20111018,4388,4396,4360,4365,4295,4307,4326,-89,-70,62872,2720017920,283852
1765,a1209,20111019,4307,4326,4326,4359,4313,4335,4339,9,13,40256,1746719240,280980
1766,a1209,20111020,4335,4339,4253,4282,4233,4270,4255,-69,-84,70344,2993598680,284544
1767,a1209,20111021,4270,4255,4300,4328,4288,4328,4317,73,62,57046,2463179160,284708
1768,a1209,20111024,4328,4317,4329,4420,4303,4399,4364,82,47,100322,4378658500,286528
1769,a1209,20111025,4399,4364,4404,4435,4381,4416,4411,52,47,103824,4579856840,290244
1770,a1209,20111026,4416,4411,4400,4434,4383,4419,4411,8,0,95542,4215083200,293704
1771,a1209,20111027,4419,4411,4408,4477,4401,4471,4454,60,43,198950,8862489380,320652
1772,a1209,20111028,4471,4454,4495,4498,4436,4440,4463,-14,9,145532,6495713860,311728
1773,a1209,20111031,4440,4463,4440,4443,4376,4386,4405,-77,-58,127318,5609007100,314302
1774,a1209,20111101,4386,4405,4400,4433,4395,4403,4414,-2,9,157494,6952896260,317078
1775,a1209,20111102,4403,4414,4395,4480,4372,4463,4413,49,-1,151122,6670261300,326000
1776,a1209,20111103,4463,4413,4420,4447,4400,4409,4421,-4,8,185122,8185559180,333928
1777,a1209,20111104,4409,4421,4481,4481,4430,4437,4445,16,24,144930,6443030080,331344
1778,a1209,20111107,4437,4445,4428,4440,4383,4394,4405,-51,-40,109080,4805283140,331354
1779,a1209,20111108,4394,4405,4388,4402,4358,4383,4379,-22,-26,140372,6147768820,327128
1780,a1209,20111109,4383,4379,4404,4406,4368,4379,4382,0,3,123738,5423159780,317036
1781,a1209,20111110,4379,4382,4329,4329,4271,4298,4298,-84,-84,183148,7872790600,302538
1782,a1209,20111111,4298,4298,4300,4324,4290,4313,4307,15,9,94784,4082970860,297582
1783,a1209,20111114,4313,4307,4338,4367,4326,4363,4346,56,39,124364,5405272020,301302
1784,a1209,20111115,4363,4346,4344,4392,4329,4385,4368,39,22,174736,7633003120,309968
1785,a1209,20111116,4385,4368,4398,4404,4340,4345,4368,-23,0,138432,6047503240,301144
1786,a1209,20111117,4345,4368,4349,4374,4325,4360,4353,-8,-15,95602,4162139460,300658
1787,a1209,20111118,4360,4353,4311,4332,4305,4332,4322,-21,-31,96714,4180132720,302310
1788,a1209,20111121,4332,4322,4326,4365,4320,4346,4344,24,22,131962,5732795520,305322
1789,a1209,20111122,4346,4344,4300,4324,4297,4308,4314,-36,-30,129044,5567582620,313150
1790,a1209,20111123,4308,4314,4321,4322,4253,4259,4277,-55,-37,214704,9183324900,325824
1791,a1209,20111124,4259,4277,4220,4270,4207,4245,4238,-32,-39,190812,8088159340,318886
1792,a1209,20111125,4245,4238,4222,4257,4201,4209,4226,-29,-12,157882,6673418140,326136
1793,a1209,20111128,4209,4226,4232,4249,4217,4227,4230,1,4,124098,5250570080,327990
1794,a1209,20111129,4227,4230,4229,4251,4222,4247,4235,17,5,109030,4617559860,317966
1795,a1209,20111130,4247,4235,4248,4250,4204,4210,4225,-25,-10,88578,3743202000,321948
1796,a1209,20111201,4210,4225,4285,4298,4263,4284,4280,59,55,132690,5679170520,298658
1797,a1209,20111202,4284,4280,4268,4279,4261,4272,4270,-8,-10,64070,2736268100,297228
1798,a1209,20111205,4272,4270,4281,4289,4275,4285,4282,15,12,55734,2386648640,303542
1799,a1209,20111206,4285,4282,4265,4271,4258,4269,4266,-13,-16,34494,1471564440,304498
1800,a1209,20111207,4269,4266,4281,4285,4270,4278,4276,12,10,33566,1435585600,303782
1801,a1209,20111208,4278,4276,4272,4273,4239,4250,4252,-26,-24,66124,2811698980,307344
1802,a1209,20111209,4250,4252,4241,4263,4236,4253,4253,1,1,51288,2181536300,306528
1803,a1209,20111212,4253,4253,4230,4247,4225,4227,4234,-26,-19,66172,2801998580,314780
1804,a1209,20111213,4227,4234,4229,4259,4229,4249,4248,15,14,107292,4558573380,315164
1805,a1209,20111214,4249,4248,4253,4269,4245,4259,4253,11,5,64994,2764291160,306128
1806,a1209,20111215,4259,4253,4230,4307,4230,4298,4278,45,25,236210,10106070260,310070
1807,a1209,20111216,4298,4278,4302,4320,4293,4319,4305,41,27,137498,5920051080,303470
1808,a1209,20111219,4319,4305,4323,4347,4314,4331,4332,26,27,175102,7586059820,304398
1809,a1209,20111220,4331,4332,4339,4339,4312,4319,4324,-13,-8,104414,4515709060,307198
1810,a1209,20111221,4319,4324,4330,4336,4301,4303,4317,-21,-7,94936,4099323940,309408
1811,a1209,20111222,4303,4317,4316,4319,4297,4311,4309,-6,-8,88326,3806461700,308604
1812,a1209,20111223,4311,4309,4329,4329,4312,4315,4319,6,10,82262,3552899360,298246
1813,a1209,20111226,4315,4319,4320,4347,4310,4319,4332,0,13,171720,7439388260,296730
1814,a1209,20111227,4319,4332,4319,4329,4298,4301,4313,-31,-19,78932,3405077820,293464
1815,a1209,20111228,4301,4313,4340,4343,4326,4337,4334,24,21,117180,5079376620,288828
1816,a1209,20111229,4337,4334,4320,4357,4319,4337,4344,3,10,154342,6704938160,286672
1817,a1209,20111230,4337,4344,4337,4349,4330,4340,4339,-4,-5,73914,3207155540,279024
1818,a1211,20110518,4605,4605,0,0,0,4605,4605,0,0,0,0,0
1819,a1211,20110519,4605,4605,0,0,0,4605,4605,0,0,0,0,0
1820,a1211,20110520,4605,4605,4471,4690,4471,4551,4576,-54,-29,12,549220,0
1821,a1211,20110523,4551,4576,0,0,0,4576,4576,0,0,0,0,0
1822,a1211,20110524,4576,4576,4653,4653,4600,4600,4626,24,50,4,185060,2
1823,a1211,20110525,4600,4626,0,0,0,4626,4626,0,0,0,0,2
1824,a1211,20110526,4626,4626,4638,4638,4627,4627,4632,1,6,4,185300,2
1825,a1211,20110527,4627,4632,0,0,0,4632,4632,0,0,0,0,2
1826,a1211,20110530,4632,4632,0,0,0,4632,4632,0,0,0,0,2
1827,a1211,20110531,4632,4632,0,0,0,4632,4632,0,0,0,0,2
1828,a1211,20110601,4632,4632,0,0,0,4632,4632,0,0,0,0,2
1829,a1211,20110602,4632,4632,0,0,0,4632,4632,0,0,0,0,2
1830,a1211,20110603,4632,4632,0,0,0,4632,4632,0,0,0,0,2
1831,a1211,20110607,4632,4632,0,0,0,4632,4632,0,0,0,0,2
1832,a1211,20110608,4632,4632,0,0,0,4632,4632,0,0,0,0,2
1833,a1211,20110609,4632,4632,0,0,0,4632,4632,0,0,0,0,2
1834,a1211,20110610,4632,4632,0,0,0,4632,4632,0,0,0,0,2
1835,a1211,20110613,4632,4632,0,0,0,4632,4632,0,0,0,0,2
1836,a1211,20110614,4632,4632,0,0,0,4632,4632,0,0,0,0,2
1837,a1211,20110615,4632,4632,4519,4640,4519,4640,4593,8,-39,6,275580,2
1838,a1211,20110616,4640,4593,0,0,0,4593,4593,0,0,0,0,2
1839,a1211,20110617,4593,4593,4501,4587,4501,4587,4544,-6,-49,4,181760,2
1840,a1211,20110620,4587,4544,0,0,0,4544,4544,0,0,0,0,2
1841,a1211,20110621,4544,4544,0,0,0,4544,4544,0,0,0,0,2
1842,a1211,20110622,4544,4544,0,0,0,4544,4544,0,0,0,0,2
1843,a1211,20110623,4544,4544,4582,4582,4328,4540,4516,-4,-28,50,2258340,10
1844,a1211,20110624,4540,4516,4530,4555,4530,4555,4541,39,25,6,272480,10
1845,a1211,20110627,4555,4541,0,0,0,4541,4541,0,0,0,0,10
1846,a1211,20110628,4541,4541,0,0,0,4541,4541,0,0,0,0,10
1847,a1211,20110629,4541,4541,4583,4583,4583,4583,4583,42,42,2,91660,10
1848,a1211,20110630,4583,4583,0,0,0,4583,4583,0,0,0,0,10
1849,a1211,20110701,4583,4583,0,0,0,4583,4583,0,0,0,0,10
1850,a1211,20110704,4583,4583,0,0,0,4583,4583,0,0,0,0,10
1851,a1211,20110705,4583,4583,4601,4630,4585,4620,4607,37,24,32,1474520,24
1852,a1211,20110706,4620,4607,4628,4628,4614,4614,4621,7,14,4,184840,24
1853,a1211,20110707,4614,4621,4618,4618,4618,4618,4618,-3,-3,2,92360,24
1854,a1211,20110708,4618,4618,4680,4700,4658,4700,4686,82,68,12,562420,28
1855,a1211,20110711,4700,4686,4708,4708,4692,4706,4704,20,18,18,846840,30
1856,a1211,20110712,4706,4704,0,0,0,4704,4704,0,0,0,0,30
1857,a1211,20110713,4704,4704,4729,4729,4729,4729,4729,25,25,2,94580,32
1858,a1211,20110714,4729,4729,4780,4810,4765,4810,4780,81,51,12,573700,36
1859,a1211,20110715,4810,4780,0,0,0,4780,4780,0,0,0,0,36
1860,a1211,20110718,4780,4780,4800,4800,4800,4800,4800,20,20,2,96000,36
1861,a1211,20110719,4800,4800,0,0,0,4800,4800,0,0,0,0,36
1862,a1211,20110720,4800,4800,0,0,0,4800,4800,0,0,0,0,36
1863,a1211,20110721,4800,4800,4780,4780,4771,4771,4778,-29,-22,12,573420,34
1864,a1211,20110722,4771,4778,0,0,0,4778,4778,0,0,0,0,34
1865,a1211,20110725,4778,4778,4741,4780,4741,4745,4755,-33,-23,28,1331520,26
1866,a1211,20110726,4745,4755,4750,4750,4750,4750,4750,-5,-5,4,190000,24
1867,a1211,20110727,4750,4750,4776,4776,4776,4776,4776,26,26,4,191040,26
1868,a1211,20110728,4776,4776,4789,4789,4777,4777,4780,1,4,12,573680,28
1869,a1211,20110729,4777,4780,0,0,0,4780,4780,0,0,0,0,28
1870,a1211,20110801,4780,4780,4767,4785,4767,4785,4777,5,-3,10,477720,24
1871,a1211,20110802,4785,4777,4790,4790,4790,4790,4790,13,13,2,95800,24
1872,a1211,20110803,4790,4790,4823,4823,4813,4813,4818,23,28,4,192720,24
1873,a1211,20110804,4813,4818,0,0,0,4818,4818,0,0,0,0,24
1874,a1211,20110805,4818,4818,4690,4705,4687,4687,4693,-131,-125,8,375440,26
1875,a1211,20110808,4687,4693,4655,4655,4655,4655,4655,-38,-38,2,93100,26
1876,a1211,20110809,4655,4655,0,0,0,4655,4655,0,0,0,0,26
1877,a1211,20110810,4655,4655,4658,4658,4621,4630,4629,-25,-26,42,1944580,36
1878,a1211,20110811,4630,4629,4634,4668,4610,4661,4641,32,12,24,1113920,32
1879,a1211,20110812,4661,4641,4681,4687,4681,4687,4684,46,43,4,187360,30
1880,a1211,20110815,4687,4684,4718,4745,4718,4745,4730,61,46,26,1229840,20
1881,a1211,20110816,4745,4730,4707,4707,4700,4700,4704,-30,-26,6,282240,24
1882,a1211,20110817,4700,4704,4722,4722,4693,4707,4707,3,3,12,564940,20
1883,a1211,20110818,4707,4707,0,0,0,4707,4707,0,0,0,0,20
1884,a1211,20110819,4707,4707,4675,4675,4675,4675,4675,-32,-32,2,93500,20
1885,a1211,20110822,4675,4675,4722,4749,4699,4699,4723,24,48,6,283400,20
1886,a1211,20110823,4699,4723,4740,4743,4740,4743,4741,20,18,4,189660,16
1887,a1211,20110824,4743,4741,0,0,0,4741,4741,0,0,0,0,16
1888,a1211,20110825,4741,4741,0,0,0,4741,4741,0,0,0,0,16
1889,a1211,20110826,4741,4741,0,0,0,4741,4741,0,0,0,0,16
1890,a1211,20110829,4741,4741,4804,4851,4804,4851,4834,110,93,14,676800,16
1891,a1211,20110830,4851,4834,4840,4840,4831,4831,4833,-3,-1,8,386700,18
1892,a1211,20110831,4831,4833,4820,4820,4820,4820,4820,-13,-13,2,96400,18
1893,a1211,20110901,4820,4820,4837,4868,4821,4835,4841,15,21,18,871480,22
1894,a1211,20110902,4835,4841,4876,4876,4876,4876,4876,35,35,2,97520,22
1895,a1211,20110905,4876,4876,4911,4911,4911,4911,4911,35,35,4,196440,18
1896,a1211,20110906,4911,4911,4831,4831,4800,4831,4821,-80,-90,16,771460,26
1897,a1211,20110907,4831,4821,4845,4855,4845,4855,4852,34,31,10,485280,22
1898,a1211,20110908,4855,4852,4848,4848,4844,4844,4845,-8,-7,6,290720,18
1899,a1211,20110909,4844,4845,0,0,0,4845,4845,0,0,0,0,18
1900,a1211,20110913,4845,4845,4785,4785,4771,4771,4778,-74,-67,4,191120,18
1901,a1211,20110914,4771,4778,4753,4753,4733,4733,4745,-45,-33,6,284700,18
1902,a1211,20110915,4733,4745,4720,4744,4720,4724,4729,-21,-16,8,378360,24
1903,a1211,20110916,4724,4729,0,0,0,4729,4729,0,0,0,0,24
1904,a1211,20110919,4729,4729,4681,4683,4630,4630,4661,-99,-68,14,652600,28
1905,a1211,20110920,4630,4661,4635,4635,4635,4635,4635,-26,-26,2,92700,28
1906,a1211,20110921,4635,4635,4630,4630,4630,4630,4630,-5,-5,2,92600,28
1907,a1211,20110922,4630,4630,4505,4604,4505,4599,4558,-31,-72,8,364700,28
1908,a1211,20110923,4599,4558,4500,4500,4367,4367,4457,-191,-101,10,445740,28
1909,a1211,20110926,4367,4457,4371,4371,4371,4371,4371,-86,-86,4,174840,26
1910,a1211,20110927,4371,4371,0,0,0,4371,4371,0,0,0,0,26
1911,a1211,20110928,4371,4371,4310,4310,4310,4310,4310,-61,-61,2,86200,24
1912,a1211,20110929,4310,4310,4277,4277,4277,4277,4277,-33,-33,2,85540,22
1913,a1211,20110930,4277,4277,4354,4355,4354,4355,4354,78,77,6,261260,20
1914,a1211,20111010,4355,4354,0,0,0,4354,4354,0,0,0,0,20
1915,a1211,20111011,4354,4354,4385,4385,4301,4301,4333,-53,-21,18,780020,26
1916,a1211,20111012,4301,4333,4435,4455,4350,4350,4398,17,65,66,2903320,50
1917,a1211,20111013,4350,4398,4350,4350,4350,4350,4350,-48,-48,2,87000,48
1918,a1211,20111014,4350,4350,4377,4390,4377,4390,4383,40,33,4,175340,50
1919,a1211,20111017,4390,4383,4376,4376,4370,4370,4373,-13,-10,4,174920,50
1920,a1211,20111018,4370,4373,0,0,0,4373,4373,0,0,0,0,50
1921,a1211,20111019,4373,4373,0,0,0,4373,4373,0,0,0,0,50
1922,a1211,20111020,4373,4373,4201,4280,4162,4260,4237,-113,-136,22,932340,52
1923,a1211,20111021,4260,4237,0,0,0,4237,4237,0,0,0,0,52
1924,a1211,20111024,4237,4237,4383,4383,4383,4383,4383,146,146,2,87660,50
1925,a1211,20111025,4383,4383,0,0,0,4383,4383,0,0,0,0,50
1926,a1211,20111026,4383,4383,0,0,0,4383,4383,0,0,0,0,50
1927,a1211,20111027,4383,4383,0,0,0,4383,4383,0,0,0,0,50
1928,a1211,20111028,4383,4383,4421,4421,4421,4421,4421,38,38,2,88420,52
1929,a1211,20111031,4421,4421,4483,4483,4333,4401,4399,-20,-22,8,351940,52
1930,a1211,20111101,4401,4399,0,0,0,4399,4399,0,0,0,0,52
1931,a1211,20111102,4399,4399,0,0,0,4399,4399,0,0,0,0,52
1932,a1211,20111103,4399,4399,0,0,0,4399,4399,0,0,0,0,52
1933,a1211,20111104,4399,4399,0,0,0,4399,4399,0,0,0,0,52
1934,a1211,20111107,4399,4399,0,0,0,4399,4399,0,0,0,0,52
1935,a1211,20111108,4399,4399,4358,4371,4358,4371,4366,-28,-33,10,436660,50
1936,a1211,20111109,4371,4366,0,0,0,4366,4366,0,0,0,0,50
1937,a1211,20111110,4366,4366,4363,4363,4286,4286,4324,-80,-42,4,172980,52
1938,a1211,20111111,4286,4324,4297,4297,4297,4297,4297,-27,-27,2,85940,52
1939,a1211,20111114,4297,4297,4300,4337,4300,4328,4331,31,34,32,1386100,70
1940,a1211,20111115,4328,4331,4306,4306,4305,4305,4305,-26,-26,4,172220,66
1941,a1211,20111116,4305,4305,4380,4380,4322,4326,4350,21,45,12,522020,66
1942,a1211,20111117,4326,4350,4340,4350,4338,4338,4342,-12,-8,18,781620,66
1943,a1211,20111118,4338,4342,4314,4314,4314,4314,4314,-28,-28,2,86280,68
1944,a1211,20111121,4314,4314,4315,4340,4310,4327,4323,13,9,10,432340,70
1945,a1211,20111122,4327,4323,4300,4300,4296,4296,4297,-27,-26,30,1289340,72
1946,a1211,20111123,4296,4297,4256,4256,4205,4205,4222,-92,-75,6,253320,74
1947,a1211,20111124,4205,4222,4239,4239,4223,4226,4228,4,6,14,591960,80
1948,a1211,20111125,4226,4228,4219,4219,4219,4219,4219,-9,-9,12,506280,92
1949,a1211,20111128,4219,4219,0,0,0,4219,4219,0,0,0,0,92
1950,a1211,20111129,4219,4219,4208,4208,4208,4208,4208,-11,-11,2,84160,94
1951,a1211,20111130,4208,4208,0,0,0,4208,4208,0,0,0,0,94
1952,a1211,20111201,4208,4208,4295,4295,4251,4262,4268,54,60,28,1195300,104
1953,a1211,20111202,4262,4268,4252,4252,4252,4252,4252,-16,-16,2,85040,106
1954,a1211,20111205,4252,4252,0,0,0,4252,4252,0,0,0,0,106
1955,a1211,20111206,4252,4252,4247,4247,4221,4242,4234,-10,-18,16,677500,108
1956,a1211,20111207,4242,4234,4244,4250,4244,4250,4246,16,12,6,254760,108
1957,a1211,20111208,4250,4246,0,0,0,4246,4246,0,0,0,0,108
1958,a1211,20111209,4246,4246,0,0,0,4246,4246,0,0,0,0,108
1959,a1211,20111212,4246,4246,0,0,0,4246,4246,0,0,0,0,108
1960,a1211,20111213,4246,4246,0,0,0,4246,4246,0,0,0,0,108
1961,a1211,20111214,4246,4246,4225,4225,4225,4225,4225,-21,-21,4,169000,104
1962,a1211,20111215,4225,4225,4225,4284,4225,4275,4259,50,34,22,937180,110
1963,a1211,20111216,4275,4259,4272,4289,4267,4289,4274,30,15,24,1025780,110
1964,a1211,20111219,4289,4274,4308,4309,4284,4303,4299,29,25,32,1375820,116
1965,a1211,20111220,4303,4299,4300,4300,4286,4287,4293,-12,-6,20,858620,124
1966,a1211,20111221,4287,4293,4289,4289,4282,4282,4285,-11,-8,4,171420,124
1967,a1211,20111222,4282,4285,4289,4289,4276,4276,4284,-9,-1,6,257080,126
1968,a1211,20111223,4276,4284,4290,4290,4289,4290,4289,6,5,10,428980,134
1969,a1211,20111226,4290,4289,4308,4317,4291,4317,4309,28,20,24,1034260,140
1970,a1211,20111227,4317,4309,0,0,0,4309,4309,0,0,0,0,140
1971,a1211,20111228,4309,4309,4283,4313,4280,4310,4291,1,-18,28,1201680,140
1972,a1211,20111229,4310,4291,4305,4320,4305,4315,4315,24,24,34,1467200,142
1973,a1211,20111230,4315,4315,4318,4323,4302,4323,4315,8,0,8,345220,142
1974,a1301,20110718,4803,4799,4801,4810,4789,4790,4794,-9,-5,74,3547900,180
1975,a1301,20110719,4790,4794,4781,4792,4780,4792,4784,-2,-10,20,956920,190
1976,a1301,20110720,4792,4784,4790,4806,4790,4804,4798,20,14,30,1439580,186
1977,a1301,20110721,4804,4798,4801,4815,4799,4815,4810,17,12,72,3463740,230
1978,a1301,20110722,4815,4810,4801,4810,4790,4790,4797,-20,-13,118,5661460,192
1979,a1301,20110725,4790,4797,4800,4800,4770,4774,4781,-23,-16,74,3538100,198
1980,a1301,20110726,4774,4781,4776,4776,4770,4771,4771,-10,-10,74,3530980,170
1981,a1301,20110727,4771,4771,4789,4805,4789,4805,4797,34,26,46,2207020,170
1982,a1301,20110728,4805,4797,4797,4797,4790,4794,4793,-3,-4,20,958660,182
1983,a1301,20110729,4794,4793,4781,4800,4772,4774,4786,-19,-7,30,1435800,196
1984,a1301,20110801,4774,4786,4790,4844,4788,4844,4807,58,21,124,5961560,226
1985,a1301,20110802,4844,4807,4825,4835,4811,4818,4822,11,15,508,24496340,548
1986,a1301,20110803,4818,4822,4870,4870,4822,4822,4841,0,19,694,33602460,1018
1987,a1301,20110804,4822,4841,4823,4823,4791,4793,4806,-48,-35,142,6824540,1016
1988,a1301,20110805,4793,4806,4750,4750,4670,4704,4714,-102,-92,162,7637480,1020
1989,a1301,20110808,4704,4714,4698,4715,4665,4681,4696,-33,-18,212,9956240,906
1990,a1301,20110809,4681,4696,4600,4635,4575,4620,4605,-76,-91,94,4329020,914
1991,a1301,20110810,4620,4605,4645,4650,4640,4649,4645,44,40,52,2415440,916
1992,a1301,20110811,4649,4645,4645,4693,4645,4693,4674,48,29,58,2711040,920
1993,a1301,20110812,4693,4674,4736,4736,4701,4703,4714,29,40,54,2545800,938
1994,a1301,20110815,4703,4714,4731,4769,4731,4755,4752,41,38,64,3041880,960
1995,a1301,20110816,4755,4752,4752,4760,4731,4733,4752,-19,0,112,5323320,952
1996,a1301,20110817,4733,4752,4756,4757,4740,4743,4745,-9,-7,38,1803420,954
1997,a1301,20110818,4743,4745,4731,4750,4731,4739,4743,-6,-2,60,2846140,968
1998,a1301,20110819,4739,4743,4711,4724,4707,4719,4714,-24,-29,20,942980,962
1999,a1301,20110822,4719,4714,4714,4762,4714,4746,4748,32,34,86,4083620,974
2000,a1301,20110823,4746,4748,4762,4788,4761,4788,4771,40,23,182,8684720,1078
2001,a1301,20110824,4788,4771,4800,4800,4765,4773,4775,2,4,58,2769560,1100
2002,a1301,20110825,4773,4775,4762,4767,4752,4766,4759,-9,-16,98,4664680,1092
2003,a1301,20110826,4766,4759,4762,4785,4755,4764,4768,5,9,240,11444980,1120
2004,a1301,20110829,4764,4768,4799,4853,4799,4839,4821,71,53,5594,269734740,5876
2005,a1301,20110830,4839,4821,4848,4877,4808,4815,4834,-6,13,2014,97361400,6968
2006,a1301,20110831,4815,4834,4819,4830,4811,4815,4825,-19,-9,1006,48542020,7212
2007,a1301,20110901,4815,4825,4820,4848,4811,4811,4826,-14,1,430,20751840,7320
2008,a1301,20110902,4811,4826,4815,4840,4810,4822,4822,-4,-4,2818,135885760,9282
2009,a1301,20110905,4822,4822,4824,4887,4812,4817,4850,-5,28,686,33271860,9286
2010,a1301,20110906,4817,4850,4810,4819,4778,4799,4792,-51,-58,2148,102939620,10144
2011,a1301,20110907,4799,4792,4805,4849,4802,4845,4825,53,33,2328,112333580,10716
2012,a1301,20110908,4845,4825,4840,4840,4823,4829,4830,4,5,500,24151380,10868
2013,a1301,20110909,4829,4830,4825,4860,4825,4859,4840,29,10,594,28754480,10876
2014,a1301,20110913,4859,4840,4799,4810,4752,4758,4767,-82,-73,1994,95070580,11458
2015,a1301,20110914,4758,4767,4768,4772,4700,4710,4736,-57,-31,1228,58164620,12050
2016,a1301,20110915,4710,4736,4720,4722,4692,4695,4703,-41,-33,4218,198396140,14046
2017,a1301,20110916,4695,4703,4669,4673,4644,4649,4654,-54,-49,2066,96161220,14496
2018,a1301,20110919,4649,4654,4640,4640,4566,4566,4606,-88,-48,1290,59418580,14580
2019,a1301,20110920,4566,4606,4600,4605,4582,4597,4596,-9,-10,1154,53044300,14636
2020,a1301,20110921,4597,4596,4592,4621,4550,4596,4590,0,-6,6760,310336660,19656
2021,a1301,20110922,4596,4590,4552,4553,4502,4532,4538,-58,-52,2904,131787840,20782
2022,a1301,20110923,4532,4538,4457,4519,4330,4385,4444,-153,-94,8174,363316840,22082
2023,a1301,20110926,4385,4444,4379,4381,4230,4241,4346,-203,-98,5342,232171180,23630
2024,a1301,20110927,4241,4346,4336,4355,4300,4344,4331,-2,-15,4152,179858340,23032
2025,a1301,20110928,4344,4331,4304,4317,4289,4306,4306,-25,-25,5586,240551840,23236
2026,a1301,20110929,4306,4306,4200,4248,4146,4238,4204,-68,-102,3142,132102200,23464
2027,a1301,20110930,4238,4204,4245,4338,4245,4338,4299,134,95,1336,57447900,23246
2028,a1301,20111010,4338,4299,4200,4345,4200,4295,4296,-4,-3,3656,157079920,25180
2029,a1301,20111011,4295,4296,4300,4345,4258,4267,4308,-29,12,4542,195699780,27844
2030,a1301,20111012,4267,4308,4340,4365,4311,4355,4347,47,39,4488,195117140,28364
2031,a1301,20111013,4355,4347,4350,4355,4315,4337,4327,-10,-20,10720,463907860,31124
2032,a1301,20111014,4337,4327,4355,4370,4346,4363,4361,36,34,3178,138607600,31184
2033,a1301,20111017,4363,4361,4381,4381,4346,4355,4364,-6,3,2014,87891960,31214
2034,a1301,20111018,4355,4364,4335,4344,4278,4282,4306,-82,-58,1594,68650780,31276
2035,a1301,20111019,4282,4306,4306,4327,4286,4305,4308,-1,2,1866,80395420,31306
2036,a1301,20111020,4305,4308,4256,4256,4210,4250,4233,-58,-75,2526,106934740,31256
2037,a1301,20111021,4250,4233,4261,4300,4261,4299,4290,66,57,1328,56976500,30932
2038,a1301,20111024,4299,4290,4292,4390,4285,4371,4330,81,40,4142,179367020,31580
2039,a1301,20111025,4371,4330,4366,4405,4358,4367,4377,37,47,4684,205027000,33236
2040,a1301,20111026,4367,4377,4354,4387,4337,4370,4369,-7,-8,2796,122179540,34096
2041,a1301,20111027,4370,4369,4360,4420,4360,4419,4402,50,33,4554,200477400,34256
2042,a1301,20111028,4419,4402,4415,4444,4392,4394,4410,-8,8,5006,220796480,36282
2043,a1301,20111031,4394,4410,4389,4394,4354,4357,4374,-53,-36,2748,120204120,36522
2044,a1301,20111101,4357,4374,4362,4404,4362,4382,4389,8,15,3958,173736760,36682
2045,a1301,20111102,4382,4389,4366,4440,4360,4420,4379,31,-10,7566,331332960,41306
2046,a1301,20111103,4420,4379,4401,4404,4369,4373,4384,-6,5,5246,229991560,42340
2047,a1301,20111104,4373,4384,4414,4421,4395,4402,4404,18,20,4800,211409580,44134
2048,a1301,20111107,4402,4404,4397,4401,4343,4358,4365,-46,-39,5556,242567160,46388
2049,a1301,20111108,4358,4365,4349,4362,4321,4346,4342,-19,-23,3878,168402920,47372
2050,a1301,20111109,4346,4342,4345,4365,4331,4340,4344,-2,2,3186,138428440,48352
2051,a1301,20111110,4340,4344,4313,4313,4243,4261,4264,-83,-80,9566,407930460,52260
2052,a1301,20111111,4261,4264,4260,4280,4255,4272,4268,8,4,3458,147597060,54040
2053,a1301,20111114,4272,4268,4289,4308,4283,4307,4293,39,25,8656,371611120,56232
2054,a1301,20111115,4307,4293,4290,4339,4280,4330,4309,37,16,4672,201341060,56290
2055,a1301,20111116,4330,4309,4340,4349,4296,4304,4316,-5,7,4218,182062780,56480
2056,a1301,20111117,4304,4316,4313,4334,4295,4320,4318,4,2,7488,323352560,58292
2057,a1301,20111118,4320,4318,4296,4298,4275,4295,4292,-23,-26,6556,281406040,61076
2058,a1301,20111121,4295,4292,4295,4317,4283,4301,4300,9,8,5658,243349900,62458
2059,a1301,20111122,4301,4300,4270,4290,4265,4272,4278,-28,-22,4410,188686240,62886
2060,a1301,20111123,4272,4278,4283,4283,4222,4231,4242,-47,-36,16484,699277340,71310
2061,a1301,20111124,4231,4242,4200,4232,4177,4207,4204,-35,-38,6556,275620100,73228
2062,a1301,20111125,4207,4204,4192,4220,4167,4174,4185,-30,-19,8572,358815080,74736
2063,a1301,20111128,4174,4185,4194,4209,4190,4196,4201,11,16,4598,193181880,74936
2064,a1301,20111129,4196,4201,4203,4218,4193,4216,4206,15,5,4070,171199980,75760
2065,a1301,20111130,4216,4206,4206,4215,4180,4180,4197,-26,-9,2060,86475920,76072
2066,a1301,20111201,4180,4197,4219,4263,4219,4251,4247,54,50,5874,249509640,76046
2067,a1301,20111202,4251,4247,4247,4258,4231,4237,4239,-10,-8,3804,161276700,77198
2068,a1301,20111205,4237,4239,4242,4251,4240,4250,4247,11,8,3110,132082200,78194
2069,a1301,20111206,4250,4247,4238,4238,4225,4233,4231,-14,-16,1694,71679580,78472
2070,a1301,20111207,4233,4231,4241,4248,4236,4241,4242,10,11,1802,76442800,78658
2071,a1301,20111208,4241,4242,4235,4248,4203,4214,4215,-28,-27,3470,146262580,79708
2072,a1301,20111209,4214,4215,4211,4227,4204,4219,4220,4,5,2674,112849180,79856
2073,a1301,20111212,4219,4220,4190,4211,4190,4190,4198,-30,-22,3858,161977720,80742
2074,a1301,20111213,4190,4198,4200,4215,4192,4209,4207,11,9,5080,213731960,81204
2075,a1301,20111214,4209,4207,4210,4230,4206,4222,4218,15,11,12228,515861260,83688
2076,a1301,20111215,4222,4218,4200,4270,4195,4265,4239,47,21,15118,640988380,84842
2077,a1301,20111216,4265,4239,4271,4280,4255,4275,4267,36,28,11478,489833900,86172
2078,a1301,20111219,4275,4267,4288,4306,4281,4297,4296,30,29,11572,497139440,86856
2079,a1301,20111220,4297,4296,4296,4300,4278,4285,4288,-11,-8,11156,478441980,85592
2080,a1301,20111221,4285,4288,4296,4298,4267,4267,4282,-21,-6,8568,366919360,86858
2081,a1301,20111222,4267,4282,4282,4282,4264,4275,4274,-7,-8,4152,177487680,86914
2082,a1301,20111223,4275,4274,4274,4293,4274,4283,4283,9,9,10088,432138620,91618
2083,a1301,20111226,4283,4283,4286,4311,4281,4290,4296,7,13,12110,520273980,92916
2084,a1301,20111227,4290,4296,4286,4295,4274,4275,4283,-21,-13,4608,197393260,92810
2085,a1301,20111228,4275,4283,4310,4316,4296,4307,4303,24,20,9084,390942840,92286
2086,a1301,20111229,4307,4303,4298,4320,4292,4304,4310,1,7,11454,493676240,92834
2087,a1301,20111230,4304,4310,4309,4314,4300,4307,4305,-3,-5,13052,562009640,96576
2088,a1303,20110919,4761,4761,0,0,0,4761,4761,0,0,0,0,0
2089,a1303,20110920,4761,4761,4731,4731,4638,4644,4663,-117,-98,16,746120,12
2090,a1303,20110921,4644,4663,0,0,0,4663,4663,0,0,0,0,12
2091,a1303,20110922,4663,4663,0,0,0,4663,4663,0,0,0,0,12
2092,a1303,20110923,4663,4663,4545,4545,4431,4431,4457,-232,-206,10,445740,16
2093,a1303,20110926,4431,4457,4350,4370,4338,4338,4356,-119,-101,46,2004080,16
2094,a1303,20110927,4338,4356,0,0,0,4356,4356,0,0,0,0,16
2095,a1303,20110928,4356,4356,0,0,0,4356,4356,0,0,0,0,16
2096,a1303,20110929,4356,4356,4171,4300,4171,4300,4226,-56,-130,6,253600,16
2097,a1303,20110930,4300,4226,4330,4330,4330,4330,4330,104,104,2,86600,14
2098,a1303,20111010,4330,4330,0,0,0,4330,4330,0,0,0,0,14
2099,a1303,20111011,4330,4330,4301,4301,4271,4271,4280,-59,-50,12,513700,18
2100,a1303,20111012,4271,4280,0,0,0,4280,4280,0,0,0,0,18
2101,a1303,20111013,4280,4280,0,0,0,4280,4280,0,0,0,0,18
2102,a1303,20111014,4280,4280,4366,4370,4366,4366,4366,86,86,46,2008600,56
2103,a1303,20111017,4366,4366,4370,4370,4354,4354,4360,-12,-6,32,1395340,78
2104,a1303,20111018,4354,4360,4300,4303,4300,4303,4301,-57,-59,4,172060,80
2105,a1303,20111019,4303,4301,4319,4319,4319,4319,4319,18,18,2,86380,80
2106,a1303,20111020,4319,4319,0,0,0,4319,4319,0,0,0,0,80
2107,a1303,20111021,4319,4319,4299,4309,4280,4298,4298,-21,-21,18,773680,80
2108,a1303,20111024,4298,4298,4250,4368,4250,4368,4296,70,-2,22,945320,80
2109,a1303,20111025,4368,4296,4379,4393,4362,4362,4371,66,75,24,1049180,92
2110,a1303,20111026,4362,4371,4398,4398,4377,4377,4387,6,16,12,526520,92
2111,a1303,20111027,4377,4387,4379,4418,4379,4418,4402,31,15,24,1056520,92
2112,a1303,20111028,4418,4402,4429,4430,4396,4396,4408,-6,6,24,1057940,92
2113,a1303,20111031,4396,4408,4377,4377,4377,4377,4377,-31,-31,2,87540,92
2114,a1303,20111101,4377,4377,4403,4403,4385,4387,4393,10,16,18,790760,92
2115,a1303,20111102,4387,4393,4405,4415,4405,4415,4407,22,14,8,352600,92
2116,a1303,20111103,4415,4407,4372,4372,4372,4372,4372,-35,-35,2,87440,94
2117,a1303,20111104,4372,4372,0,0,0,4372,4372,0,0,0,0,94
2118,a1303,20111107,4372,4372,4355,4365,4355,4365,4364,-7,-8,34,1483880,106
2119,a1303,20111108,4365,4364,4349,4349,4349,4349,4349,-15,-15,2,86980,108
2120,a1303,20111109,4349,4349,4341,4341,4341,4341,4341,-8,-8,10,434100,110
2121,a1303,20111110,4341,4341,4287,4290,4260,4270,4274,-71,-67,24,1025900,112
2122,a1303,20111111,4270,4274,0,0,0,4274,4274,0,0,0,0,112
2123,a1303,20111114,4274,4274,0,0,0,4274,4274,0,0,0,0,112
2124,a1303,20111115,4274,4274,4331,4388,4331,4359,4359,85,85,12,523160,104
2125,a1303,20111116,4359,4359,4339,4339,4339,4339,4339,-20,-20,2,86780,104
2126,a1303,20111117,4339,4339,4380,4380,4369,4369,4374,30,35,4,174980,106
2127,a1303,20111118,4369,4374,0,0,0,4374,4374,0,0,0,0,106
2128,a1303,20111121,4374,4374,0,0,0,4374,4374,0,0,0,0,106
2129,a1303,20111122,4374,4374,0,0,0,4374,4374,0,0,0,0,106
2130,a1303,20111123,4374,4374,4303,4303,4258,4265,4283,-109,-91,18,771000,108
2131,a1303,20111124,4265,4283,4270,4270,4270,4270,4270,-13,-13,2,85400,106
2132,a1303,20111125,4270,4270,4160,4160,4160,4160,4160,-110,-110,4,166400,108
2133,a1303,20111128,4160,4160,4185,4239,4170,4238,4214,78,54,10,421400,106
2134,a1303,20111129,4238,4214,4255,4270,4255,4270,4266,56,52,10,426620,106
2135,a1303,20111130,4270,4266,0,0,0,4266,4266,0,0,0,0,106
2136,a1303,20111201,4266,4266,0,0,0,4266,4266,0,0,0,0,106
2137,a1303,20111202,4266,4266,4270,4288,4270,4288,4276,22,10,16,684280,104
2138,a1303,20111205,4288,4276,0,0,0,4276,4276,0,0,0,0,104
2139,a1303,20111206,4276,4276,0,0,0,4276,4276,0,0,0,0,104
2140,a1303,20111207,4276,4276,0,0,0,4276,4276,0,0,0,0,104
2141,a1303,20111208,4276,4276,4276,4276,4268,4268,4270,-8,-6,6,256240,104
2142,a1303,20111209,4268,4270,0,0,0,4270,4270,0,0,0,0,104
2143,a1303,20111212,4270,4270,0,0,0,4270,4270,0,0,0,0,104
2144,a1303,20111213,4270,4270,0,0,0,4270,4270,0,0,0,0,104
2145,a1303,20111214,4270,4270,0,0,0,4270,4270,0,0,0,0,104
2146,a1303,20111215,4270,4270,4278,4278,4278,4278,4278,8,8,2,85560,104
2147,a1303,20111216,4278,4278,4328,4328,4306,4306,4317,28,39,4,172680,104
2148,a1303,20111219,4306,4317,0,0,0,4317,4317,0,0,0,0,104
2149,a1303,20111220,4317,4317,4319,4319,4319,4319,4319,2,2,2,86380,104
2150,a1303,20111221,4319,4319,0,0,0,4319,4319,0,0,0,0,104
2151,a1303,20111222,4319,4319,0,0,0,4319,4319,0,0,0,0,104
2152,a1303,20111223,4319,4319,0,0,0,4319,4319,0,0,0,0,104
2153,a1303,20111226,4319,4319,4345,4345,4345,4345,4345,26,26,2,86900,102
2154,a1303,20111227,4345,4345,4345,4345,4345,4345,4345,0,0,10,434500,102
2155,a1303,20111228,4345,4345,4343,4343,4343,4343,4343,-2,-2,8,347440,102
2156,a1303,20111229,4343,4343,4357,4357,4357,4357,4357,14,14,4,174280,102
2157,a1303,20111230,4357,4357,4340,4340,4340,4340,4340,-17,-17,2,86800,102
2158,a1305,20111116,4390,4377,4419,4419,4370,4382,4383,5,6,162,7101360,184
2159,a1305,20111117,4382,4383,4380,4440,4374,4422,4408,39,25,186,8198900,308
2160,a1305,20111118,4422,4408,4400,4405,4389,4395,4401,-13,-7,42,1848460,322
2161,a1305,20111121,4395,4401,4385,4412,4385,4406,4403,5,2,94,4138960,356
2162,a1305,20111122,4406,4403,4382,4390,4371,4374,4381,-29,-22,92,4030980,364
2163,a1305,20111123,4374,4381,4383,4383,4319,4326,4345,-55,-36,102,4432180,368
2164,a1305,20111124,4326,4345,4340,4340,4279,4309,4304,-36,-41,202,8694580,416
2165,a1305,20111125,4309,4304,4288,4316,4279,4286,4300,-18,-4,112,4816400,458
2166,a1305,20111128,4286,4300,4299,4312,4290,4292,4300,-8,0,58,2494000,474
2167,a1305,20111129,4292,4300,4308,4322,4301,4322,4314,22,14,322,13894080,724
2168,a1305,20111130,4322,4314,4324,4324,4293,4298,4311,-16,-3,158,6812720,802
2169,a1305,20111201,4298,4311,4361,4370,4341,4368,4359,57,48,232,10113680,850
2170,a1305,20111202,4368,4359,4355,4360,4347,4355,4353,-4,-6,352,15325160,1018
2171,a1305,20111205,4355,4353,4360,4373,4360,4373,4368,20,15,50,2184220,1024
2172,a1305,20111206,4373,4368,4360,4360,4348,4359,4355,-9,-13,42,1829100,1042
2173,a1305,20111207,4359,4355,4370,4370,4360,4363,4365,8,10,62,2706860,1054
2174,a1305,20111208,4363,4365,4353,4353,4333,4344,4342,-21,-23,134,5818880,1136
2175,a1305,20111209,4344,4342,4346,4356,4343,4352,4349,10,7,46,2000540,1138
2176,a1305,20111212,4352,4349,4339,4339,4330,4330,4334,-19,-15,76,3293980,1210
2177,a1305,20111213,4330,4334,4349,4350,4343,4347,4348,13,14,34,1478340,1236
2178,a1305,20111214,4347,4348,4346,4362,4346,4362,4355,14,7,86,3745560,1266
2179,a1305,20111215,4362,4355,4345,4400,4345,4397,4377,42,22,222,9719020,1380
2180,a1305,20111216,4397,4377,4395,4401,4343,4356,4363,-21,-14,1392,60741280,1646
2181,a1305,20111219,4356,4363,4362,4385,4359,4381,4370,18,7,2274,99394380,3686
2182,a1305,20111220,4381,4370,4388,4398,4352,4352,4361,-18,-9,5500,239885140,7844
2183,a1305,20111221,4352,4361,4365,4368,4339,4340,4350,-21,-11,1942,84496160,9254
2184,a1305,20111222,4340,4350,4346,4350,4335,4346,4345,-4,-5,356,15470840,9508
2185,a1305,20111223,4346,4345,4355,4365,4350,4353,4355,8,10,268,11672600,9684
2186,a1305,20111226,4353,4355,4350,4380,4350,4360,4363,5,8,1706,74443340,10662
2187,a1305,20111227,4360,4363,4356,4360,4343,4343,4348,-20,-15,362,15741520,10560
2188,a1305,20111228,4343,4348,4370,4380,4363,4375,4370,27,22,394,17220140,10546
2189,a1305,20111229,4375,4370,4359,4390,4359,4372,4378,2,8,388,16986860,10572
2190,a1305,20111230,4372,4378,4375,4380,4352,4360,4362,-18,-16,2340,102082200,12454
1,a1201,20120104,4070,4065,4080,4180,4080,4120,4087,55,22,4536,185388620,16094
2,a1201,20120105,4120,4087,4150,4150,4115,4124,4124,37,37,42,1732240,13094
3,a1201,20120106,4124,4124,4143,4143,4124,4139,4130,15,6,732,30234860,3922
4,a1201,20120109,4139,4130,4170,4170,4120,4149,4141,19,11,134,5549140,116
5,a1201,20120110,4149,4141,4188,4188,4188,4188,4188,47,47,10,418800,44
6,a1201,20120111,4188,4188,4109,4109,4100,4100,4101,-88,-87,20,820360,60
7,a1201,20120112,4100,4101,0,0,0,4101,4101,0,0,0,0,60
8,a1201,20120113,4101,4101,4100,4100,4100,4100,4100,-1,-1,18,738000,78
9,a1201,20120116,4100,4100,4100,4100,4090,4100,4099,0,-1,44,1803800,60
10,a1201,20120117,4100,4099,4110,4200,4100,4100,4095,1,-4,64,2656000,0
11,a1203,20120104,4168,4163,4190,4216,4172,4200,4205,37,42,164,6897420,572
12,a1203,20120105,4200,4205,4203,4210,4203,4210,4205,5,0,30,1261660,552
13,a1203,20120106,4210,4205,4200,4213,4199,4213,4201,8,-4,92,3864960,476
14,a1203,20120109,4213,4201,4201,4201,4201,4201,4201,0,0,2,84020,474
15,a1203,20120110,4201,4201,4230,4230,4212,4213,4217,12,16,18,759080,468
16,a1203,20120111,4213,4217,0,0,0,4217,4217,0,0,0,0,468
17,a1203,20120112,4217,4217,4161,4187,4161,4181,4181,-36,-36,32,1337960,464
18,a1203,20120113,4181,4181,4158,4158,4155,4155,4157,-26,-24,14,581980,462
19,a1203,20120116,4155,4157,4125,4132,4120,4120,4122,-37,-35,130,5358680,424
20,a1203,20120117,4120,4122,4179,4179,4130,4140,4147,18,25,20,829420,420
21,a1203,20120118,4140,4147,4143,4143,4130,4133,4137,-14,-10,20,827420,408
22,a1203,20120119,4133,4137,4101,4142,4101,4142,4121,5,-16,4,164860,408
23,a1203,20120120,4142,4121,4160,4170,4146,4170,4156,49,35,22,914340,408
24,a1203,20120130,4170,4156,4161,4206,4161,4166,4174,10,18,22,918300,420
25,a1203,20120131,4166,4174,4165,4165,4151,4151,4155,-23,-19,14,581700,414
26,a1203,20120201,4151,4155,4175,4220,4175,4186,4191,31,36,46,1928300,410
27,a1203,20120202,4186,4191,4195,4195,4188,4188,4190,-3,-1,10,419080,410
28,a1203,20120203,4188,4190,4172,4196,4153,4168,4182,-22,-8,104,4349920,352
29,a1203,20120206,4168,4182,4181,4198,4181,4198,4189,16,7,232,9719700,502
30,a1203,20120207,4198,4189,4171,4204,4171,4204,4189,15,0,56,2346380,494
31,a1203,20120208,4204,4189,4185,4240,4183,4240,4214,51,25,20,842960,494
32,a1203,20120209,4240,4214,4240,4240,4176,4176,4199,-38,-15,30,1259780,494
33,a1203,20120210,4176,4199,4172,4182,4172,4182,4177,-17,-22,4,167080,494
34,a1203,20120213,4182,4177,4184,4205,4184,4203,4194,26,17,38,1593920,494
35,a1203,20120214,4203,4194,4196,4210,4114,4115,4156,-79,-38,58,2410540,542
36,a1203,20120215,4115,4156,4122,4122,4081,4104,4102,-52,-54,8,328200,542
37,a1203,20120216,4104,4102,4108,4169,4108,4165,4123,63,21,50,2061800,494
38,a1203,20120217,4165,4123,4192,4192,4051,4115,4132,-8,9,24,991680,498
39,a1203,20120220,4115,4132,4132,4146,4074,4146,4121,14,-11,8,329680,494
40,a1203,20120221,4146,4121,4138,4218,4138,4170,4161,49,40,30,1248440,496
41,a1203,20120222,4170,4161,4147,4242,4147,4160,4175,-1,14,114,4759900,496
42,a1203,20120223,4160,4175,4160,4160,4160,4160,4160,-15,-15,24,998400,496
43,a1203,20120224,4160,4160,4190,4190,4190,4190,4190,30,30,2,83800,494
44,a1203,20120227,4190,4190,4210,4210,4105,4110,4158,-80,-32,12,499020,494
45,a1203,20120228,4110,4158,4179,4179,4065,4121,4131,-37,-27,52,2148260,494
46,a1203,20120229,4121,4131,4138,4158,4138,4158,4147,27,16,40,1658820,494
47,a1203,20120301,4158,4147,0,0,0,4147,4147,0,0,0,0,198
48,a1203,20120302,4147,4147,4300,4300,4060,4060,4180,-87,33,20,836000,48
49,a1203,20120305,4060,4180,0,0,0,4180,4180,0,0,0,0,48
50,a1203,20120306,4180,4180,0,0,0,4180,4180,0,0,0,0,48
51,a1203,20120307,4180,4180,0,0,0,4180,4180,0,0,0,0,48
52,a1203,20120308,4180,4180,0,0,0,4180,4180,0,0,0,0,48
53,a1203,20120309,4180,4180,0,0,0,4180,4180,0,0,0,0,48
54,a1203,20120312,4180,4180,0,0,0,4180,4180,0,0,0,0,48
55,a1203,20120313,4180,4180,0,0,0,4180,4180,0,0,0,0,48
56,a1203,20120314,4180,4180,0,0,0,4180,4180,0,0,10,418000,0
57,a1205,20120104,4291,4299,4310,4318,4307,4310,4312,11,13,4302,185535700,55936
58,a1205,20120105,4310,4312,4312,4326,4300,4312,4317,0,5,8510,367423380,49460
59,a1205,20120106,4312,4317,4299,4305,4292,4297,4296,-20,-21,2106,90490860,48450
60,a1205,20120109,4297,4296,4299,4299,4289,4294,4292,-2,-4,3880,166543500,45756
61,a1205,20120110,4294,4292,4311,4318,4307,4312,4311,20,19,5214,224814180,42988
62,a1205,20120111,4312,4311,4312,4312,4297,4301,4302,-10,-9,2768,119079680,41576
63,a1205,20120112,4301,4302,4288,4288,4278,4280,4280,-22,-22,2934,125599000,40578
64,a1205,20120113,4280,4280,4267,4270,4240,4241,4251,-39,-29,4644,197441740,39112
65,a1205,20120116,4241,4251,4220,4220,4197,4210,4208,-41,-43,4732,199132960,38846
66,a1205,20120117,4210,4208,4216,4236,4209,4233,4221,25,13,3378,142615900,37748
67,a1205,20120118,4233,4221,4230,4238,4220,4223,4228,2,7,2400,101488640,36694
68,a1205,20120119,4223,4228,4232,4240,4229,4240,4235,12,7,3056,129441360,34580
69,a1205,20120120,4240,4235,4248,4277,4245,4274,4259,39,24,3340,142272320,32720
70,a1205,20120130,4274,4259,4280,4280,4259,4260,4269,1,10,1682,71804920,32216
71,a1205,20120131,4260,4269,4237,4261,4237,4260,4251,-9,-18,1648,70068000,31496
72,a1205,20120201,4260,4251,4261,4311,4261,4284,4293,33,42,16726,718171520,23748
73,a1205,20120202,4284,4293,4293,4299,4277,4287,4290,-6,-3,4130,177190100,23702
74,a1205,20120203,4287,4290,4299,4303,4268,4274,4283,-16,-7,1690,72387860,23540
75,a1205,20120206,4274,4283,4289,4299,4285,4296,4291,13,8,3814,163695380,23596
76,a1205,20120207,4296,4291,4296,4306,4281,4289,4294,-2,3,3894,167229420,21828
77,a1205,20120208,4289,4294,4294,4302,4280,4300,4293,6,-1,1684,72295980,21288
78,a1205,20120209,4300,4293,4297,4304,4285,4289,4295,-4,2,1128,48448900,20872
79,a1205,20120210,4289,4295,4300,4300,4271,4272,4279,-23,-16,3440,147219340,19430
80,a1205,20120213,4272,4279,4286,4307,4285,4300,4296,21,17,2346,100801240,18494
81,a1205,20120214,4300,4296,4310,4317,4294,4296,4305,0,9,1776,76473140,18036
82,a1205,20120215,4296,4305,4297,4305,4287,4294,4293,-11,-12,1052,45163280,17398
83,a1205,20120216,4294,4293,4298,4298,4274,4283,4283,-10,-10,1372,58771740,17172
84,a1205,20120217,4283,4283,4283,4300,4283,4296,4296,13,13,904,38838220,16872
85,a1205,20120220,4296,4296,4307,4310,4297,4299,4301,3,5,1812,77944740,17468
86,a1205,20120221,4299,4301,4296,4320,4294,4312,4310,11,9,3264,140687460,17474
87,a1205,20120222,4312,4310,4311,4316,4300,4303,4307,-7,-3,1146,49359580,16756
88,a1205,20120223,4303,4307,4300,4320,4295,4308,4304,1,-3,1004,43221400,16662
89,a1205,20120224,4308,4304,4309,4313,4306,4310,4311,6,7,976,42076760,16580
90,a1205,20120227,4310,4311,4330,4330,4306,4315,4319,4,8,1356,58572520,16454
91,a1205,20120228,4315,4319,4323,4330,4322,4329,4327,10,8,1018,44051600,16658
92,a1205,20120229,4329,4327,4332,4334,4320,4321,4325,-6,-2,562,24310880,16608
93,a1205,20120301,4321,4325,4318,4326,4300,4300,4312,-25,-13,952,41056640,16120
94,a1205,20120302,4300,4312,4315,4319,4306,4314,4314,2,2,512,22088360,15998
95,a1205,20120305,4314,4314,4327,4334,4315,4331,4328,17,14,3918,169609500,17182
96,a1205,20120306,4331,4328,4336,4336,4317,4330,4332,2,4,5420,234807180,20376
97,a1205,20120307,4330,4332,4329,4337,4316,4323,4330,-9,-2,842,36463380,20264
98,a1205,20120308,4323,4330,4323,4330,4322,4323,4326,-7,-4,268,11595140,20112
99,a1205,20120309,4323,4326,4335,4368,4332,4367,4353,41,27,3486,151779480,19668
100,a1205,20120312,4367,4353,4358,4362,4343,4359,4354,6,1,1928,83955720,19346
101,a1205,20120313,4359,4354,4353,4386,4353,4385,4372,31,18,968,42328560,19020
102,a1205,20120314,4385,4372,4385,4418,4375,4387,4398,15,26,2322,102142300,18706
103,a1205,20120315,4387,4398,4400,4405,4366,4394,4394,-4,-4,1244,54669920,18066
104,a1205,20120316,4394,4394,4405,4417,4388,4398,4404,4,10,594,26162400,17914
105,a1205,20120319,4398,4404,4400,4418,4400,4415,4407,11,3,788,34733960,17862
106,a1205,20120320,4415,4407,4409,4409,4362,4362,4384,-45,-23,654,28676400,17706
107,a1205,20120321,4362,4384,4355,4371,4355,4371,4364,-13,-20,218,9514720,17616
108,a1205,20120322,4371,4364,4376,4380,4365,4367,4372,3,8,336,14691140,17448
109,a1205,20120323,4367,4372,4377,4398,4373,4395,4383,23,11,854,37439200,17342
110,a1205,20120326,4395,4383,4395,4433,4395,4418,4416,35,33,2590,114383420,17444
111,a1205,20120327,4418,4416,4418,4428,4413,4424,4421,8,5,406,17951000,17318
112,a1205,20120328,4424,4421,4410,4434,4406,4406,4421,-15,0,604,26706640,17224
113,a1205,20120329,4406,4421,4429,4429,4384,4393,4411,-28,-10,1378,60797040,16614
114,a1205,20120330,4393,4411,4383,4385,4358,4360,4365,-51,-46,686,29947160,16536
115,a1205,20120405,4360,4365,4402,4467,4400,4460,4437,95,72,2636,116979500,15574
116,a1205,20120406,4460,4437,4455,4500,4455,4491,4484,54,47,1628,73005080,14770
117,a1205,20120409,4491,4484,4500,4514,4488,4492,4498,8,14,768,34547480,14844
118,a1205,20120410,4492,4498,4488,4510,4488,4509,4502,11,4,570,25665540,14554
119,a1205,20120411,4509,4502,4486,4486,4430,4448,4454,-54,-48,424,18887900,14376
120,a1205,20120412,4448,4454,4441,4456,4431,4446,4445,-8,-9,348,15470500,14112
121,a1205,20120413,4446,4445,4480,4482,4460,4460,4466,15,21,954,42609120,13218
122,a1205,20120416,4460,4466,4441,4441,4418,4418,4425,-48,-41,414,18320860,12898
123,a1205,20120417,4418,4425,4410,4430,4410,4426,4423,1,-2,234,10351240,12714
124,a1205,20120418,4426,4423,4433,4435,4378,4395,4398,-28,-25,994,43719320,11908
125,a1205,20120419,4395,4398,4380,4402,4380,4398,4397,0,-1,334,14688000,11704
126,a1205,20120420,4398,4397,4400,4406,4391,4401,4398,4,1,224,9851560,11620
127,a1205,20120423,4401,4398,4432,4432,4422,4422,4427,24,29,562,24882880,11602
128,a1205,20120424,4422,4427,4420,4420,4403,4403,4412,-24,-15,320,14120560,11474
129,a1205,20120425,4403,4412,4425,4430,4404,4404,4419,-8,7,702,31021800,11542
130,a1205,20120426,4404,4419,4396,4396,4387,4388,4395,-31,-24,194,8527840,11348
131,a1205,20120427,4388,4395,4388,4398,4384,4384,4389,-11,-6,454,19930100,11236
132,a1205,20120502,4384,4389,0,0,0,4389,4389,0,0,0,0,9144
133,a1205,20120503,4389,4389,4383,4383,4370,4370,4376,-19,-13,752,32907900,8556
134,a1205,20120504,4370,4376,4373,4379,4370,4379,4374,3,-2,754,32985740,9280
135,a1205,20120507,4379,4374,4361,4361,4348,4349,4356,-25,-18,504,21956960,9544
136,a1205,20120508,4349,4356,4357,4360,4350,4356,4354,0,-2,1574,68542740,5038
137,a1205,20120509,4356,4354,4331,4333,4300,4333,4328,-21,-26,252,10907540,4630
138,a1205,20120510,4333,4328,4330,4330,4330,4330,4330,2,2,20,866000,1794
139,a1205,20120511,4330,4330,4331,4331,4330,4330,4330,0,0,102,4416620,1676
140,a1205,20120514,4330,4330,4298,4300,4295,4297,4297,-33,-33,262,11260060,1252
141,a1205,20120515,4297,4297,4298,4298,4298,4298,4355,1,58,80,3438400,0
142,a1207,20120104,4295,4308,4321,4326,4321,4326,4323,18,15,4,172940,122
143,a1207,20120105,4326,4323,4335,4335,4335,4335,4335,12,12,2,86700,122
144,a1207,20120106,4335,4335,4287,4309,4287,4309,4298,-26,-37,4,171920,124
145,a1207,20120109,4309,4298,4352,4352,4300,4300,4318,2,20,14,604600,120
146,a1207,20120110,4300,4318,4330,4330,4330,4330,4330,12,12,2,86600,120
147,a1207,20120111,4330,4330,4333,4334,4302,4306,4318,-24,-12,46,1986620,120
148,a1207,20120112,4306,4318,4308,4308,4297,4308,4304,-10,-14,6,258260,120
149,a1207,20120113,4308,4304,0,0,0,4304,4304,0,0,0,0,120
150,a1207,20120116,4304,4304,4222,4230,4211,4220,4224,-84,-80,22,929460,118
151,a1207,20120117,4220,4224,4221,4240,4221,4240,4233,16,9,6,254020,118
152,a1207,20120118,4240,4233,4269,4269,4246,4246,4257,13,24,4,170300,120
153,a1207,20120119,4246,4257,4240,4240,4240,4240,4240,-17,-17,10,424000,118
154,a1207,20120120,4240,4240,4290,4290,4290,4290,4290,50,50,4,171600,118
155,a1207,20120130,4290,4290,0,0,0,4290,4290,0,0,0,0,118
156,a1207,20120131,4290,4290,4258,4277,4258,4277,4270,-13,-20,6,256240,118
157,a1207,20120201,4277,4270,4325,4335,4325,4330,4331,60,61,8,346500,122
158,a1207,20120202,4330,4331,4354,4354,4330,4330,4345,-1,14,14,608360,126
159,a1207,20120203,4330,4345,4330,4330,4330,4330,4330,-15,-15,2,86600,126
160,a1207,20120206,4330,4330,4334,4359,4334,4359,4346,29,16,4,173860,128
161,a1207,20120207,4359,4346,4372,4373,4341,4373,4362,27,16,6,261720,130
162,a1207,20120208,4373,4362,4354,4354,4354,4354,4354,-8,-8,22,957880,110
163,a1207,20120209,4354,4354,0,0,0,4354,4354,0,0,0,0,110
164,a1207,20120210,4354,4354,0,0,0,4354,4354,0,0,0,0,110
165,a1207,20120213,4354,4354,0,0,0,4354,4354,0,0,0,0,110
166,a1207,20120214,4354,4354,0,0,0,4354,4354,0,0,0,0,110
167,a1207,20120215,4354,4354,0,0,0,4354,4354,0,0,0,0,110
168,a1207,20120216,4354,4354,4327,4329,4327,4329,4327,-25,-27,6,259660,104
169,a1207,20120217,4329,4327,0,0,0,4327,4327,0,0,0,0,104
170,a1207,20120220,4327,4327,0,0,0,4327,4327,0,0,0,0,104
171,a1207,20120221,4327,4327,4359,4410,4336,4382,4385,55,58,222,9735040,106
172,a1207,20120222,4382,4385,4366,4366,4366,4366,4366,-19,-19,2,87320,106
173,a1207,20120223,4366,4366,4337,4349,4337,4346,4343,-20,-23,14,608080,108
174,a1207,20120224,4346,4343,4382,4382,4357,4357,4369,14,26,4,174780,108
175,a1207,20120227,4357,4369,4393,4393,4375,4375,4384,6,15,4,175360,106
176,a1207,20120228,4375,4384,0,0,0,4384,4384,0,0,0,0,106
177,a1207,20120229,4384,4384,0,0,0,4384,4384,0,0,0,0,106
178,a1207,20120301,4384,4384,0,0,0,4384,4384,0,0,0,0,106
179,a1207,20120302,4384,4384,4398,4398,4368,4368,4383,-16,-1,16,701280,106
180,a1207,20120305,4368,4383,0,0,0,4383,4383,0,0,0,0,106
181,a1207,20120306,4383,4383,4386,4386,4382,4382,4384,-1,1,6,263080,102
182,a1207,20120307,4382,4384,0,0,0,4384,4384,0,0,0,0,102
183,a1207,20120308,4384,4384,0,0,0,4384,4384,0,0,0,0,102
184,a1207,20120309,4384,4384,0,0,0,4384,4384,0,0,0,0,102
185,a1207,20120312,4384,4384,0,0,0,4384,4384,0,0,0,0,102
186,a1207,20120313,4384,4384,4449,4449,4411,4428,4429,44,45,10,442960,104
187,a1207,20120314,4428,4429,4426,4490,4413,4413,4433,-16,4,12,531980,106
188,a1207,20120315,4413,4433,0,0,0,4433,4433,0,0,0,0,106
189,a1207,20120316,4433,4433,0,0,0,4433,4433,0,0,0,0,106
190,a1207,20120319,4433,4433,4462,4464,4462,4464,4463,31,30,4,178520,102
191,a1207,20120320,4464,4463,0,0,0,4463,4463,0,0,0,0,102
192,a1207,20120321,4463,4463,0,0,0,4463,4463,0,0,0,0,102
193,a1207,20120322,4463,4463,0,0,0,4463,4463,0,0,0,0,102
194,a1207,20120323,4463,4463,0,0,0,4463,4463,0,0,0,0,102
195,a1207,20120326,4463,4463,4488,4488,4488,4488,4488,25,25,4,179520,102
196,a1207,20120327,4488,4488,0,0,0,4488,4488,0,0,0,0,102
197,a1207,20120328,4488,4488,4484,4484,4484,4484,4484,-4,-4,2,89680,100
198,a1207,20120329,4484,4484,0,0,0,4484,4484,0,0,0,0,100
199,a1207,20120330,4484,4484,0,0,0,4484,4484,0,0,0,0,100
200,a1207,20120405,4484,4484,4550,4550,4505,4550,4528,66,44,48,2173840,106
201,a1207,20120406,4550,4528,4526,4618,4526,4618,4561,90,33,24,1094860,112
202,a1207,20120409,4618,4561,4578,4578,4562,4568,4568,7,7,14,639580,104
203,a1207,20120410,4568,4568,4580,4590,4570,4590,4585,22,17,26,1192260,90
204,a1207,20120411,4590,4585,4540,4540,4501,4530,4523,-55,-62,46,2080780,94
205,a1207,20120412,4530,4523,4511,4511,4510,4510,4510,-13,-13,4,180420,92
206,a1207,20120413,4510,4510,4526,4526,4526,4526,4526,16,16,34,1538840,58
207,a1207,20120416,4526,4526,4526,4526,4470,4496,4496,-30,-30,48,2158180,80
208,a1207,20120417,4496,4496,4494,4498,4491,4491,4495,-5,-1,20,899000,72
209,a1207,20120418,4491,4495,4490,4497,4477,4477,4488,-18,-7,8,359100,72
210,a1207,20120419,4477,4488,0,0,0,4488,4488,0,0,0,0,72
211,a1207,20120420,4488,4488,0,0,0,4488,4488,0,0,0,0,72
212,a1207,20120423,4488,4488,0,0,0,4488,4488,0,0,0,0,72
213,a1207,20120424,4488,4488,0,0,0,4488,4488,0,0,0,0,72
214,a1207,20120425,4488,4488,4450,4481,4450,4481,4471,-7,-17,16,715500,70
215,a1207,20120426,4481,4471,4468,4471,4468,4470,4469,-1,-2,14,625740,56
216,a1207,20120427,4470,4469,0,0,0,4469,4469,0,0,0,0,56
217,a1207,20120502,4469,4469,4466,4466,4462,4462,4464,-7,-5,10,446400,46
218,a1207,20120503,4462,4464,0,0,0,4464,4464,0,0,0,0,46
219,a1207,20120504,4464,4464,0,0,0,4464,4464,0,0,0,0,46
220,a1207,20120507,4464,4464,4380,4390,4379,4379,4381,-85,-83,38,1665140,70
221,a1207,20120508,4379,4381,4385,4395,4382,4395,4386,14,5,94,4123520,112
222,a1207,20120509,4395,4386,4356,4389,4353,4389,4366,3,-20,154,6724480,142
223,a1207,20120510,4389,4366,4376,4404,4376,4384,4384,18,18,42,1841420,144
224,a1207,20120511,4384,4384,4382,4401,4382,4398,4391,14,7,72,3162020,184
225,a1207,20120514,4398,4391,4358,4370,4342,4342,4349,-49,-42,12,521980,180
226,a1207,20120515,4342,4349,4290,4290,4251,4265,4264,-84,-85,38,1620320,180
227,a1207,20120516,4265,4264,4289,4308,4267,4267,4290,3,26,84,3603780,220
228,a1207,20120517,4267,4290,4274,4283,4255,4282,4270,-8,-20,18,768680,226
229,a1207,20120518,4282,4270,4260,4260,4240,4240,4255,-30,-15,224,9531200,410
230,a1207,20120521,4240,4255,4240,4270,4240,4269,4264,14,9,116,4946580,484
231,a1207,20120522,4269,4264,4318,4318,4256,4256,4277,-8,13,10,427700,484
232,a1207,20120523,4256,4277,4202,4232,4202,4204,4210,-73,-67,28,1178900,474
233,a1207,20120524,4204,4210,4206,4213,4196,4213,4205,3,-5,20,841140,470
234,a1207,20120525,4213,4205,4162,4258,4162,4182,4200,-23,-5,14,588060,470
235,a1207,20120528,4182,4200,4230,4230,4202,4212,4211,12,11,102,4295320,470
236,a1207,20120529,4212,4211,4212,4216,4190,4216,4204,5,-7,56,2354460,474
237,a1207,20120530,4216,4204,4202,4209,4202,4204,4206,0,2,8,336480,474
238,a1207,20120531,4204,4206,4209,4228,4201,4228,4212,22,6,20,842400,474
239,a1207,20120601,4228,4212,0,0,0,4212,4212,0,0,0,0,474
240,a1207,20120604,4212,4212,4202,4202,4200,4200,4200,-12,-12,10,420040,482
241,a1207,20120605,4200,4200,4238,4238,4180,4223,4207,23,7,18,757280,476
242,a1207,20120606,4223,4207,4235,4235,4235,4235,4235,28,28,2,84700,476
243,a1207,20120607,4235,4235,4246,4255,4220,4240,4239,5,4,318,13480040,180
244,a1207,20120608,4240,4239,4244,4244,4205,4208,4224,-31,-15,54,2281200,136
245,a1207,20120611,4208,4224,4230,4250,4161,4250,4221,26,-3,56,2364120,128
246,a1207,20120612,4250,4221,4240,4246,4201,4242,4235,21,14,22,931880,126
247,a1207,20120613,4242,4235,4230,4240,4230,4240,4238,5,3,12,508600,114
248,a1207,20120614,4240,4238,4219,4219,4219,4219,4219,-19,-19,4,168760,114
249,a1207,20120615,4219,4219,4202,4202,4202,4202,4202,-17,-17,2,84040,112
250,a1207,20120618,4202,4202,4204,4204,4204,4204,4204,2,2,4,168160,110
251,a1207,20120619,4204,4204,0,0,0,4204,4204,0,0,0,0,110
252,a1207,20120620,4204,4204,0,0,0,4204,4204,0,0,0,0,110
253,a1207,20120621,4204,4204,4351,4351,4210,4210,4280,6,76,4,171220,108
254,a1207,20120625,4210,4280,4280,4360,4280,4359,4311,79,31,20,862340,94
255,a1207,20120626,4359,4311,0,0,0,4311,4311,0,0,0,0,94
256,a1207,20120627,4311,4311,4395,4395,4320,4320,4357,9,46,8,348620,92
257,a1207,20120628,4320,4357,0,0,0,4357,4357,0,0,0,0,92
258,a1207,20120629,4357,4357,4338,4339,4210,4210,4252,-147,-105,12,510340,82
259,a1207,20120702,4210,4252,0,0,0,4252,4252,0,0,0,0,82
260,a1207,20120703,4252,4252,0,0,0,4252,4252,0,0,0,0,82
261,a1207,20120704,4252,4252,0,0,0,4252,4252,0,0,0,0,70
262,a1207,20120705,4252,4252,0,0,0,4252,4252,0,0,0,0,70
263,a1207,20120706,4252,4252,0,0,0,4252,4252,0,0,0,0,70
264,a1207,20120709,4252,4252,4450,4450,4450,4450,4450,198,198,100,4450000,70
265,a1207,20120710,4450,4450,0,0,0,4450,4450,0,0,0,0,70
266,a1207,20120711,4450,4450,0,0,0,4450,4450,0,0,0,0,70
267,a1207,20120712,4450,4450,0,0,0,4450,4450,0,0,0,0,70
268,a1207,20120713,4450,4450,0,0,0,4450,4450,0,0,0,0,0
269,a1209,20120104,4340,4339,4366,4378,4351,4360,4362,21,23,81194,3541777920,258880
270,a1209,20120105,4360,4362,4363,4385,4352,4362,4367,0,5,102942,4495907160,256006
271,a1209,20120106,4362,4367,4340,4351,4336,4350,4345,-17,-22,44164,1918959020,254186
272,a1209,20120109,4350,4345,4343,4356,4341,4352,4348,7,3,57390,2495441720,249660
273,a1209,20120110,4352,4348,4378,4382,4366,4372,4374,24,26,79246,3466703260,243702
274,a1209,20120111,4372,4374,4374,4378,4361,4370,4369,-4,-5,42354,1850669060,244410
275,a1209,20120112,4370,4369,4351,4359,4345,4355,4352,-14,-17,40536,1764140580,238346
276,a1209,20120113,4355,4352,4343,4344,4312,4318,4327,-34,-25,48252,2087864240,237046
277,a1209,20120116,4318,4327,4299,4299,4253,4259,4268,-68,-59,70846,3024116140,234346
278,a1209,20120117,4259,4268,4270,4290,4258,4284,4273,16,5,84468,3610002500,235982
279,a1209,20120118,4284,4273,4282,4298,4270,4271,4283,-2,10,48448,2075375740,229352
280,a1209,20120119,4271,4283,4288,4299,4281,4289,4287,6,4,43876,1881085420,217314
281,a1209,20120120,4289,4287,4300,4329,4299,4327,4313,40,26,33152,1429854360,209336
282,a1209,20120130,4327,4313,4330,4337,4311,4312,4326,-1,13,47938,2074103020,210466
283,a1209,20120131,4312,4326,4299,4322,4294,4321,4306,-5,-20,42810,1843700300,211870
284,a1209,20120201,4321,4306,4329,4395,4326,4384,4376,78,70,259330,11349024460,251946
285,a1209,20120202,4384,4376,4390,4420,4386,4408,4405,32,29,181984,8016931520,258334
286,a1209,20120203,4408,4405,4416,4425,4376,4385,4397,-20,-8,129918,5712921040,247182
287,a1209,20120206,4385,4397,4410,4428,4401,4424,4418,27,21,121954,5388019680,246930
288,a1209,20120207,4424,4418,4420,4446,4397,4406,4420,-12,2,142950,6318476840,245418
289,a1209,20120208,4406,4420,4416,4433,4398,4433,4416,13,-4,107480,4747217360,248976
290,a1209,20120209,4433,4416,4420,4441,4410,4419,4425,3,9,130128,5758249180,249200
291,a1209,20120210,4419,4425,4415,4415,4381,4390,4395,-35,-30,80376,3532961360,245240
292,a1209,20120213,4390,4395,4409,4426,4402,4420,4416,25,21,92896,4102694660,255088
293,a1209,20120214,4420,4416,4435,4448,4416,4419,4433,3,17,123198,5461550080,258298
294,a1209,20120215,4419,4433,4428,4433,4409,4414,4418,-19,-15,74700,3300297580,256444
295,a1209,20120216,4414,4418,4418,4425,4386,4395,4399,-23,-19,108144,4758187560,247314
296,a1209,20120217,4395,4399,4405,4426,4398,4420,4417,21,18,123994,5476838580,265524
297,a1209,20120220,4420,4417,4441,4443,4424,4427,4431,10,14,112024,4964260020,246090
298,a1209,20120221,4427,4431,4432,4462,4419,4452,4446,21,15,229808,10219316520,283982
299,a1209,20120222,4452,4446,4450,4451,4431,4433,4441,-13,-5,137908,6125500060,286898
300,a1209,20120223,4433,4441,4418,4438,4415,4434,4424,-7,-17,100984,4467743920,277950
301,a1209,20120224,4434,4424,4432,4442,4430,4438,4436,14,12,82472,3658792680,262024
302,a1209,20120227,4438,4436,4443,4461,4440,4448,4452,12,16,100846,4489920680,244116
303,a1209,20120228,4448,4452,4464,4475,4458,4475,4466,23,14,99062,4424931960,233616
304,a1209,20120229,4475,4466,4480,4480,4460,4463,4465,-3,-1,71394,3188334660,226104
305,a1209,20120301,4463,4465,4450,4480,4435,4437,4457,-28,-8,137132,6112257940,210628
306,a1209,20120302,4437,4457,4450,4468,4449,4463,4458,6,1,86474,3855364680,207900
307,a1209,20120305,4463,4458,4478,4485,4453,4463,4469,5,11,139034,6213803840,209436
308,a1209,20120306,4463,4469,4453,4459,4444,4447,4451,-22,-18,68276,3039129280,205808
309,a1209,20120307,4447,4451,4448,4462,4427,4436,4445,-15,-6,93986,4178278280,209954
310,a1209,20120308,4436,4445,4438,4457,4435,4446,4446,1,1,92716,4122671200,200518
311,a1209,20120309,4446,4446,4456,4514,4456,4505,4489,59,43,197774,8879959820,232370
312,a1209,20120312,4505,4489,4484,4498,4469,4482,4480,-7,-9,99280,4448066560,234504
313,a1209,20120313,4482,4480,4480,4507,4473,4502,4494,22,14,101600,4566875360,238792
314,a1209,20120314,4502,4494,4520,4544,4487,4502,4518,8,24,165488,7478035640,234278
315,a1209,20120315,4502,4518,4512,4522,4474,4509,4506,-9,-12,136272,6140591620,221890
316,a1209,20120316,4509,4506,4525,4527,4492,4503,4513,-3,7,92752,4185931660,220532
317,a1209,20120319,4503,4513,4520,4536,4514,4525,4524,12,11,124740,5644406880,218458
318,a1209,20120320,4525,4524,4517,4522,4466,4468,4490,-56,-34,107036,4806191000,198342
319,a1209,20120321,4468,4490,4460,4481,4452,4480,4468,-10,-22,58784,2626894640,187506
320,a1209,20120322,4480,4468,4485,4497,4476,4483,4486,15,18,51274,2300573080,182820
321,a1209,20120323,4483,4486,4488,4517,4488,4515,4503,29,17,80606,3629899380,179168
322,a1209,20120326,4515,4503,4527,4572,4522,4561,4551,58,48,181702,8270889520,196752
323,a1209,20120327,4561,4551,4561,4567,4547,4562,4558,11,7,77814,3546782080,185808
324,a1209,20120328,4562,4558,4547,4571,4539,4546,4555,-12,-3,99102,4514876280,173878
325,a1209,20120329,4546,4555,4546,4577,4531,4537,4551,-18,-4,166880,7595460620,169312
326,a1209,20120330,4537,4551,4527,4530,4503,4509,4513,-42,-38,55196,2491374880,159670
327,a1209,20120405,4509,4513,4531,4618,4531,4608,4591,95,78,117926,5414502120,148310
328,a1209,20120406,4608,4591,4622,4657,4612,4641,4636,50,45,133742,6200414940,134428
329,a1209,20120409,4641,4636,4658,4668,4632,4642,4643,6,7,49378,2293066820,127246
330,a1209,20120410,4642,4643,4635,4664,4633,4660,4651,17,8,70008,3256307720,122712
331,a1209,20120411,4660,4651,4620,4629,4582,4590,4601,-61,-50,43386,1996497520,118846
332,a1209,20120412,4590,4601,4589,4599,4567,4579,4581,-22,-20,49154,2251784220,115908
333,a1209,20120413,4579,4581,4615,4629,4585,4591,4602,10,21,45604,2099099580,114170
334,a1209,20120416,4591,4602,4550,4571,4540,4564,4557,-38,-45,33798,1540506760,108500
335,a1209,20120417,4564,4557,4545,4573,4545,4565,4563,8,6,24024,1096304220,103844
336,a1209,20120418,4565,4563,4580,4580,4523,4541,4547,-22,-16,40126,1824800780,99984
337,a1209,20120419,4541,4547,4526,4546,4525,4541,4537,-6,-10,21382,970165480,97730
338,a1209,20120420,4541,4537,4540,4545,4528,4539,4536,2,-1,16224,736056300,96682
339,a1209,20120423,4539,4536,4580,4590,4553,4559,4570,23,34,23760,1085918560,93818
340,a1209,20120424,4559,4570,4549,4561,4537,4543,4548,-27,-22,15196,691212120,92212
341,a1209,20120425,4543,4548,4578,4580,4549,4552,4565,4,17,21804,995430380,92208
342,a1209,20120426,4552,4565,4552,4552,4530,4534,4537,-31,-28,14548,660065500,89438
343,a1209,20120427,4534,4537,4521,4548,4521,4539,4539,2,2,15710,713227240,86172
344,a1209,20120502,4539,4539,4550,4559,4526,4526,4537,-13,-2,13850,628487760,84720
345,a1209,20120503,4526,4537,4520,4521,4495,4496,4505,-41,-32,24590,1107991880,87688
346,a1209,20120504,4496,4505,4500,4514,4490,4513,4500,8,-5,20648,929317600,84852
347,a1209,20120507,4513,4500,4500,4505,4468,4475,4477,-25,-23,15242,682387800,83670
348,a1209,20120508,4475,4477,4477,4484,4471,4472,4477,-5,0,8782,393193320,81340
349,a1209,20120509,4472,4477,4459,4459,4430,4437,4441,-40,-36,20824,924832980,82182
350,a1209,20120510,4437,4441,4438,4465,4438,4463,4450,22,9,11354,505302040,83278
351,a1209,20120511,4463,4450,4470,4470,4414,4419,4432,-31,-18,13834,613165080,81286
352,a1209,20120514,4419,4432,4395,4400,4306,4317,4343,-115,-89,20812,904044040,74570
353,a1209,20120515,4317,4343,4308,4322,4276,4311,4300,-32,-43,11264,484395720,71806
354,a1209,20120516,4311,4300,4321,4321,4222,4228,4268,-72,-32,13410,572343260,68756
355,a1209,20120517,4228,4268,4270,4277,4239,4267,4262,-1,-6,12058,513918060,68258
356,a1209,20120518,4267,4262,4262,4275,4240,4255,4255,-7,-7,12434,529075600,67286
357,a1209,20120521,4255,4255,4266,4292,4259,4286,4273,31,18,10254,438215320,64530
358,a1209,20120522,4286,4273,4281,4282,4268,4271,4274,-2,1,2350,100452520,64278
359,a1209,20120523,4271,4274,4252,4252,4213,4213,4226,-61,-48,13450,568515620,61432
360,a1209,20120524,4213,4226,4225,4251,4216,4247,4239,21,13,7586,321584660,60324
361,a1209,20120525,4247,4239,4249,4249,4222,4235,4233,-4,-6,4314,182638560,60346
362,a1209,20120528,4235,4233,4243,4265,4238,4261,4254,28,21,4316,183606220,58290
363,a1209,20120529,4261,4254,4263,4277,4248,4273,4262,19,8,3554,151500140,57320
364,a1209,20120530,4273,4262,4265,4300,4255,4263,4273,1,11,4260,182061680,56594
365,a1209,20120531,4263,4273,4247,4261,4240,4240,4251,-33,-22,3382,143786060,55648
366,a1209,20120601,4240,4251,4230,4233,4203,4221,4219,-30,-32,4016,169450260,54476
367,a1209,20120604,4221,4219,4215,4225,4180,4201,4203,-18,-16,4456,187319080,53432
368,a1209,20120605,4201,4203,4218,4249,4202,4239,4229,36,26,6332,267783800,49946
369,a1209,20120606,4239,4229,4243,4273,4236,4241,4253,12,24,3214,136720400,49232
370,a1209,20120607,4241,4253,4270,4291,4257,4261,4273,8,20,10864,464253280,45648
371,a1209,20120608,4261,4273,4283,4288,4230,4248,4254,-25,-19,4676,198953600,43876
372,a1209,20120611,4248,4254,4260,4305,4252,4303,4280,49,26,9392,402027980,39402
373,a1209,20120612,4303,4280,4288,4315,4277,4312,4299,32,19,8828,379522820,33944
374,a1209,20120613,4312,4299,4312,4315,4285,4290,4296,-9,-3,3150,135345960,32124
375,a1209,20120614,4290,4296,4278,4278,4240,4240,4252,-56,-44,3536,150366660,30240
376,a1209,20120615,4240,4252,4230,4269,4230,4268,4258,16,6,1890,80485260,29746
377,a1209,20120618,4268,4258,4270,4289,4262,4275,4272,17,14,2006,85710440,29152
378,a1209,20120619,4275,4272,4319,4338,4299,4329,4324,57,52,10134,438210900,23388
379,a1209,20120620,4329,4324,4351,4372,4351,4370,4360,46,36,14620,637559920,21698
380,a1209,20120621,4370,4360,4340,4360,4321,4352,4343,-8,-17,3502,152120800,19934
381,a1209,20120625,4352,4343,4377,4409,4369,4369,4396,26,53,6770,297656080,21120
382,a1209,20120626,4369,4396,4400,4400,4355,4366,4375,-30,-21,3362,147110920,21160
383,a1209,20120627,4366,4375,4365,4374,4350,4355,4361,-20,-14,1354,59058780,20608
384,a1209,20120628,4355,4361,4355,4365,4321,4321,4335,-40,-26,1198,51936900,20244
385,a1209,20120629,4321,4335,4314,4351,4308,4351,4331,16,-4,1308,56662140,19988
386,a1209,20120702,4351,4331,4401,4402,4350,4359,4367,28,36,2436,106386480,19038
387,a1209,20120703,4359,4367,4377,4380,4353,4379,4367,12,0,2204,96255940,18480
388,a1209,20120704,4379,4367,4392,4426,4383,4419,4401,52,34,5898,259613280,19164
389,a1209,20120705,4419,4401,4429,4455,4418,4435,4435,34,34,4238,187971020,19424
390,a1209,20120706,4435,4435,4464,4464,4382,4414,4423,-21,-12,3452,152704660,18128
391,a1209,20120709,4414,4423,4425,4599,4425,4599,4553,176,130,7648,348239760,20674
392,a1209,20120710,4599,4553,4590,4590,4513,4525,4543,-28,-10,5212,236814100,19192
393,a1209,20120711,4525,4543,4539,4639,4495,4510,4576,-33,33,5828,266722040,20326
394,a1209,20120712,4510,4576,4450,4498,4443,4450,4470,-126,-106,2014,90034000,20270
395,a1209,20120713,4450,4470,4471,4537,4471,4530,4505,60,35,1368,61631240,20338
396,a1209,20120716,4530,4505,4583,4684,4583,4678,4630,173,125,7320,338962300,22180
397,a1209,20120717,4678,4630,4718,4718,4495,4582,4579,-48,-51,4112,188305400,21618
398,a1209,20120718,4582,4579,4609,4620,4552,4562,4592,-17,13,1266,58135900,21250
399,a1209,20120719,4562,4592,4612,4639,4576,4617,4612,25,20,1792,82648400,21486
400,a1209,20120720,4617,4612,4636,4677,4595,4660,4654,48,42,9316,433578020,21710
401,a1209,20120723,4660,4654,4631,4749,4583,4702,4684,48,30,12034,563734640,21340
402,a1209,20120724,4702,4684,4497,4568,4497,4531,4542,-153,-142,5740,260746980,20010
403,a1209,20120725,4531,4542,4500,4529,4485,4494,4510,-48,-32,4044,182410380,19552
404,a1209,20120726,4494,4510,4534,4534,4496,4513,4509,3,-1,2096,94515580,18636
405,a1209,20120727,4513,4509,4499,4550,4455,4542,4512,33,3,2206,99541920,18402
406,a1209,20120730,4542,4512,4583,4666,4583,4655,4635,143,123,2408,111624620,18580
407,a1209,20120731,4655,4635,4619,4659,4607,4651,4636,16,1,1366,63333340,18678
408,a1209,20120801,4651,4636,4660,4672,4621,4629,4645,-7,9,1482,68846880,18624
409,a1209,20120802,4629,4645,4600,4699,4600,4699,4666,54,21,2456,114598580,19310
410,a1209,20120803,4699,4666,4699,4730,4664,4675,4697,9,31,4588,215529140,18792
411,a1209,20120806,4675,4697,4675,4675,4619,4630,4655,-67,-42,3130,145717920,18002
412,a1209,20120807,4630,4655,4639,4644,4624,4642,4632,-13,-23,646,29925460,18144
413,a1209,20120808,4642,4632,4618,4620,4563,4569,4598,-63,-34,1278,58772640,17360
414,a1209,20120809,4569,4598,4594,4609,4592,4597,4599,-1,1,516,23730920,17408
415,a1209,20120810,4597,4599,4636,4656,4613,4623,4628,24,29,650,30087980,17428
416,a1209,20120813,4623,4628,4626,4626,4595,4595,4604,-33,-24,1142,52585480,16732
417,a1209,20120814,4595,4604,4577,4585,4547,4573,4566,-31,-38,2856,130422000,15934
418,a1209,20120815,4573,4566,4556,4616,4553,4605,4588,39,22,564,25878920,15914
419,a1209,20120816,4605,4588,4611,4612,4587,4600,4602,12,14,2936,135131060,15484
420,a1209,20120817,4600,4602,4606,4614,4591,4595,4597,-7,-5,2772,127451400,14422
421,a1209,20120820,4595,4597,4608,4643,4608,4642,4627,45,30,2840,131435000,13428
422,a1209,20120821,4642,4627,4675,4707,4665,4707,4683,80,56,1466,68665020,13870
423,a1209,20120822,4707,4683,4738,4750,4710,4749,4733,66,50,914,43267560,13874
424,a1209,20120823,4749,4733,4759,4793,4741,4749,4768,16,35,652,31091420,13968
425,a1209,20120824,4749,4768,4770,4800,4770,4800,4778,32,10,4378,209197860,14046
426,a1209,20120827,4800,4778,4860,4934,4830,4865,4865,87,87,682,33179740,13576
427,a1209,20120828,4865,4865,4893,4922,4806,4806,4822,-59,-43,4266,205741660,9844
428,a1209,20120829,4806,4822,4796,4836,4786,4812,4814,-10,-8,1462,70382360,8792
429,a1209,20120830,4812,4814,4805,4860,4803,4860,4836,46,22,460,22248200,8792
430,a1209,20120831,4860,4836,4868,4874,4815,4858,4839,22,3,1076,52074860,8538
431,a1209,20120903,4858,4839,0,0,0,4839,4839,0,0,0,0,3038
432,a1209,20120904,4839,4839,0,0,0,4839,4839,0,0,0,0,520
433,a1209,20120905,4839,4839,4950,4950,4950,4950,4950,111,111,200,9900000,612
434,a1209,20120906,4950,4950,4811,4811,4811,4811,4811,-139,-139,100,4811000,412
435,a1209,20120907,4811,4811,0,0,0,4811,4811,0,0,0,0,412
436,a1209,20120910,4811,4811,0,0,0,4811,4811,0,0,0,0,412
437,a1209,20120911,4811,4811,0,0,0,4811,4811,0,0,0,0,412
438,a1209,20120912,4811,4811,0,0,0,4811,4811,0,0,0,0,412
439,a1209,20120913,4811,4811,0,0,0,4811,4811,0,0,0,0,300
440,a1209,20120914,4811,4811,0,0,0,4811,4903,0,92,0,0,0
441,a1211,20120104,4323,4315,4345,4345,4342,4342,4343,27,28,4,173740,142
442,a1211,20120105,4342,4343,4342,4349,4342,4345,4345,2,2,12,521440,146
443,a1211,20120106,4345,4345,4321,4325,4321,4325,4323,-20,-22,6,259420,148
444,a1211,20120109,4325,4323,4328,4332,4328,4332,4329,9,6,10,432980,148
445,a1211,20120110,4332,4329,4358,4358,4342,4353,4353,24,24,24,1044800,152
446,a1211,20120111,4353,4353,4351,4357,4349,4357,4351,4,-2,32,1392620,178
447,a1211,20120112,4357,4351,4336,4343,4331,4343,4339,-8,-12,26,1128140,182
448,a1211,20120113,4343,4339,4319,4319,4314,4314,4317,-25,-22,6,259020,178
449,a1211,20120116,4314,4317,4301,4301,4271,4275,4278,-42,-39,48,2053820,188
450,a1211,20120117,4275,4278,4276,4309,4276,4309,4288,31,10,20,857740,184
451,a1211,20120118,4309,4288,4282,4291,4282,4284,4288,-4,0,12,514560,178
452,a1211,20120119,4284,4288,4293,4293,4293,4293,4293,5,5,2,85860,178
453,a1211,20120120,4293,4293,4309,4325,4309,4325,4316,32,23,12,518020,178
454,a1211,20120130,4325,4316,4355,4355,4299,4329,4329,13,13,16,692740,176
455,a1211,20120131,4329,4329,4322,4330,4322,4330,4328,1,-1,12,519440,186
456,a1211,20120201,4330,4328,4355,4399,4355,4395,4375,67,47,64,2800020,194
457,a1211,20120202,4395,4375,4425,4440,4400,4440,4418,65,43,60,2651380,218
458,a1211,20120203,4440,4418,4401,4414,4400,4409,4401,-9,-17,48,2112880,202
459,a1211,20120206,4409,4401,4428,4441,4421,4441,4430,40,29,90,3987560,200
460,a1211,20120207,4441,4430,4445,4631,4362,4422,4431,-8,1,82,3633800,200
461,a1211,20120208,4422,4431,4417,4450,4417,4450,4431,19,0,224,9926200,278
462,a1211,20120209,4450,4431,4450,4450,4440,4440,4444,9,13,18,800060,268
463,a1211,20120210,4440,4444,0,0,0,4444,4444,0,0,0,0,268
464,a1211,20120213,4444,4444,0,0,0,4444,4444,0,0,0,0,268
465,a1211,20120214,4444,4444,4458,4458,4458,4458,4458,14,14,2,89160,266
466,a1211,20120215,4458,4458,4423,4450,4423,4450,4436,-8,-22,4,177460,266
467,a1211,20120216,4450,4436,0,0,0,4436,4436,0,0,0,0,266
468,a1211,20120217,4436,4436,4440,4440,4440,4440,4440,4,4,16,710400,252
469,a1211,20120220,4440,4440,4474,4474,4450,4452,4459,12,19,30,1337760,252
470,a1211,20120221,4452,4459,4448,4476,4448,4476,4460,17,1,10,446060,252
471,a1211,20120222,4476,4460,4465,4473,4453,4473,4463,13,3,12,535640,254
472,a1211,20120223,4473,4463,4452,4456,4449,4456,4452,-7,-11,24,1068500,244
473,a1211,20120224,4456,4452,4456,4456,4456,4456,4456,4,4,2,89120,244
474,a1211,20120227,4456,4456,4480,4480,4480,4480,4480,24,24,22,985600,222
475,a1211,20120228,4480,4480,4491,4491,4490,4490,4490,10,10,24,1077780,198
476,a1211,20120229,4490,4490,4495,4495,4494,4494,4494,4,4,4,179780,194
477,a1211,20120301,4494,4494,4494,4494,4491,4491,4493,-3,-1,28,1258260,170
478,a1211,20120302,4491,4493,4497,4498,4490,4490,4495,-3,2,12,539400,172
479,a1211,20120305,4490,4495,4495,4495,4495,4495,4495,0,0,4,179800,170
480,a1211,20120306,4495,4495,4465,4487,4460,4460,4469,-35,-26,10,446940,172
481,a1211,20120307,4460,4469,4415,4476,4415,4476,4445,7,-24,4,177820,172
482,a1211,20120308,4476,4445,4470,4471,4470,4471,4470,26,25,4,178820,170
483,a1211,20120309,4471,4470,4499,4540,4499,4515,4517,45,47,26,1174540,174
484,a1211,20120312,4515,4517,0,0,0,4517,4517,0,0,0,0,174
485,a1211,20120313,4517,4517,0,0,0,4517,4517,0,0,0,0,174
486,a1211,20120314,4517,4517,4536,4536,4525,4525,4529,8,12,8,362320,176
487,a1211,20120315,4525,4529,4527,4527,4513,4513,4520,-16,-9,4,180800,178
488,a1211,20120316,4513,4520,4535,4540,4508,4508,4527,-12,7,6,271660,176
489,a1211,20120319,4508,4527,4533,4537,4523,4527,4529,0,2,10,452920,180
490,a1211,20120320,4527,4529,4503,4509,4491,4497,4500,-32,-29,36,1620220,158
491,a1211,20120321,4497,4500,4485,4485,4483,4485,4484,-15,-16,10,448420,158
492,a1211,20120322,4485,4484,4494,4496,4494,4496,4495,12,11,6,269720,158
493,a1211,20120323,4496,4495,4519,4520,4519,4520,4519,25,24,4,180780,160
494,a1211,20120326,4520,4519,4529,4564,4529,4564,4548,45,29,10,454880,166
495,a1211,20120327,4564,4548,4571,4574,4562,4569,4567,21,19,18,822220,176
496,a1211,20120328,4569,4567,4568,4574,4566,4570,4570,3,3,10,457000,178
497,a1211,20120329,4570,4570,4548,4548,4547,4547,4547,-23,-23,4,181900,178
498,a1211,20120330,4547,4547,4519,4519,4519,4519,4519,-28,-28,2,90380,178
499,a1211,20120405,4519,4519,4596,4619,4596,4619,4610,100,91,30,1383160,190
500,a1211,20120406,4619,4610,4640,4713,4640,4713,4663,103,53,34,1585480,188
501,a1211,20120409,4713,4663,4688,4689,4688,4689,4688,26,25,6,281300,182
502,a1211,20120410,4689,4688,4711,4711,4700,4700,4708,12,20,14,659180,176
503,a1211,20120411,4700,4708,4590,4651,4590,4629,4631,-79,-77,12,555780,178
504,a1211,20120412,4629,4631,0,0,0,4631,4631,0,0,0,0,178
505,a1211,20120413,4631,4631,0,0,0,4631,4631,0,0,0,0,178
506,a1211,20120416,4631,4631,4615,4615,4615,4615,4615,-16,-16,2,92300,178
507,a1211,20120417,4615,4615,4551,4614,4551,4614,4582,-1,-33,4,183300,180
508,a1211,20120418,4614,4582,4678,4678,4585,4588,4597,6,15,30,1379260,182
509,a1211,20120419,4588,4597,4616,4616,4568,4592,4577,-5,-20,196,8972000,244
510,a1211,20120420,4592,4577,4599,4599,4579,4587,4594,10,17,76,3491480,212
511,a1211,20120423,4587,4594,4615,4615,4615,4615,4615,21,21,8,369200,204
512,a1211,20120424,4615,4615,0,0,0,4615,4615,0,0,0,0,204
513,a1211,20120425,4615,4615,0,0,0,4615,4615,0,0,0,0,204
514,a1211,20120426,4615,4615,4592,4592,4566,4566,4579,-49,-36,12,549500,202
515,a1211,20120427,4566,4579,4584,4608,4582,4600,4590,21,11,22,1009840,204
516,a1211,20120502,4600,4590,0,0,0,4590,4590,0,0,0,0,204
517,a1211,20120503,4590,4590,0,0,0,4590,4590,0,0,0,0,204
518,a1211,20120504,4590,4590,4542,4557,4542,4557,4547,-33,-43,8,363820,200
519,a1211,20120507,4557,4547,4522,4526,4474,4509,4508,-38,-39,18,811540,194
520,a1211,20120508,4509,4508,4514,4525,4514,4525,4519,17,11,20,903840,190
521,a1211,20120509,4525,4519,4460,4476,4460,4476,4466,-43,-53,24,1071980,192
522,a1211,20120510,4476,4466,4476,4476,4466,4473,4472,7,6,32,1431160,190
523,a1211,20120511,4473,4472,0,0,0,4472,4472,0,0,0,0,190
524,a1211,20120514,4472,4472,4361,4361,4324,4324,4342,-148,-130,4,173700,186
525,a1211,20120515,4324,4342,4339,4339,4302,4336,4328,-6,-14,22,952300,190
526,a1211,20120516,4336,4328,4314,4314,4238,4290,4300,-38,-28,16,688120,178
527,a1211,20120517,4290,4300,4308,4315,4285,4300,4293,0,-7,18,772860,164
528,a1211,20120518,4300,4293,4293,4293,4293,4293,4293,0,0,2,85860,162
529,a1211,20120521,4293,4293,4300,4316,4300,4316,4305,23,12,6,258320,164
530,a1211,20120522,4316,4305,4304,4304,4303,4303,4303,-2,-2,10,430360,154
531,a1211,20120523,4303,4303,4210,4253,4202,4202,4229,-101,-74,8,338360,154
532,a1211,20120524,4202,4229,4309,4309,4250,4262,4282,33,53,8,342600,150
533,a1211,20120525,4262,4282,4276,4276,4238,4255,4263,-27,-19,68,2899020,96
534,a1211,20120528,4255,4263,4263,4264,4263,4264,4263,1,0,6,255820,96
535,a1211,20120529,4264,4263,0,0,0,4263,4263,0,0,0,0,96
536,a1211,20120530,4263,4263,4287,4287,4287,4287,4287,24,24,2,85740,96
537,a1211,20120531,4287,4287,4279,4279,4279,4279,4279,-8,-8,4,171160,94
538,a1211,20120601,4279,4279,0,0,0,4279,4279,0,0,0,0,94
539,a1211,20120604,4279,4279,0,0,0,4279,4279,0,0,0,0,94
540,a1211,20120605,4279,4279,4266,4266,4266,4266,4266,-13,-13,2,85320,92
541,a1211,20120606,4266,4266,0,0,0,4266,4266,0,0,0,0,92
542,a1211,20120607,4266,4266,0,0,0,4266,4266,0,0,0,0,92
543,a1211,20120608,4266,4266,0,0,0,4266,4266,0,0,0,0,92
544,a1211,20120611,4266,4266,4334,4393,4333,4343,4350,77,84,8,348060,94
545,a1211,20120612,4343,4350,4373,4385,4364,4385,4374,35,24,6,262440,92
546,a1211,20120613,4385,4374,4420,4433,4358,4360,4388,-14,14,24,1053260,102
547,a1211,20120614,4360,4388,0,0,0,4388,4388,0,0,0,0,102
548,a1211,20120615,4388,4388,0,0,0,4388,4388,0,0,0,0,102
549,a1211,20120618,4388,4388,4337,4340,4327,4327,4336,-61,-52,18,780560,106
550,a1211,20120619,4327,4336,4360,4385,4360,4381,4377,45,41,10,437780,108
551,a1211,20120620,4381,4377,0,0,0,4377,4377,0,0,0,0,108
552,a1211,20120621,4377,4377,0,0,0,4377,4377,0,0,0,0,108
553,a1211,20120625,4377,4377,4450,4450,4450,4450,4450,73,73,12,534000,98
554,a1211,20120626,4450,4450,4495,4495,4426,4431,4461,-19,11,8,356940,98
555,a1211,20120627,4431,4461,0,0,0,4461,4461,0,0,0,0,98
556,a1211,20120628,4461,4461,4402,4453,4402,4453,4427,-8,-34,4,177100,98
557,a1211,20120629,4453,4427,4427,4427,4427,4427,4427,0,0,16,708320,82
558,a1211,20120702,4427,4427,0,0,0,4427,4427,0,0,0,0,82
559,a1211,20120703,4427,4427,4448,4448,4448,4448,4448,21,21,2,88960,84
560,a1211,20120704,4448,4448,4470,4474,4467,4471,4470,23,22,10,447060,92
561,a1211,20120705,4471,4470,0,0,0,4470,4470,0,0,0,0,92
562,a1211,20120706,4470,4470,0,0,0,4470,4470,0,0,0,0,92
563,a1211,20120709,4470,4470,4559,4648,4559,4610,4622,140,152,10,462260,92
564,a1211,20120710,4610,4622,4604,4604,4603,4603,4603,-19,-19,8,368280,96
565,a1211,20120711,4603,4603,4708,4710,4603,4603,4671,0,68,18,840920,90
566,a1211,20120712,4603,4671,4566,4566,4487,4493,4503,-178,-168,60,2701880,132
567,a1211,20120713,4493,4503,4683,4683,4551,4590,4612,87,109,126,5811480,128
568,a1211,20120716,4590,4612,4689,4727,4681,4713,4703,101,91,54,2539800,124
569,a1211,20120717,4713,4703,4701,4701,4598,4657,4633,-46,-70,28,1297260,142
570,a1211,20120718,4657,4633,4656,4656,4628,4649,4650,16,17,34,1581040,140
571,a1211,20120719,4649,4650,4664,4700,4661,4672,4691,22,41,70,3284260,152
572,a1211,20120720,4672,4691,4745,4790,4709,4720,4740,29,49,60,2844180,154
573,a1211,20120723,4720,4740,4763,4793,4716,4717,4746,-23,6,116,5505580,140
574,a1211,20120724,4717,4746,4603,4609,4557,4557,4583,-189,-163,20,916600,126
575,a1211,20120725,4557,4583,4515,4578,4515,4526,4541,-57,-42,34,1544200,110
576,a1211,20120726,4526,4541,4532,4532,4525,4525,4530,-16,-11,12,543620,106
577,a1211,20120727,4525,4530,4500,4500,4500,4500,4500,-30,-30,2,90000,106
578,a1211,20120730,4500,4500,4675,4680,4659,4669,4669,169,169,12,560340,112
579,a1211,20120731,4669,4669,4701,4701,4701,4701,4701,32,32,2,94020,110
580,a1211,20120801,4701,4701,4747,4747,4660,4660,4697,-41,-4,8,375780,108
581,a1211,20120802,4660,4697,4648,4648,4648,4648,4648,-49,-49,4,185920,106
582,a1211,20120803,4648,4648,4710,4747,4671,4676,4705,28,57,114,5363800,168
583,a1211,20120806,4676,4705,4701,4711,4648,4648,4682,-57,-23,14,655540,162
584,a1211,20120807,4648,4682,4682,4704,4640,4666,4677,-16,-5,56,2619600,136
585,a1211,20120808,4666,4677,4675,4675,4587,4587,4625,-90,-52,16,740000,140
586,a1211,20120809,4587,4625,4614,4677,4614,4627,4635,2,10,26,1205160,138
587,a1211,20120810,4627,4635,4673,4677,4664,4677,4670,42,35,112,5231200,136
588,a1211,20120813,4677,4670,4715,4715,4641,4641,4671,-29,1,20,934280,134
589,a1211,20120814,4641,4671,4619,4619,4581,4581,4600,-90,-71,18,828020,134
590,a1211,20120815,4581,4600,4682,4682,4639,4639,4660,39,60,4,186420,132
591,a1211,20120816,4639,4660,4659,4708,4653,4653,4672,-7,12,8,373800,132
592,a1211,20120817,4653,4672,0,0,0,4672,4672,0,0,0,0,132
593,a1211,20120820,4672,4672,0,0,0,4672,4672,0,0,0,0,132
594,a1211,20120821,4672,4672,0,0,0,4672,4672,0,0,0,0,132
595,a1211,20120822,4672,4672,4801,4801,4791,4797,4796,125,124,18,863400,134
596,a1211,20120823,4797,4796,4800,4837,4769,4784,4806,-12,10,26,1249720,142
597,a1211,20120824,4784,4806,4781,4814,4781,4814,4805,8,-1,56,2691100,160
598,a1211,20120827,4814,4805,4858,4886,4858,4880,4876,75,71,50,2438100,186
599,a1211,20120828,4880,4876,4812,4817,4812,4817,4814,-59,-62,72,3466540,248
600,a1211,20120829,4817,4814,0,0,0,4814,4814,0,0,0,0,248
601,a1211,20120830,4814,4814,4850,4853,4830,4853,4840,39,26,44,2130000,244
602,a1211,20120831,4853,4840,4830,4830,4829,4830,4829,-10,-11,12,579560,242
603,a1211,20120903,4830,4829,4842,4955,4842,4948,4897,119,68,156,7639500,178
604,a1211,20120904,4948,4897,4959,5024,4959,5010,4982,113,85,66,3288500,200
605,a1211,20120905,5010,4982,0,0,0,4982,4982,0,0,0,0,200
606,a1211,20120906,4982,4982,0,0,0,4982,4982,0,0,0,0,200
607,a1211,20120907,4982,4982,4945,4945,4905,4908,4914,-74,-68,52,2555640,196
608,a1211,20120910,4908,4914,4959,4959,4939,4939,4945,25,31,6,296740,192
609,a1211,20120911,4939,4945,4920,4920,4920,4920,4920,-25,-25,6,295200,186
610,a1211,20120912,4920,4920,4944,4944,4944,4944,4944,24,24,2,98880,184
611,a1211,20120913,4944,4944,4982,4983,4982,4983,4982,39,38,14,697600,182
612,a1211,20120914,4983,4982,0,0,0,4982,4982,0,0,0,0,182
613,a1211,20120917,4982,4982,4901,4920,4901,4920,4906,-62,-76,8,392540,188
614,a1211,20120918,4920,4906,4831,4877,4802,4808,4825,-98,-81,64,3088100,206
615,a1211,20120919,4808,4825,4820,4821,4791,4800,4811,-25,-14,46,2213280,216
616,a1211,20120920,4800,4811,4781,4805,4776,4778,4786,-33,-25,14,670120,224
617,a1211,20120921,4778,4786,4776,4804,4760,4800,4771,14,-15,110,5248320,306
618,a1211,20120924,4800,4771,4765,4829,4624,4829,4761,58,-10,44,2094900,286
619,a1211,20120925,4829,4761,4880,4880,4820,4835,4838,74,77,20,967600,294
620,a1211,20120926,4835,4838,0,0,0,4838,4838,0,0,0,0,294
621,a1211,20120927,4838,4838,0,0,0,4838,4838,0,0,0,0,294
622,a1211,20120928,4838,4838,4826,4826,4710,4710,4774,-128,-64,6,286480,292
623,a1211,20121008,4710,4774,4764,4764,4630,4675,4657,-99,-117,128,5961440,220
624,a1211,20121009,4675,4657,4750,4750,4680,4700,4694,43,37,166,7793200,240
625,a1211,20121010,4700,4694,4696,4703,4680,4703,4695,9,1,26,1220940,242
626,a1211,20121011,4703,4695,4668,4776,4668,4745,4758,50,63,96,4567880,314
627,a1211,20121012,4745,4758,4741,4770,4740,4740,4747,-18,-11,10,474740,308
628,a1211,20121015,4740,4747,4670,4670,4670,4670,4670,-77,-77,2,93400,308
629,a1211,20121016,4670,4670,4730,4748,4675,4692,4709,22,39,34,1601220,310
630,a1211,20121017,4692,4709,0,0,0,4709,4709,0,0,0,0,310
631,a1211,20121018,4709,4709,4704,4726,4704,4726,4715,17,6,4,188600,310
632,a1211,20121019,4726,4715,4710,4710,4700,4700,4701,-15,-14,62,2915140,320
633,a1211,20121022,4700,4701,4715,4715,4700,4702,4706,1,5,34,1600060,338
634,a1211,20121023,4702,4706,0,0,0,4706,4706,0,0,0,0,338
635,a1211,20121024,4706,4706,0,0,0,4706,4706,0,0,0,0,338
636,a1211,20121025,4706,4706,4710,4725,4700,4702,4715,-4,9,58,2735020,324
637,a1211,20121026,4702,4715,4718,4720,4710,4710,4715,-5,0,70,3300760,386
638,a1211,20121029,4710,4715,4700,4725,4681,4700,4700,-15,-15,36,1692120,410
639,a1211,20121030,4700,4700,4709,4709,4685,4685,4697,-15,-3,16,751520,410
640,a1211,20121031,4685,4697,0,0,0,4697,4697,0,0,0,0,410
641,a1211,20121101,4697,4697,4511,4511,4511,4511,4511,-186,-186,2,90220,90
642,a1211,20121102,4511,4511,0,0,0,4511,4511,0,0,0,0,90
643,a1211,20121105,4511,4511,0,0,0,4511,4511,0,0,0,0,2
644,a1211,20121106,4511,4511,0,0,0,4511,4511,0,0,0,0,2
645,a1211,20121107,4511,4511,0,0,0,4511,4511,0,0,0,0,2
646,a1211,20121108,4511,4511,0,0,0,4511,4511,0,0,0,0,2
647,a1211,20121109,4511,4511,0,0,0,4511,4511,0,0,0,0,2
648,a1211,20121112,4511,4511,0,0,0,4511,4511,0,0,0,0,0
649,a1211,20121113,4511,4511,0,0,0,4511,4511,0,0,0,0,0
650,a1211,20121114,4511,4511,0,0,0,4511,4511,0,0,0,0,0
651,a1301,20120104,4307,4305,4330,4338,4322,4328,4331,23,26,8446,365825380,96578
652,a1301,20120105,4328,4331,4331,4350,4325,4331,4333,0,2,13064,566080500,99568
653,a1301,20120106,4331,4333,4308,4324,4305,4323,4315,-10,-18,6946,299781360,101230
654,a1301,20120109,4323,4315,4316,4338,4314,4332,4325,17,10,12654,547385080,104508
655,a1301,20120110,4332,4325,4358,4362,4348,4357,4354,32,29,17614,766994260,109674
656,a1301,20120111,4357,4354,4354,4366,4344,4362,4357,8,3,11204,488198320,110022
657,a1301,20120112,4362,4357,4348,4358,4344,4355,4352,-2,-5,14760,642415980,116866
658,a1301,20120113,4355,4352,4340,4345,4331,4335,4338,-17,-14,11422,495580920,116844
659,a1301,20120116,4335,4338,4308,4313,4283,4289,4302,-49,-36,13238,569517220,116444
660,a1301,20120117,4289,4302,4304,4315,4289,4313,4302,11,0,15022,646304140,115364
661,a1301,20120118,4313,4302,4312,4322,4300,4302,4311,0,9,8894,383442360,115072
662,a1301,20120119,4302,4311,4311,4317,4303,4309,4309,-2,-2,4882,210367040,114992
663,a1301,20120120,4309,4309,4319,4347,4315,4347,4330,38,21,7284,315469640,113102
664,a1301,20120130,4347,4330,4350,4355,4338,4340,4346,10,16,7642,332156200,112886
665,a1301,20120131,4340,4346,4330,4355,4320,4355,4340,9,-6,8588,372732580,112988
666,a1301,20120201,4355,4340,4358,4422,4358,4412,4400,72,60,31100,1368678860,116910
667,a1301,20120202,4412,4400,4412,4441,4412,4439,4429,39,29,21632,958132200,118118
668,a1301,20120203,4439,4429,4448,4457,4418,4424,4436,-5,7,14390,638340980,117134
669,a1301,20120206,4424,4436,4448,4473,4444,4465,4465,29,29,16038,716133180,116974
670,a1301,20120207,4465,4465,4465,4485,4437,4443,4459,-22,-6,25958,1157584980,116610
671,a1301,20120208,4443,4459,4455,4474,4445,4474,4460,15,1,18662,832396600,116586
672,a1301,20120209,4474,4460,4446,4478,4446,4462,4466,2,6,15006,670274000,114592
673,a1301,20120210,4462,4466,4458,4459,4427,4436,4438,-30,-28,11772,522545040,115136
674,a1301,20120213,4436,4438,4454,4478,4449,4475,4466,37,28,16218,724385740,115482
675,a1301,20120214,4475,4466,4495,4498,4472,4474,4485,8,19,15810,709136440,116212
676,a1301,20120215,4474,4485,4485,4489,4462,4466,4472,-19,-13,10922,488476920,116428
677,a1301,20120216,4466,4472,4478,4478,4444,4453,4456,-19,-16,19072,849989360,117808
678,a1301,20120217,4453,4456,4460,4482,4456,4475,4472,19,16,16106,720399500,118114
679,a1301,20120220,4475,4472,4489,4509,4477,4485,4492,13,20,25016,1123939380,120622
680,a1301,20120221,4485,4492,4488,4516,4477,4513,4500,21,8,26508,1193097500,123242
681,a1301,20120222,4513,4500,4507,4509,4493,4495,4501,-5,1,14494,652392880,122622
682,a1301,20120223,4495,4501,4495,4496,4473,4490,4483,-11,-18,14048,629890460,122482
683,a1301,20120224,4490,4483,4490,4496,4483,4491,4489,8,6,11220,503741820,123636
684,a1301,20120227,4491,4489,4491,4514,4491,4503,4504,14,15,12182,548790680,123562
685,a1301,20120228,4503,4504,4518,4537,4515,4536,4526,32,22,22692,1027244240,127990
686,a1301,20120229,4536,4526,4535,4542,4523,4529,4528,3,2,18300,828781680,124358
687,a1301,20120301,4529,4528,4490,4544,4490,4508,4523,-20,-5,27824,1258504040,126210
688,a1301,20120302,4508,4523,4525,4533,4519,4530,4526,7,3,13856,627122620,127044
689,a1301,20120305,4530,4526,4529,4552,4511,4523,4531,-3,5,43448,1969036340,141290
690,a1301,20120306,4523,4531,4511,4518,4500,4505,4508,-26,-23,20974,945607920,145354
691,a1301,20120307,4505,4508,4499,4515,4480,4488,4499,-20,-9,24396,1097705340,146390
692,a1301,20120308,4488,4499,4496,4512,4488,4502,4500,3,1,24780,1115137740,146436
693,a1301,20120309,4502,4500,4513,4566,4512,4563,4545,63,45,46498,2113667000,153326
694,a1301,20120312,4563,4545,4545,4555,4527,4532,4537,-13,-8,41050,1862505380,161532
695,a1301,20120313,4532,4537,4530,4555,4523,4553,4543,16,6,28720,1304822820,161614
696,a1301,20120314,4553,4543,4567,4584,4538,4545,4563,2,20,57660,2631089400,173830
697,a1301,20120315,4545,4563,4560,4560,4516,4538,4536,-25,-27,72030,3267487460,201856
698,a1301,20120316,4538,4536,4558,4567,4522,4535,4547,-1,11,46996,2137209740,209430
699,a1301,20120319,4535,4547,4551,4568,4545,4555,4556,8,9,53724,2448160180,213732
700,a1301,20120320,4555,4556,4549,4550,4491,4496,4517,-60,-39,50894,2299354760,223042
701,a1301,20120321,4496,4517,4480,4510,4476,4510,4498,-7,-19,24688,1110475920,222968
702,a1301,20120322,4510,4498,4520,4526,4512,4516,4518,18,20,24224,1094470440,223042
703,a1301,20120323,4516,4518,4527,4555,4519,4551,4538,33,20,50758,2303540580,223300
704,a1301,20120326,4551,4538,4560,4598,4553,4590,4578,52,40,113480,5195871300,207388
705,a1301,20120327,4590,4578,4590,4598,4576,4593,4588,15,10,53738,2466008520,210156
706,a1301,20120328,4593,4588,4580,4594,4565,4573,4579,-15,-9,74518,3412402560,215790
707,a1301,20120329,4573,4579,4575,4599,4553,4558,4572,-21,-7,90146,4122022340,215902
708,a1301,20120330,4558,4572,4550,4553,4527,4529,4534,-43,-38,40756,1847896140,218134
709,a1301,20120405,4529,4534,4606,4658,4586,4654,4627,120,93,106908,4946805120,200364
710,a1301,20120406,4654,4627,4654,4745,4654,4723,4720,96,93,337402,15927331020,245086
711,a1301,20120409,4723,4720,4747,4747,4711,4733,4731,13,11,148104,7007667680,234758
712,a1301,20120410,4733,4731,4725,4774,4724,4764,4752,33,21,291184,13838092840,254610
713,a1301,20120411,4764,4752,4720,4720,4562,4673,4690,-79,-62,175442,8229469080,236344
714,a1301,20120412,4673,4690,4677,4690,4661,4680,4676,-10,-14,118748,5553523100,234446
715,a1301,20120413,4680,4676,4720,4727,4681,4682,4700,6,24,145894,6858055300,223988
716,a1301,20120416,4682,4700,4632,4672,4632,4663,4653,-37,-47,148072,6890686840,234124
717,a1301,20120417,4663,4653,4661,4672,4651,4660,4663,7,10,99958,4661117400,237552
718,a1301,20120418,4660,4663,4677,4678,4617,4635,4644,-28,-19,150798,7004282680,237826
719,a1301,20120419,4635,4644,4629,4648,4622,4640,4636,-4,-8,95454,4425631920,238604
720,a1301,20120420,4640,4636,4640,4647,4624,4638,4636,2,0,92630,4295248680,241194
721,a1301,20120423,4638,4636,4697,4697,4658,4662,4675,26,39,109094,5100277540,251142
722,a1301,20120424,4662,4675,4648,4669,4637,4641,4652,-34,-23,108690,5056313580,251908
723,a1301,20120425,4641,4652,4682,4705,4658,4659,4679,7,27,209810,9817743160,260080
724,a1301,20120426,4659,4679,4658,4658,4637,4642,4646,-37,-33,98618,4582214500,262708
725,a1301,20120427,4642,4646,4655,4666,4642,4654,4654,8,8,116830,5438156500,261086
726,a1301,20120502,4654,4654,4670,4673,4632,4632,4646,-22,-8,108550,5043746820,269932
727,a1301,20120503,4632,4646,4633,4633,4598,4601,4615,-45,-31,170226,7856190040,279584
728,a1301,20120504,4601,4615,4604,4620,4586,4619,4600,4,-15,120818,5557788400,275336
729,a1301,20120507,4619,4600,4610,4610,4553,4566,4571,-34,-29,134862,6165221480,275842
730,a1301,20120508,4566,4571,4566,4582,4559,4562,4572,-9,1,83698,3827099480,275244
731,a1301,20120509,4562,4572,4530,4545,4504,4513,4519,-59,-53,152706,6901123580,271096
732,a1301,20120510,4513,4519,4522,4546,4507,4539,4524,20,5,105674,4781410060,271896
733,a1301,20120511,4539,4524,4545,4550,4466,4476,4502,-48,-22,199736,8993319600,285602
734,a1301,20120514,4476,4502,4450,4457,4355,4382,4397,-120,-105,281926,12396779980,260922
735,a1301,20120515,4382,4397,4360,4388,4342,4379,4366,-18,-31,163838,7153936020,245474
736,a1301,20120516,4379,4366,4338,4393,4293,4297,4342,-69,-24,165566,7189143600,253918
737,a1301,20120517,4297,4342,4339,4350,4308,4334,4329,-8,-13,196198,8494709620,261662
738,a1301,20120518,4334,4329,4314,4333,4281,4307,4310,-22,-19,227676,9813375720,272658
739,a1301,20120521,4307,4310,4316,4361,4316,4347,4339,37,29,172028,7464777500,256232
740,a1301,20120522,4347,4339,4340,4345,4324,4332,4334,-7,-5,85190,3692539220,257338
741,a1301,20120523,4332,4334,4290,4290,4259,4274,4272,-60,-62,117508,5020823800,252260
742,a1301,20120524,4274,4272,4285,4310,4282,4310,4297,38,25,108264,4652474420,246978
743,a1301,20120525,4310,4297,4309,4311,4284,4302,4297,5,0,67906,2918134660,244950
744,a1301,20120528,4302,4297,4313,4333,4304,4328,4320,31,23,97300,4203761940,245628
745,a1301,20120529,4328,4320,4319,4343,4310,4340,4326,20,6,96180,4161245480,238748
746,a1301,20120530,4340,4326,4330,4357,4324,4331,4341,5,15,133856,5811326500,246792
747,a1301,20120531,4331,4341,4316,4340,4307,4317,4327,-24,-14,94382,4084492080,254414
748,a1301,20120601,4317,4327,4296,4308,4279,4297,4296,-30,-31,124236,5337678900,268480
749,a1301,20120604,4297,4296,4297,4305,4259,4280,4280,-16,-16,161154,6897543140,262998
750,a1301,20120605,4280,4280,4299,4349,4288,4325,4321,45,41,163460,7063361760,267980
751,a1301,20120606,4325,4321,4329,4379,4323,4341,4352,20,31,164962,7180155120,261024
752,a1301,20120607,4341,4352,4369,4384,4334,4347,4365,-5,13,153852,6717129740,237796
753,a1301,20120608,4347,4365,4383,4384,4321,4344,4352,-21,-13,142036,6182336740,236280
754,a1301,20120611,4344,4352,4360,4413,4360,4411,4390,59,38,179782,7893524160,231896
755,a1301,20120612,4411,4390,4380,4432,4379,4425,4410,35,20,315956,13933798920,265230
756,a1301,20120613,4425,4410,4417,4423,4392,4393,4402,-17,-8,173352,7632623600,258358
757,a1301,20120614,4393,4402,4371,4374,4339,4340,4354,-62,-48,141986,6182548560,264344
758,a1301,20120615,4340,4354,4346,4370,4341,4368,4360,14,6,119956,5230197040,246902
759,a1301,20120618,4368,4360,4388,4395,4364,4378,4376,18,16,114712,5020452180,246202
760,a1301,20120619,4378,4376,4420,4456,4405,4444,4438,68,62,188746,8376560260,231888
761,a1301,20120620,4444,4438,4478,4488,4461,4475,4471,37,33,129760,5802619520,233380
762,a1301,20120621,4475,4471,4451,4469,4424,4461,4451,-10,-20,163128,7261910480,206244
763,a1301,20120625,4461,4451,4506,4560,4502,4511,4534,60,83,235314,10670800860,219036
764,a1301,20120626,4511,4534,4523,4534,4499,4515,4516,-19,-18,166830,7534238160,212594
765,a1301,20120627,4515,4516,4510,4529,4497,4505,4510,-11,-6,111226,5017069120,209352
766,a1301,20120628,4505,4510,4460,4515,4460,4469,4484,-41,-26,130214,5838814280,202888
767,a1301,20120629,4469,4484,4478,4495,4448,4495,4474,11,-10,106786,4778427700,202590
768,a1301,20120702,4495,4474,4550,4551,4487,4502,4509,28,35,116592,5257889140,206770
769,a1301,20120703,4502,4509,4506,4535,4498,4532,4515,23,6,122064,5511863200,207888
770,a1301,20120704,4532,4515,4542,4588,4536,4580,4561,65,46,162848,7428357180,206522
771,a1301,20120705,4580,4561,4567,4614,4567,4602,4596,41,35,156016,7171530260,198776
772,a1301,20120706,4602,4596,4614,4620,4530,4561,4582,-35,-14,111450,5107235260,192296
773,a1301,20120709,4561,4582,4572,4765,4572,4765,4720,183,138,806586,38070950180,368616
774,a1301,20120710,4765,4720,4736,4749,4666,4679,4696,-41,-24,936882,44004413220,292116
775,a1301,20120711,4679,4696,4696,4805,4644,4660,4722,-36,26,1258492,59434426440,303104
776,a1301,20120712,4660,4722,4638,4660,4597,4604,4626,-118,-96,481206,22262865460,296440
777,a1301,20120713,4604,4626,4644,4698,4626,4695,4669,69,43,699822,32675523000,350862
778,a1301,20120716,4695,4669,4766,4850,4766,4839,4818,170,149,1012182,48774917460,414044
779,a1301,20120717,4839,4818,4850,4858,4650,4745,4757,-73,-61,936734,44561109280,384398
780,a1301,20120718,4745,4757,4760,4786,4709,4726,4742,-31,-15,640844,30393398540,391166
781,a1301,20120719,4726,4742,4797,4797,4738,4772,4769,30,27,705478,33647854780,405152
782,a1301,20120720,4772,4769,4772,4837,4747,4815,4803,46,34,759378,36477617240,393522
783,a1301,20120723,4815,4803,4750,4904,4730,4835,4825,32,22,1939770,93598106560,498266
784,a1301,20120724,4835,4825,4632,4692,4632,4642,4660,-183,-165,855248,39854808680,342596
785,a1301,20120725,4642,4660,4598,4666,4577,4608,4635,-52,-25,567560,26311192640,271644
786,a1301,20120726,4608,4635,4633,4652,4600,4612,4622,-23,-13,366386,16934578600,247262
787,a1301,20120727,4612,4622,4602,4645,4566,4643,4607,21,-15,632032,29119716140,234078
788,a1301,20120730,4643,4607,4730,4785,4693,4775,4752,168,145,659326,31332878180,258332
789,a1301,20120731,4775,4752,4735,4775,4715,4769,4751,17,-1,415866,19758272200,251010
790,a1301,20120801,4769,4751,4780,4800,4730,4731,4771,-20,20,419650,20023143700,250510
791,a1301,20120802,4731,4771,4713,4752,4713,4744,4734,-27,-37,339726,16085730020,241486
792,a1301,20120803,4744,4734,4730,4840,4723,4756,4784,22,50,1442274,69007826780,268532
793,a1301,20120806,4756,4784,4728,4747,4694,4736,4725,-48,-59,553558,26159466160,240872
794,a1301,20120807,4736,4725,4742,4759,4717,4756,4736,31,11,448128,21224927160,233194
795,a1301,20120808,4756,4736,4725,4730,4667,4671,4699,-65,-37,468632,22024759980,235758
796,a1301,20120809,4671,4699,4700,4724,4694,4714,4710,15,11,309010,14557275860,230670
797,a1301,20120810,4714,4710,4770,4775,4735,4743,4750,33,40,310708,14760780140,225936
798,a1301,20120813,4743,4750,4733,4738,4707,4709,4725,-41,-25,180618,8535765000,222904
799,a1301,20120814,4709,4725,4685,4707,4651,4705,4681,-20,-44,234156,10961659280,214846
800,a1301,20120815,4705,4681,4698,4768,4686,4750,4734,69,53,451494,21376538800,231404
801,a1301,20120816,4750,4734,4753,4772,4720,4725,4738,-9,4,258840,12265772740,233416
802,a1301,20120817,4725,4738,4738,4742,4717,4731,4730,-7,-8,142364,6734134720,229236
803,a1301,20120820,4731,4730,4742,4779,4735,4759,4762,29,32,208808,9945127540,227342
804,a1301,20120821,4759,4762,4800,4848,4789,4846,4828,84,66,313954,15159596260,221966
805,a1301,20120822,4846,4828,4876,4896,4863,4870,4877,42,49,255640,12467749480,218398
806,a1301,20120823,4870,4877,4900,4945,4853,4873,4896,-4,19,493324,24157975980,217328
807,a1301,20120824,4873,4896,4860,4919,4852,4918,4891,22,-5,205390,10046538440,219932
808,a1301,20120827,4918,4891,4969,4999,4937,4954,4965,63,74,248368,12331537480,218680
809,a1301,20120828,4954,4965,4905,4927,4882,4885,4905,-80,-60,217338,10662349840,205166
810,a1301,20120829,4885,4905,4898,4923,4861,4920,4897,15,-8,213226,10442494840,201450
811,a1301,20120830,4920,4897,4936,4955,4907,4942,4930,45,33,182214,8983826740,211318
812,a1301,20120831,4942,4930,4930,4930,4905,4911,4914,-19,-16,122482,6019854540,199672
813,a1301,20120903,4911,4914,4909,5008,4909,4975,4966,61,52,243244,12081889420,192222
814,a1301,20120904,4975,4966,4984,5007,4971,5000,4991,34,25,219534,10957054680,184586
815,a1301,20120905,5000,4991,4966,4980,4945,4957,4963,-34,-28,113338,5625123120,173350
816,a1301,20120906,4957,4963,4909,4913,4851,4865,4878,-98,-85,93772,4574657700,161004
817,a1301,20120907,4865,4878,4873,4898,4839,4844,4868,-34,-10,83636,4071798780,152272
818,a1301,20120910,4844,4868,4839,4887,4836,4878,4865,10,-3,57174,2781519020,149452
819,a1301,20120911,4878,4865,4870,4901,4838,4853,4860,-12,-5,97658,4746636220,146720
820,a1301,20120912,4853,4860,4850,4888,4840,4872,4860,12,0,57942,2816541340,140972
821,a1301,20120913,4872,4860,4910,4932,4897,4899,4917,39,57,52720,2592733220,139674
822,a1301,20120914,4899,4917,4923,4964,4903,4919,4931,2,14,44188,2179018360,139510
823,a1301,20120917,4919,4931,4888,4894,4814,4818,4858,-113,-73,59214,2877123300,135440
824,a1301,20120918,4818,4858,4750,4786,4713,4728,4755,-130,-103,90738,4314963820,121516
825,a1301,20120919,4728,4755,4755,4779,4751,4769,4763,14,8,33626,1601819300,117864
826,a1301,20120920,4769,4763,4779,4787,4744,4753,4765,-10,2,43578,2076593500,117056
827,a1301,20120921,4753,4765,4752,4800,4720,4797,4768,32,3,78788,3757060280,110968
828,a1301,20120924,4797,4768,4760,4830,4734,4814,4785,46,17,230034,11008576740,107850
829,a1301,20120925,4814,4785,4836,4901,4815,4898,4863,113,78,109850,5342123060,106148
830,a1301,20120926,4898,4863,4898,4938,4837,4853,4891,-10,28,177720,8693910380,101264
831,a1301,20120927,4853,4891,4810,4867,4810,4833,4836,-58,-55,125162,6053807100,91356
832,a1301,20120928,4833,4836,4847,4875,4820,4847,4847,11,11,61468,2979418860,83932
833,a1301,20121008,4847,4847,4840,4840,4707,4711,4756,-136,-91,92052,4378800140,69430
834,a1301,20121009,4711,4756,4733,4744,4691,4721,4715,-35,-41,92556,4364041500,72642
835,a1301,20121010,4721,4715,4697,4706,4656,4700,4678,-15,-37,54102,2531042120,72790
836,a1301,20121011,4700,4678,4679,4742,4677,4715,4721,37,43,58164,2745967640,72342
837,a1301,20121012,4715,4721,4730,4756,4668,4671,4703,-50,-18,71884,3380733820,72904
838,a1301,20121015,4671,4703,4651,4689,4636,4675,4664,-28,-39,42668,1990045700,70524
839,a1301,20121016,4675,4664,4675,4702,4662,4668,4681,4,17,34992,1638192900,66804
840,a1301,20121017,4668,4681,4652,4677,4644,4663,4656,-18,-25,34094,1587754240,65358
841,a1301,20121018,4663,4656,4670,4696,4663,4688,4681,32,25,29652,1388240280,63610
842,a1301,20121019,4688,4681,4708,4716,4682,4691,4690,10,9,17758,833017020,61342
843,a1301,20121022,4691,4690,4692,4729,4681,4723,4705,33,15,20386,959268780,55448
844,a1301,20121023,4723,4705,4723,4723,4684,4686,4698,-19,-7,15964,750053180,54630
845,a1301,20121024,4686,4698,4703,4747,4699,4740,4729,42,31,34098,1612691240,48316
846,a1301,20121025,4740,4729,4745,4753,4720,4738,4736,9,7,13042,617730700,46416
847,a1301,20121026,4738,4736,4731,4774,4724,4764,4750,28,14,27842,1322616600,43318
848,a1301,20121029,4764,4750,4750,4763,4706,4708,4723,-42,-27,28714,1356248060,42756
849,a1301,20121030,4708,4723,4705,4711,4680,4700,4697,-23,-26,16008,751947980,42066
850,a1301,20121031,4700,4697,4707,4730,4688,4730,4706,33,9,10166,478425960,41790
851,a1301,20121101,4730,4706,4747,4837,4715,4799,4788,93,82,34304,1642548580,36628
852,a1301,20121102,4799,4788,4788,4804,4767,4789,4787,1,-1,19456,931428000,32028
853,a1301,20121105,4789,4787,4750,4792,4722,4745,4760,-42,-27,20040,954041520,28592
854,a1301,20121106,4745,4760,4747,4777,4747,4769,4764,9,4,9030,430195420,27770
855,a1301,20121107,4769,4764,4771,4773,4717,4726,4736,-38,-28,11356,537857220,25442
856,a1301,20121108,4726,4736,4728,4739,4708,4728,4726,-8,-10,6980,329943700,25230
857,a1301,20121109,4728,4726,4716,4733,4677,4677,4698,-49,-28,11124,522698780,24170
858,a1301,20121112,4677,4698,4629,4630,4522,4622,4593,-76,-105,44818,2058549320,27176
859,a1301,20121113,4622,4593,4605,4657,4605,4653,4629,60,36,13746,636438100,24636
860,a1301,20121114,4653,4629,4687,4687,4630,4639,4643,10,14,13610,631924400,22070
861,a1301,20121115,4639,4643,4623,4639,4601,4603,4622,-40,-21,8834,408334640,22088
862,a1301,20121116,4603,4622,4605,4632,4600,4631,4611,9,-11,9424,434585300,21428
863,a1301,20121119,4631,4611,4638,4652,4611,4625,4627,14,16,4430,205008520,20870
864,a1301,20121120,4625,4627,4625,4636,4609,4630,4620,3,-7,3796,175384480,20414
865,a1301,20121121,4630,4620,4650,4650,4633,4645,4643,25,23,5822,270362980,20168
866,a1301,20121122,4645,4643,4641,4645,4630,4645,4640,2,-3,5004,232196540,18454
867,a1301,20121123,4645,4640,4636,4672,4636,4660,4657,20,17,2182,101625860,17858
868,a1301,20121126,4660,4657,4666,4670,4650,4653,4661,-4,4,2602,121299820,17346
869,a1301,20121127,4653,4661,4662,4669,4637,4637,4651,-24,-10,3374,156956680,16074
870,a1301,20121128,4637,4651,4676,4676,4631,4641,4649,-10,-2,2718,126365200,15010
871,a1301,20121129,4641,4649,4640,4662,4630,4657,4646,8,-3,2584,120061380,14396
872,a1301,20121130,4657,4646,4654,4656,4638,4649,4647,3,1,1660,77141620,13586
873,a1301,20121203,4649,4647,4653,4670,4647,4652,4659,5,12,2332,108651120,12762
874,a1301,20121204,4652,4659,4648,4648,4620,4637,4631,-22,-28,2200,101886220,11710
875,a1301,20121205,4637,4631,4633,4646,4627,4641,4635,10,4,1302,60348760,11164
876,a1301,20121206,4641,4635,4645,4660,4641,4648,4653,13,18,2424,112797220,10624
877,a1301,20121207,4648,4653,4646,4660,4626,4650,4651,-3,-2,1648,76650660,10202
878,a1301,20121210,4650,4651,4630,4645,4625,4642,4638,-9,-13,1128,52319460,9960
879,a1301,20121211,4642,4638,4648,4650,4630,4632,4640,-6,2,778,36100820,9650
880,a1301,20121212,4632,4640,4631,4642,4620,4632,4627,-8,-13,1456,67376480,9352
881,a1301,20121213,4632,4627,4640,4650,4627,4627,4640,0,13,600,27840640,9028
882,a1301,20121214,4627,4640,4627,4644,4627,4640,4638,0,-2,1674,77654160,8910
883,a1301,20121217,4640,4638,4643,4695,4643,4692,4673,54,35,4328,202287960,5390
884,a1301,20121218,4692,4673,4680,4685,4652,4656,4669,-17,-4,488,22786620,5454
885,a1301,20121219,4656,4669,4656,4656,4631,4633,4640,-36,-29,450,20884000,5474
886,a1301,20121220,4633,4640,4617,4628,4601,4610,4618,-30,-22,2784,128566980,6784
887,a1301,20121221,4610,4618,4604,4613,4600,4613,4605,-5,-13,536,24683360,6342
888,a1301,20121224,4613,4605,4617,4629,4605,4615,4620,10,15,1024,47312120,5946
889,a1301,20121225,4615,4620,4615,4617,4601,4605,4609,-15,-11,916,42227020,5572
890,a1301,20121226,4605,4609,4615,4650,4443,4606,4610,-3,1,902,41584480,5236
891,a1301,20121227,4606,4610,4604,4617,4604,4612,4612,2,2,90,4151380,5160
892,a1301,20121228,4612,4612,4583,4624,4583,4624,4620,12,8,158,7299680,5146
893,a1301,20121231,4624,4620,4704,4704,4600,4610,4617,-10,-3,146,6741740,5104
894,a1303,20120104,4340,4340,4368,4368,4367,4367,4367,27,27,4,174700,102
895,a1303,20120105,4367,4367,4375,4375,4375,4375,4375,8,8,8,350000,94
896,a1303,20120106,4375,4375,4351,4351,4351,4351,4351,-24,-24,2,87020,96
897,a1303,20120109,4351,4351,4353,4369,4353,4369,4362,18,11,6,261740,96
898,a1303,20120110,4369,4362,4375,4384,4375,4384,4381,22,19,12,525820,84
899,a1303,20120111,4384,4381,4376,4377,4376,4377,4376,-4,-5,12,525220,82
900,a1303,20120112,4377,4376,0,0,0,4376,4376,0,0,0,0,82
901,a1303,20120113,4376,4376,4363,4363,4361,4361,4361,-15,-15,12,523360,82
902,a1303,20120116,4361,4361,4321,4321,4320,4320,4320,-41,-41,4,172820,82
903,a1303,20120117,4320,4320,4345,4345,4345,4345,4345,25,25,4,173800,82
904,a1303,20120118,4345,4345,0,0,0,4345,4345,0,0,0,0,82
905,a1303,20120119,4345,4345,0,0,0,4345,4345,0,0,0,0,82
906,a1303,20120120,4345,4345,4360,4360,4360,4360,4360,15,15,12,523200,70
907,a1303,20120130,4360,4360,0,0,0,4360,4360,0,0,0,0,70
908,a1303,20120131,4360,4360,4317,4374,4317,4362,4357,2,-3,16,697260,72
909,a1303,20120201,4362,4357,4383,4433,4383,4433,4417,76,60,16,706780,60
910,a1303,20120202,4433,4417,4448,4457,4448,4457,4449,40,32,10,444980,62
911,a1303,20120203,4457,4449,0,0,0,4449,4449,0,0,0,0,62
912,a1303,20120206,4449,4449,4500,4508,4489,4490,4498,41,49,56,2519380,50
913,a1303,20120207,4490,4498,4498,4498,4491,4491,4494,-7,-4,4,179780,48
914,a1303,20120208,4491,4494,0,0,0,4494,4494,0,0,0,0,48
915,a1303,20120209,4494,4494,0,0,0,4494,4494,0,0,0,0,48
916,a1303,20120210,4494,4494,4474,4474,4474,4474,4474,-20,-20,10,447400,58
917,a1303,20120213,4474,4474,4503,4503,4499,4499,4502,25,28,16,720320,46
918,a1303,20120214,4499,4502,4510,4515,4503,4503,4509,1,7,6,270560,50
919,a1303,20120215,4503,4509,4495,4495,4495,4495,4495,-14,-14,2,89900,48
920,a1303,20120216,4495,4495,4484,4491,4481,4491,4486,-4,-9,8,358900,42
921,a1303,20120217,4491,4486,4502,4510,4492,4502,4500,16,14,40,1800320,48
922,a1303,20120220,4502,4500,4517,4517,4510,4510,4514,10,14,10,451420,48
923,a1303,20120221,4510,4514,0,0,0,4514,4514,0,0,0,0,48
924,a1303,20120222,4514,4514,0,0,0,4514,4514,0,0,0,0,48
925,a1303,20120223,4514,4514,4510,4510,4510,4510,4510,-4,-4,2,90200,50
926,a1303,20120224,4510,4510,0,0,0,4510,4510,0,0,0,0,50
927,a1303,20120227,4510,4510,4532,4532,4532,4532,4532,22,22,2,90640,48
928,a1303,20120228,4532,4532,0,0,0,4532,4532,0,0,0,0,48
929,a1303,20120229,4532,4532,0,0,0,4532,4532,0,0,0,0,48
930,a1303,20120301,4532,4532,4563,4587,4548,4563,4564,31,32,36,1643280,50
931,a1303,20120302,4563,4564,4546,4555,4546,4554,4551,-10,-13,12,546200,54
932,a1303,20120305,4554,4551,4570,4575,4557,4557,4570,6,19,10,457040,48
933,a1303,20120306,4557,4570,4536,4536,4536,4536,4536,-34,-34,2,90720,48
934,a1303,20120307,4536,4536,4527,4531,4527,4527,4528,-9,-8,6,271700,50
935,a1303,20120308,4527,4528,4523,4539,4523,4532,4531,4,3,14,634360,48
936,a1303,20120309,4532,4531,4549,4580,4549,4578,4575,47,44,20,915080,54
937,a1303,20120312,4578,4575,4571,4571,4536,4560,4555,-15,-20,6,273340,56
938,a1303,20120313,4560,4555,0,0,0,4555,4555,0,0,0,0,56
939,a1303,20120314,4555,4555,0,0,0,4555,4555,0,0,0,0,56
940,a1303,20120315,4555,4555,0,0,0,4555,4555,0,0,0,0,56
941,a1303,20120316,4555,4555,0,0,0,4555,4555,0,0,0,0,56
942,a1303,20120319,4555,4555,0,0,0,4555,4555,0,0,0,0,56
943,a1303,20120320,4555,4555,0,0,0,4555,4555,0,0,0,0,56
944,a1303,20120321,4555,4555,0,0,0,4555,4555,0,0,0,0,56
945,a1303,20120322,4555,4555,0,0,0,4555,4555,0,0,0,0,56
946,a1303,20120323,4555,4555,0,0,0,4555,4555,0,0,0,0,56
947,a1303,20120326,4555,4555,4547,4614,4547,4609,4586,54,31,82,3761220,76
948,a1303,20120327,4609,4586,4615,4615,4607,4614,4610,28,24,20,922120,70
949,a1303,20120328,4614,4610,4595,4605,4595,4595,4597,-15,-13,8,367800,64
950,a1303,20120329,4595,4597,4590,4602,4570,4602,4585,5,-12,40,1834220,60
951,a1303,20120330,4602,4585,4556,4565,4553,4555,4556,-30,-29,18,820100,58
952,a1303,20120405,4555,4556,4650,4656,4650,4656,4653,100,97,4,186120,56
953,a1303,20120406,4656,4653,4733,4769,4733,4769,4760,116,107,12,571220,50
954,a1303,20120409,4769,4760,4763,4763,4763,4763,4763,3,3,2,95260,52
955,a1303,20120410,4763,4763,4769,4780,4769,4778,4774,15,11,16,763880,60
956,a1303,20120411,4778,4774,4700,4733,4700,4733,4725,-41,-49,14,661560,62
957,a1303,20120412,4733,4725,4709,4724,4709,4724,4719,-1,-6,14,660660,68
958,a1303,20120413,4724,4719,4738,4749,4732,4732,4737,13,18,8,379020,70
959,a1303,20120416,4732,4737,4700,4701,4679,4679,4694,-58,-43,8,375540,68
960,a1303,20120417,4679,4694,0,0,0,4694,4694,0,0,0,0,68
961,a1303,20120418,4694,4694,4665,4675,4652,4675,4664,-19,-30,6,279840,70
962,a1303,20120419,4675,4664,4579,4685,4579,4683,4661,19,-3,14,652580,74
963,a1303,20120420,4683,4661,4679,4696,4675,4696,4679,35,18,50,2339680,76
964,a1303,20120423,4696,4679,4696,4723,4690,4715,4709,36,30,62,2919720,92
965,a1303,20120424,4715,4709,4705,4705,4688,4688,4693,-21,-16,16,750940,82
966,a1303,20120425,4688,4693,4730,4746,4711,4716,4726,23,33,44,2079600,74
967,a1303,20120426,4716,4726,0,0,0,4726,4726,0,0,0,0,74
968,a1303,20120427,4726,4726,4691,4704,4670,4700,4693,-26,-33,42,1971220,76
969,a1303,20120502,4700,4693,4694,4694,4694,4694,4694,1,1,4,187760,74
970,a1303,20120503,4694,4694,4667,4673,4629,4629,4656,-65,-38,8,372520,74
971,a1303,20120504,4629,4656,4611,4648,4611,4648,4640,-8,-16,20,928120,64
972,a1303,20120507,4648,4640,4626,4626,4588,4618,4610,-22,-30,6,276640,64
973,a1303,20120508,4618,4610,4605,4605,4605,4605,4605,-5,-5,2,92100,62
974,a1303,20120509,4605,4605,4535,4572,4535,4569,4556,-36,-49,12,546740,64
975,a1303,20120510,4569,4556,4556,4574,4516,4558,4549,2,-7,14,636940,64
976,a1303,20120511,4558,4549,4547,4547,4529,4530,4535,-19,-14,12,544240,64
977,a1303,20120514,4530,4535,4465,4465,4465,4465,4465,-70,-70,2,89300,64
978,a1303,20120515,4465,4465,4450,4450,4400,4410,4420,-55,-45,74,3271300,70
979,a1303,20120516,4410,4420,4403,4423,4362,4362,4396,-58,-24,36,1582560,86
980,a1303,20120517,4362,4396,4372,4388,4353,4379,4371,-17,-25,10,437120,82
981,a1303,20120518,4379,4371,4340,4340,4301,4301,4312,-70,-59,38,1638720,106
982,a1303,20120521,4301,4312,4350,4390,4336,4390,4373,78,61,50,2186620,112
983,a1303,20120522,4390,4373,4364,4377,4340,4371,4355,-2,-18,22,958200,116
984,a1303,20120523,4371,4355,4371,4371,4301,4309,4315,-46,-40,84,3625300,78
985,a1303,20120524,4309,4315,4323,4331,4323,4331,4327,16,12,14,605860,72
986,a1303,20120525,4331,4327,4328,4345,4326,4326,4331,-1,4,10,433100,80
987,a1303,20120528,4326,4331,4343,4359,4343,4356,4352,25,21,18,783400,64
988,a1303,20120529,4356,4352,4380,4380,4380,4380,4380,28,28,2,87600,64
989,a1303,20120530,4380,4380,4368,4368,4349,4349,4353,-31,-27,30,1305980,82
990,a1303,20120531,4349,4353,4362,4392,4348,4348,4371,-5,18,186,8130880,54
991,a1303,20120601,4348,4371,4295,4344,4295,4344,4315,-27,-56,20,863020,50
992,a1303,20120604,4344,4315,4293,4311,4284,4293,4289,-22,-26,20,857840,52
993,a1303,20120605,4293,4289,4384,4384,4327,4327,4368,38,79,14,611620,46
994,a1303,20120606,4327,4368,4343,4391,4343,4380,4368,12,0,84,3669440,48
995,a1303,20120607,4380,4368,4463,4478,4382,4386,4424,18,56,36,1592640,56
996,a1303,20120608,4386,4424,4403,4408,4385,4388,4396,-36,-28,48,2110140,68
997,a1303,20120611,4388,4396,4398,4445,4398,4430,4424,34,28,32,1415740,54
998,a1303,20120612,4430,4424,4426,4499,4415,4445,4451,21,27,64,2849200,62
999,a1303,20120613,4445,4451,4428,4431,4427,4427,4428,-24,-23,26,1151280,50
1000,a1303,20120614,4427,4428,4414,4414,4366,4378,4387,-50,-41,48,2105820,48
1001,a1303,20120615,4378,4387,4370,4403,4366,4403,4387,16,0,30,1316180,62
1002,a1303,20120618,4403,4387,4426,4426,4388,4412,4406,25,19,10,440620,62
1003,a1303,20120619,4412,4406,4412,4503,4412,4484,4460,78,54,12,535260,64
1004,a1303,20120620,4484,4460,4498,4498,4485,4485,4491,25,31,4,179660,62
1005,a1303,20120621,4485,4491,0,0,0,4491,4491,0,0,0,0,62
1006,a1303,20120625,4491,4491,4509,4577,4509,4576,4520,85,29,52,2350440,64
1007,a1303,20120626,4576,4520,4550,4550,4530,4548,4544,28,24,8,363560,68
1008,a1303,20120627,4548,4544,4555,4555,4530,4530,4540,-14,-4,12,544860,66
1009,a1303,20120628,4530,4540,4536,4536,4489,4495,4506,-45,-34,12,540760,66
1010,a1303,20120629,4495,4506,4484,4517,4484,4517,4497,11,-9,14,629620,66
1011,a1303,20120702,4517,4497,4544,4544,4531,4534,4535,37,38,14,634900,64
1012,a1303,20120703,4534,4535,4550,4550,4523,4550,4540,15,5,10,454080,66
1013,a1303,20120704,4550,4540,4593,4598,4593,4598,4596,58,56,6,275780,68
1014,a1303,20120705,4598,4596,4633,4646,4587,4633,4618,37,22,24,1108440,72
1015,a1303,20120706,4633,4618,4600,4600,4584,4584,4596,-34,-22,10,459640,68
1016,a1303,20120709,4584,4596,4629,4768,4625,4768,4683,172,87,42,1967160,74
1017,a1303,20120710,4768,4683,4704,4726,4682,4685,4705,2,22,36,1693980,80
1018,a1303,20120711,4685,4705,4778,4794,4689,4699,4740,-6,35,96,4550440,80
1019,a1303,20120712,4699,4740,4629,4629,4629,4629,4629,-111,-111,2,92580,82
1020,a1303,20120713,4629,4629,4695,4721,4641,4721,4693,92,64,22,1032640,84
1021,a1303,20120716,4721,4693,4841,4858,4764,4825,4797,132,104,66,3166280,90
1022,a1303,20120717,4825,4797,4753,4790,4740,4749,4757,-48,-40,34,1617660,84
1023,a1303,20120718,4749,4757,4762,4762,4709,4743,4736,-14,-21,24,1136780,88
1024,a1303,20120719,4743,4736,4751,4778,4751,4777,4769,41,33,20,953840,82
1025,a1303,20120720,4777,4769,4799,4799,4780,4799,4789,30,20,18,862080,84
1026,a1303,20120723,4799,4789,4697,4840,4690,4690,4749,-99,-40,584,27737260,226
1027,a1303,20120724,4690,4749,4560,4594,4560,4560,4566,-189,-183,114,5206100,220
1028,a1303,20120725,4560,4566,4511,4622,4511,4566,4578,0,12,216,9890200,262
1029,a1303,20120726,4566,4578,4579,4609,4540,4540,4550,-38,-28,112,5096540,244
1030,a1303,20120727,4540,4550,4550,4584,4544,4559,4556,9,6,46,2095860,244
1031,a1303,20120730,4559,4556,4645,4678,4572,4674,4660,118,104,124,5778900,248
1032,a1303,20120731,4674,4660,4671,4671,4620,4649,4644,-11,-16,40,1857900,250
1033,a1303,20120801,4649,4644,4650,4656,4620,4620,4647,-24,3,24,1115440,252
1034,a1303,20120802,4620,4647,4618,4626,4573,4596,4600,-51,-47,80,3680080,252
1035,a1303,20120803,4596,4600,4612,4664,4564,4604,4627,4,27,80,3702120,266
1036,a1303,20120806,4604,4627,4590,4651,4590,4624,4628,-3,1,248,11479520,188
1037,a1303,20120807,4624,4628,4640,4662,4640,4662,4650,34,22,22,1023180,186
1038,a1303,20120808,4662,4650,4655,4666,4636,4636,4651,-14,1,12,558220,186
1039,a1303,20120809,4636,4651,4655,4661,4653,4653,4656,2,5,24,1117460,170
1040,a1303,20120810,4653,4656,4677,4686,4664,4686,4673,30,17,10,467360,170
1041,a1303,20120813,4686,4673,4648,4672,4648,4649,4655,-24,-18,22,1024220,172
1042,a1303,20120814,4649,4655,4637,4654,4637,4654,4652,-1,-3,26,1209700,190
1043,a1303,20120815,4654,4652,4676,4694,4671,4687,4682,35,30,14,655500,190
1044,a1303,20120816,4687,4682,4693,4699,4693,4699,4696,17,14,4,187840,192
1045,a1303,20120817,4699,4696,4699,4699,4666,4690,4685,-6,-11,8,374860,192
1046,a1303,20120820,4690,4685,4681,4718,4681,4698,4702,13,17,38,1786780,188
1047,a1303,20120821,4698,4702,4731,4777,4731,4764,4768,62,66,16,762900,186
1048,a1303,20120822,4764,4768,4794,4840,4794,4822,4819,54,51,36,1734880,184
1049,a1303,20120823,4822,4819,4855,4876,4827,4828,4848,9,29,16,775800,188
1050,a1303,20120824,4828,4848,4820,4849,4793,4849,4824,1,-24,44,2122760,176
1051,a1303,20120827,4849,4824,4928,4928,4898,4900,4909,76,85,22,1080000,174
1052,a1303,20120828,4900,4909,4996,4996,4851,4873,4869,-36,-40,44,2142760,160
1053,a1303,20120829,4873,4869,4853,4853,4853,4853,4853,-16,-16,2,97060,160
1054,a1303,20120830,4853,4853,4882,4912,4863,4885,4884,32,31,20,976960,158
1055,a1303,20120831,4885,4884,4861,4868,4859,4859,4862,-25,-22,14,680700,158
1056,a1303,20120903,4859,4862,4891,4970,4888,4948,4933,86,71,78,3848080,164
1057,a1303,20120904,4948,4933,4958,5044,4939,5010,4991,77,58,58,2895000,172
1058,a1303,20120905,5010,4991,4987,4993,4977,4977,4984,-14,-7,24,1196260,166
1059,a1303,20120906,4977,4984,4914,4914,4826,4858,4848,-126,-136,124,6012660,158
1060,a1303,20120907,4858,4848,4870,4870,4820,4869,4854,21,6,18,873720,158
1061,a1303,20120910,4869,4854,4817,4877,4817,4877,4856,23,2,32,1554160,148
1062,a1303,20120911,4877,4856,4869,4869,4819,4822,4834,-34,-22,40,1933800,140
1063,a1303,20120912,4822,4834,4848,4864,4828,4843,4848,9,14,30,1454520,142
1064,a1303,20120913,4843,4848,4890,4898,4880,4890,4885,42,37,24,1172560,140
1065,a1303,20120914,4890,4885,4920,4920,4898,4898,4908,13,23,52,2552660,146
1066,a1303,20120917,4898,4908,4912,4912,4822,4845,4867,-63,-41,42,2044380,148
1067,a1303,20120918,4845,4867,4799,4799,4730,4733,4756,-134,-111,48,2283080,146
1068,a1303,20120919,4733,4756,4766,4789,4752,4752,4769,-4,13,10,476940,148
1069,a1303,20120920,4752,4769,4780,4780,4780,4780,4780,11,11,2,95600,148
1070,a1303,20120921,4780,4780,4800,4835,4765,4797,4801,17,21,12,576120,146
1071,a1303,20120924,4797,4801,4763,4822,4715,4822,4767,21,-34,16,762780,150
1072,a1303,20120925,4822,4767,4849,4869,4819,4864,4852,97,85,26,1261560,152
1073,a1303,20120926,4864,4852,4880,4914,4858,4890,4886,38,34,14,684040,152
1074,a1303,20120927,4890,4886,4783,4828,4782,4805,4809,-81,-77,22,1058180,152
1075,a1303,20120928,4805,4809,4838,4838,4795,4818,4815,9,6,10,481520,152
1076,a1303,20121008,4818,4815,4788,4788,4689,4689,4722,-126,-93,26,1227860,152
1077,a1303,20121009,4689,4722,4759,4759,4700,4709,4708,-13,-14,54,2542440,146
1078,a1303,20121010,4709,4708,4726,4726,4660,4705,4682,-3,-26,28,1311220,150
1079,a1303,20121011,4705,4682,4721,4721,4721,4721,4721,39,39,2,94420,148
1080,a1303,20121012,4721,4721,4750,4750,4750,4750,4750,29,29,2,95000,148
1081,a1303,20121015,4750,4750,0,0,0,4750,4750,0,0,0,0,148
1082,a1303,20121016,4750,4750,4718,4718,4683,4684,4701,-66,-49,18,846220,150
1083,a1303,20121017,4684,4701,4673,4707,4664,4675,4680,-26,-21,40,1872360,162
1084,a1303,20121018,4675,4680,4710,4718,4703,4703,4709,23,29,28,1318740,150
1085,a1303,20121019,4703,4709,4728,4729,4701,4703,4712,-6,3,14,659720,144
1086,a1303,20121022,4703,4712,4695,4740,4695,4740,4715,28,3,22,1037440,144
1087,a1303,20121023,4740,4715,4715,4741,4683,4741,4713,26,-2,6,282780,146
1088,a1303,20121024,4741,4713,4775,4785,4763,4785,4771,72,58,94,4484960,184
1089,a1303,20121025,4785,4771,4824,4824,4778,4789,4792,18,21,46,2204740,166
1090,a1303,20121026,4789,4792,4814,4814,4767,4778,4784,-14,-8,20,956880,154
1091,a1303,20121029,4778,4784,4751,4751,4750,4750,4750,-34,-34,4,190020,150
1092,a1303,20121030,4750,4750,4737,4738,4729,4729,4733,-21,-17,8,378680,146
1093,a1303,20121031,4729,4733,4737,4750,4707,4707,4735,-26,2,8,378860,144
1094,a1303,20121101,4707,4735,4771,4891,4771,4891,4848,156,113,44,2133460,164
1095,a1303,20121102,4891,4848,4808,4899,4808,4888,4851,40,3,40,1940660,170
1096,a1303,20121105,4888,4851,4826,4876,4806,4830,4835,-21,-16,358,17310300,226
1097,a1303,20121106,4830,4835,4860,4868,4840,4868,4848,33,13,410,19879920,468
1098,a1303,20121107,4868,4848,4846,4860,4825,4825,4842,-23,-6,248,12008440,290
1099,a1303,20121108,4825,4842,4816,4835,4816,4832,4826,-10,-16,32,1544380,288
1100,a1303,20121109,4832,4826,4818,4818,4762,4762,4800,-64,-26,36,1728200,286
1101,a1303,20121112,4762,4800,4688,4713,4643,4699,4684,-101,-116,72,3372820,258
1102,a1303,20121113,4699,4684,4647,4715,4647,4712,4703,28,19,34,1599260,252
1103,a1303,20121114,4712,4703,4734,4736,4722,4734,4731,31,28,36,1703220,252
1104,a1303,20121115,4734,4731,4729,4737,4710,4710,4721,-21,-10,18,849780,254
1105,a1303,20121116,4710,4721,4712,4719,4700,4711,4711,-10,-10,36,1696020,258
1106,a1303,20121119,4711,4711,4721,4721,4670,4706,4702,-5,-9,22,1034460,240
1107,a1303,20121120,4706,4702,4692,4718,4692,4718,4696,16,-6,24,1127120,228
1108,a1303,20121121,4718,4696,4726,4726,4726,4726,4726,30,30,2,94520,226
1109,a1303,20121122,4726,4726,4716,4725,4709,4725,4722,-1,-4,20,944460,220
1110,a1303,20121123,4725,4722,4752,4779,4733,4757,4750,35,28,30,1425160,214
1111,a1303,20121126,4757,4750,4747,4747,4739,4743,4741,-7,-9,16,758680,200
1112,a1303,20121127,4743,4741,4734,4734,4734,4734,4734,-7,-7,2,94680,200
1113,a1303,20121128,4734,4734,4723,4753,4683,4722,4731,-12,-3,46,2176300,170
1114,a1303,20121129,4722,4731,4729,4729,4713,4713,4721,-18,-10,4,188840,172
1115,a1303,20121130,4713,4721,4727,4754,4727,4749,4742,28,21,8,379360,174
1116,a1303,20121203,4749,4742,4773,4778,4732,4750,4760,8,18,18,856820,174
1117,a1303,20121204,4750,4760,4720,4720,4720,4720,4720,-40,-40,2,94400,174
1118,a1303,20121205,4720,4720,4722,4747,4722,4736,4735,16,15,6,284100,174
1119,a1303,20121206,4736,4735,4775,4775,4737,4737,4757,2,22,22,1046680,174
1120,a1303,20121207,4737,4757,4722,4744,4720,4744,4727,-13,-30,42,1985520,178
1121,a1303,20121210,4744,4727,4750,4750,4723,4727,4732,0,5,16,757200,182
1122,a1303,20121211,4727,4732,4810,4810,4737,4746,4754,14,22,22,1046060,180
1123,a1303,20121212,4746,4754,4735,4735,4724,4724,4730,-30,-24,12,567640,178
1124,a1303,20121213,4724,4730,4713,4713,4713,4713,4713,-17,-17,2,94260,178
1125,a1303,20121214,4713,4713,4722,4722,4722,4722,4722,9,9,2,94440,176
1126,a1303,20121217,4722,4722,4791,4851,4769,4789,4794,67,72,30,1438240,172
1127,a1303,20121218,4789,4794,0,0,0,4794,4794,0,0,0,0,172
1128,a1303,20121219,4794,4794,4779,4779,4779,4779,4779,-15,-15,2,95580,172
1129,a1303,20121220,4779,4779,4730,4745,4718,4738,4727,-41,-52,74,3498460,230
1130,a1303,20121221,4738,4727,4748,4748,4724,4724,4742,-3,15,18,853600,240
1131,a1303,20121224,4724,4742,4760,4760,4740,4740,4750,-2,8,22,1045100,238
1132,a1303,20121225,4740,4750,4733,4733,4726,4726,4729,-24,-21,4,189180,238
1133,a1303,20121226,4726,4729,4734,4734,4727,4727,4730,-2,1,4,189220,234
1134,a1303,20121227,4727,4730,4739,4739,4712,4739,4730,9,0,38,1797560,220
1135,a1303,20121228,4739,4730,4717,4717,4706,4706,4711,-24,-19,4,188460,218
1136,a1303,20121231,4706,4711,0,0,0,4711,4711,0,0,0,0,218
1137,a1305,20120104,4360,4362,4375,4386,4375,4383,4383,21,21,510,22356760,12476
1138,a1305,20120105,4383,4383,4381,4402,4380,4391,4392,8,9,2022,88811700,13566
1139,a1305,20120106,4391,4392,4371,4384,4369,4383,4376,-9,-16,788,34486360,14160
1140,a1305,20120109,4383,4376,4379,4392,4376,4387,4385,11,9,2610,114457320,16378
1141,a1305,20120110,4387,4385,4400,4417,4400,4412,4412,27,27,5302,233934080,20912
1142,a1305,20120111,4412,4412,4405,4421,4400,4420,4411,8,-1,2584,113998720,22556
1143,a1305,20120112,4420,4411,4406,4415,4400,4410,4408,-1,-3,1128,49725740,23442
1144,a1305,20120113,4410,4408,4402,4402,4390,4392,4395,-16,-13,2678,117705840,24582
1145,a1305,20120116,4392,4395,4355,4371,4352,4352,4361,-43,-34,1198,52254540,24658
1146,a1305,20120117,4352,4361,4363,4374,4348,4370,4362,9,1,3554,155036080,27370
1147,a1305,20120118,4370,4362,4371,4378,4351,4352,4364,-10,2,3790,165405380,30388
1148,a1305,20120119,4352,4364,4366,4366,4353,4363,4359,-1,-5,958,41763140,30368
1149,a1305,20120120,4363,4359,4371,4395,4366,4393,4383,34,24,500,21916600,30336
1150,a1305,20120130,4393,4383,4403,4408,4394,4394,4399,11,16,854,37570740,30388
1151,a1305,20120131,4394,4399,4392,4408,4380,4408,4396,9,-3,1332,58565840,30452
1152,a1305,20120201,4408,4396,4399,4476,4399,4471,4454,75,58,3440,153221040,30606
1153,a1305,20120202,4471,4454,4470,4507,4470,4505,4492,51,38,2884,129559300,30888
1154,a1305,20120203,4505,4492,4516,4521,4490,4498,4505,6,13,3430,154526020,32508
1155,a1305,20120206,4498,4505,4510,4560,4510,4554,4546,49,41,2040,92756640,33120
1156,a1305,20120207,4554,4546,4558,4577,4535,4540,4557,-6,11,2228,101537160,33350
1157,a1305,20120208,4540,4557,4558,4558,4526,4554,4541,-3,-16,4946,224620180,36750
1158,a1305,20120209,4554,4541,4538,4552,4529,4537,4539,-4,-2,1408,63917380,37472
1159,a1305,20120210,4537,4539,4525,4525,4506,4510,4514,-29,-25,732,33045400,37534
1160,a1305,20120213,4510,4514,4523,4555,4523,4552,4541,38,27,1594,72390620,37706
1161,a1305,20120214,4552,4541,4562,4570,4550,4553,4560,12,19,1350,61562360,37838
1162,a1305,20120215,4553,4560,4560,4567,4542,4542,4555,-18,-5,748,34072980,37798
1163,a1305,20120216,4542,4555,4554,4554,4520,4532,4529,-23,-26,1188,53807960,37940
1164,a1305,20120217,4532,4529,4535,4559,4531,4548,4549,19,20,2062,93809820,39174
1165,a1305,20120220,4548,4549,4576,4578,4551,4555,4563,6,14,3104,141666460,40788
1166,a1305,20120221,4555,4563,4559,4581,4538,4575,4559,12,-4,6456,294335320,45650
1167,a1305,20120222,4575,4559,4562,4572,4553,4555,4562,-4,3,2210,100828780,46890
1168,a1305,20120223,4555,4562,4558,4559,4535,4549,4542,-13,-20,3766,171088360,48256
1169,a1305,20120224,4549,4542,4551,4552,4542,4547,4547,5,5,2320,105495780,49322
1170,a1305,20120227,4547,4547,4553,4585,4503,4557,4560,10,13,2914,132900680,50906
1171,a1305,20120228,4557,4560,4575,4586,4568,4586,4573,26,13,5516,252295540,54376
1172,a1305,20120229,4586,4573,4589,4591,4575,4579,4579,6,6,904,41401740,54460
1173,a1305,20120301,4579,4579,4573,4593,4555,4559,4575,-20,-4,3356,153552080,54454
1174,a1305,20120302,4559,4575,4580,4582,4573,4581,4577,6,2,2082,95300160,55050
1175,a1305,20120305,4581,4577,4590,4600,4538,4572,4582,-5,5,14174,649483040,64192
1176,a1305,20120306,4572,4582,4572,4572,4540,4554,4557,-28,-25,4412,201063340,66930
1177,a1305,20120307,4554,4557,4540,4560,4535,4538,4548,-19,-9,2042,92888220,66910
1178,a1305,20120308,4538,4548,4531,4557,4531,4549,4547,1,-1,1544,70216560,66904
1179,a1305,20120309,4549,4547,4565,4612,4561,4612,4589,65,42,6642,304815760,67276
1180,a1305,20120312,4612,4589,4590,4600,4555,4583,4582,-6,-7,5472,250775540,68348
1181,a1305,20120313,4583,4582,4575,4604,4575,4599,4592,17,10,5616,257936100,69048
1182,a1305,20120314,4599,4592,4612,4629,4589,4598,4613,6,21,7160,330354540,71090
1183,a1305,20120315,4598,4613,4606,4613,4572,4589,4589,-24,-24,7426,340838660,74750
1184,a1305,20120316,4589,4589,4589,4616,4573,4583,4592,-6,3,5552,254986920,75338
1185,a1305,20120319,4583,4592,4596,4605,4593,4599,4599,7,7,4636,213235000,76158
1186,a1305,20120320,4599,4599,4590,4590,4547,4549,4563,-50,-36,8006,365359940,77752
1187,a1305,20120321,4549,4563,4547,4560,4535,4560,4551,-3,-12,1820,82843500,78048
1188,a1305,20120322,4560,4551,4565,4580,4562,4567,4568,16,17,1724,78764620,78078
1189,a1305,20120323,4567,4568,4574,4606,4573,4605,4589,37,21,4838,222052320,76846
1190,a1305,20120326,4605,4589,4610,4649,4610,4642,4629,53,40,6730,311532540,77140
1191,a1305,20120327,4642,4629,4649,4651,4630,4640,4640,11,11,2670,123913340,77064
1192,a1305,20120328,4640,4640,4634,4646,4617,4626,4632,-14,-8,7418,343625540,76944
1193,a1305,20120329,4626,4632,4629,4648,4606,4609,4622,-23,-10,3412,157716780,76750
1194,a1305,20120330,4609,4622,4599,4599,4580,4582,4585,-40,-37,2474,113447060,76748
1195,a1305,20120405,4582,4585,4649,4708,4626,4705,4679,120,94,10424,487802580,77284
1196,a1305,20120406,4705,4679,4700,4815,4700,4796,4776,117,97,29222,1395789440,81108
1197,a1305,20120409,4796,4776,4826,4828,4788,4805,4803,29,27,15808,759333840,85610
1198,a1305,20120410,4805,4803,4790,4845,4790,4841,4829,38,26,16660,804554920,87892
1199,a1305,20120411,4841,4829,4817,4817,4762,4764,4773,-65,-56,18050,861658600,89890
1200,a1305,20120412,4764,4773,4771,4780,4754,4778,4767,5,-6,16670,794746900,93712
1201,a1305,20120413,4778,4767,4808,4822,4770,4770,4794,3,27,34494,1653653020,111842
1202,a1305,20120416,4770,4794,4700,4757,4700,4752,4739,-42,-55,20816,986591920,111938
1203,a1305,20120417,4752,4739,4800,4800,4745,4751,4755,12,16,16050,763273880,112300
1204,a1305,20120418,4751,4755,4765,4775,4704,4721,4741,-34,-14,17226,816790140,112282
1205,a1305,20120419,4721,4741,4712,4738,4710,4732,4724,-9,-17,6064,286504260,112024
1206,a1305,20120420,4732,4724,4722,4734,4713,4730,4724,6,0,7674,362576580,112818
1207,a1305,20120423,4730,4724,4785,4785,4756,4758,4770,34,46,9538,454975480,113692
1208,a1305,20120424,4758,4770,4733,4757,4731,4735,4744,-35,-26,11788,559262620,115086
1209,a1305,20120425,4735,4744,4765,4800,4753,4754,4772,10,28,15604,744650580,118582
1210,a1305,20120426,4754,4772,4741,4749,4732,4734,4742,-38,-30,10788,511615240,118460
1211,a1305,20120427,4734,4742,4795,4795,4740,4755,4753,13,11,14088,669677720,120082
1212,a1305,20120502,4755,4753,4765,4771,4730,4731,4746,-22,-7,10970,520727520,121930
1213,a1305,20120503,4731,4746,4718,4727,4697,4697,4715,-49,-31,14136,666557680,127152
1214,a1305,20120504,4697,4715,4702,4715,4684,4715,4695,0,-20,11198,525823400,127940
1215,a1305,20120507,4715,4695,4694,4705,4644,4651,4659,-44,-36,29388,1369192960,143632
1216,a1305,20120508,4651,4659,4655,4668,4646,4648,4657,-11,-2,15536,723535320,149034
1217,a1305,20120509,4648,4657,4629,4629,4585,4589,4601,-68,-56,33798,1555183580,164324
1218,a1305,20120510,4589,4601,4591,4625,4584,4624,4606,23,5,16680,768295700,167230
1219,a1305,20120511,4624,4606,4635,4635,4552,4561,4585,-45,-21,30550,1400790520,170510
1220,a1305,20120514,4561,4585,4540,4544,4451,4473,4491,-112,-94,59652,2679059400,184378
1221,a1305,20120515,4473,4491,4460,4474,4435,4463,4456,-28,-35,34772,1549511480,190842
1222,a1305,20120516,4463,4456,4475,4475,4363,4370,4419,-86,-37,42304,1869730280,199060
1223,a1305,20120517,4370,4419,4411,4420,4378,4404,4400,-15,-19,31448,1383795860,204716
1224,a1305,20120518,4404,4400,4380,4402,4354,4376,4379,-24,-21,30278,1325907980,209966
1225,a1305,20120521,4376,4379,4398,4433,4379,4420,4414,41,35,24294,1072555960,211946
1226,a1305,20120522,4420,4414,4412,4417,4398,4402,4407,-12,-7,13614,600065080,214104
1227,a1305,20120523,4402,4407,4360,4361,4326,4337,4342,-70,-65,27932,1213059040,217798
1228,a1305,20120524,4337,4342,4347,4378,4346,4377,4364,35,22,24112,1052352040,221248
1229,a1305,20120525,4377,4364,4374,4378,4355,4377,4368,13,4,10116,441943300,220786
1230,a1305,20120528,4377,4368,4382,4408,4372,4404,4392,36,24,20718,910023600,218266
1231,a1305,20120529,4404,4392,4397,4424,4386,4416,4408,24,16,30010,1322881000,216318
1232,a1305,20120530,4416,4408,4400,4427,4395,4405,4413,-3,5,20812,918607640,216632
1233,a1305,20120531,4405,4413,4390,4409,4382,4391,4398,-22,-15,19436,854976100,216724
1234,a1305,20120601,4391,4398,4367,4378,4356,4362,4366,-36,-32,24066,1050943900,217908
1235,a1305,20120604,4362,4366,4350,4373,4326,4346,4345,-20,-21,34356,1492874980,216146
1236,a1305,20120605,4346,4345,4355,4416,4354,4395,4385,50,40,31054,1361829880,212854
1237,a1305,20120606,4395,4385,4399,4442,4391,4413,4420,28,35,36162,1598653720,213118
1238,a1305,20120607,4413,4420,4438,4447,4407,4433,4434,13,14,47608,2111394660,216630
1239,a1305,20120608,4433,4434,4453,4466,4401,4419,4429,-15,-5,52054,2305780120,217802
1240,a1305,20120611,4419,4429,4440,4489,4435,4489,4464,60,35,43242,1930640260,220642
1241,a1305,20120612,4489,4464,4464,4506,4456,4499,4483,35,19,48040,2153827640,223616
1242,a1305,20120613,4499,4483,4490,4500,4471,4476,4482,-7,-1,43522,1950731780,234048
1243,a1305,20120614,4476,4482,4455,4456,4417,4419,4435,-63,-47,37020,1642202760,230030
1244,a1305,20120615,4419,4435,4420,4445,4420,4441,4435,6,0,28944,1283748720,228240
1245,a1305,20120618,4441,4435,4460,4471,4444,4456,4456,21,21,30224,1347078200,229668
1246,a1305,20120619,4456,4456,4501,4549,4501,4536,4527,80,71,77546,3510697840,241136
1247,a1305,20120620,4536,4527,4580,4586,4552,4567,4566,40,39,83002,3790454520,226172
1248,a1305,20120621,4567,4566,4537,4559,4510,4551,4540,-15,-26,95332,4328641580,212194
1249,a1305,20120625,4551,4540,4615,4647,4594,4608,4625,68,85,92432,4275838040,205580
1250,a1305,20120626,4608,4625,4623,4641,4601,4634,4623,9,-2,88210,4078732760,198388
1251,a1305,20120627,4634,4623,4624,4662,4622,4631,4640,8,17,105928,4915962980,194960
1252,a1305,20120628,4631,4640,4639,4642,4564,4568,4600,-72,-40,95546,4395761000,184122
1253,a1305,20120629,4568,4600,4579,4595,4550,4595,4571,-5,-29,99608,4553844820,177196
1254,a1305,20120702,4595,4571,4659,4659,4588,4601,4609,30,38,100448,4630388300,167306
1255,a1305,20120703,4601,4609,4610,4643,4595,4642,4615,33,6,72202,3332284560,170522
1256,a1305,20120704,4642,4615,4615,4717,4615,4710,4682,95,67,198752,9306529260,206042
1257,a1305,20120705,4710,4682,4700,4744,4700,4729,4725,47,43,177168,8371470400,196624
1258,a1305,20120706,4729,4725,4730,4745,4536,4677,4692,-48,-33,196248,9208570780,166294
1259,a1305,20120709,4677,4692,4698,4869,4687,4853,4797,161,105,483482,23196470820,224246
1260,a1305,20120710,4853,4797,4821,4836,4768,4780,4798,-17,1,342114,16416457520,201156
1261,a1305,20120711,4780,4798,4790,4895,4739,4756,4814,-42,16,334526,16104818580,190022
1262,a1305,20120712,4756,4814,4743,4749,4690,4695,4720,-119,-94,138216,6523833740,188462
1263,a1305,20120713,4695,4720,4735,4775,4715,4775,4749,55,29,146210,6944387340,194920
1264,a1305,20120716,4775,4749,4850,4925,4846,4911,4892,162,143,207498,10152791880,210146
1265,a1305,20120717,4911,4892,4920,4925,4720,4793,4811,-99,-81,276694,13312480120,202808
1266,a1305,20120718,4793,4811,4800,4819,4760,4785,4784,-26,-27,261208,12497153900,199394
1267,a1305,20120719,4785,4784,4830,4838,4790,4824,4816,40,32,245826,11840016460,210278
1268,a1305,20120720,4824,4816,4800,4820,4760,4778,4784,-38,-32,370806,17742971480,218168
1269,a1305,20120723,4778,4784,4738,4751,4642,4653,4694,-131,-90,440128,20660734380,208950
1270,a1305,20120724,4653,4694,4507,4590,4507,4546,4554,-148,-140,302306,13768466840,198434
1271,a1305,20120725,4546,4554,4527,4596,4510,4551,4569,-3,15,341082,15587337220,170948
1272,a1305,20120726,4551,4569,4580,4594,4550,4570,4566,1,-3,207320,9467344860,180428
1273,a1305,20120727,4570,4566,4560,4608,4551,4605,4580,39,14,177836,8146067680,173024
1274,a1305,20120730,4605,4580,4656,4720,4647,4700,4690,120,110,366360,17183288320,179710
1275,a1305,20120731,4700,4690,4680,4690,4642,4679,4669,-11,-21,260252,12153762700,184744
1276,a1305,20120801,4679,4669,4677,4698,4626,4629,4673,-40,4,233190,10897579940,200998
1277,a1305,20120802,4629,4673,4627,4653,4616,4638,4634,-35,-39,213266,9884250260,206634
1278,a1305,20120803,4638,4634,4611,4690,4611,4650,4658,16,24,272856,12710707600,216094
1279,a1305,20120806,4650,4658,4601,4673,4601,4667,4649,9,-9,291718,13563895540,231214
1280,a1305,20120807,4667,4649,4670,4712,4669,4711,4688,62,39,233258,10936669320,225736
1281,a1305,20120808,4711,4688,4690,4710,4660,4663,4687,-25,-1,204952,9607019080,229456
1282,a1305,20120809,4663,4687,4688,4708,4680,4689,4691,2,4,182906,8580635300,223936
1283,a1305,20120810,4689,4691,4733,4738,4694,4709,4711,18,20,155366,7320159520,219530
1284,a1305,20120813,4709,4711,4710,4710,4679,4683,4692,-28,-19,112414,5275054500,225934
1285,a1305,20120814,4683,4692,4653,4693,4652,4689,4672,-3,-20,142206,6644286320,225680
1286,a1305,20120815,4689,4672,4687,4736,4678,4726,4707,54,35,139014,6544717880,222390
1287,a1305,20120816,4726,4707,4736,4738,4707,4708,4718,1,11,82392,3887314760,220106
1288,a1305,20120817,4708,4718,4716,4728,4703,4714,4718,-4,0,78140,3686953880,212534
1289,a1305,20120820,4714,4718,4720,4736,4719,4726,4727,8,9,66512,3144466080,208386
1290,a1305,20120821,4726,4727,4750,4807,4750,4804,4782,77,55,108946,5210595260,205218
1291,a1305,20120822,4804,4782,4850,4900,4830,4865,4861,83,79,143898,6995162120,219418
1292,a1305,20120823,4865,4861,4894,4928,4834,4860,4876,-1,15,179330,8745396740,211570
1293,a1305,20120824,4860,4876,4850,4885,4838,4884,4859,8,-17,91266,4435432000,205496
1294,a1305,20120827,4884,4859,4966,4966,4908,4927,4935,68,76,117306,5789946980,206748
1295,a1305,20120828,4927,4935,4896,4906,4854,4855,4883,-80,-52,104162,5086245840,204276
1296,a1305,20120829,4855,4883,4862,4904,4844,4903,4875,20,-8,114556,5585044220,201238
1297,a1305,20120830,4903,4875,4910,4920,4885,4916,4904,41,29,97914,4802000620,200952
1298,a1305,20120831,4916,4904,4904,4904,4868,4884,4882,-20,-22,76552,3737792980,204584
1299,a1305,20120903,4884,4882,4887,5022,4886,4997,4975,115,93,216070,10750191460,219958
1300,a1305,20120904,4997,4975,5000,5065,4985,5046,5035,71,60,355686,17912328580,265830
1301,a1305,20120905,5046,5035,5001,5040,5001,5018,5023,-17,-12,207524,10425861000,277102
1302,a1305,20120906,5018,5023,4950,4965,4895,4921,4931,-102,-92,259688,12807323700,268758
1303,a1305,20120907,4921,4931,4929,4954,4898,4899,4927,-32,-4,170690,8411414540,267408
1304,a1305,20120910,4899,4927,4885,4962,4885,4943,4932,16,5,236914,11685169820,285862
1305,a1305,20120911,4943,4932,4918,4952,4871,4886,4906,-46,-26,270350,13265287620,270708
1306,a1305,20120912,4886,4906,4885,4920,4876,4910,4899,4,-7,182528,8942342960,266426
1307,a1305,20120913,4910,4899,4958,4959,4919,4922,4941,23,42,169840,8392518740,257578
1308,a1305,20120914,4922,4941,4958,4997,4933,4954,4969,13,28,184336,9159870360,250982
1309,a1305,20120917,4954,4969,4912,4934,4863,4868,4904,-101,-65,284544,13954227180,256526
1310,a1305,20120918,4868,4904,4806,4853,4795,4809,4826,-95,-78,306950,14816457800,239634
1311,a1305,20120919,4809,4826,4837,4856,4830,4848,4842,22,16,152056,7363977740,247162
1312,a1305,20120920,4848,4842,4850,4864,4821,4840,4845,-2,3,169136,8196100900,242112
1313,a1305,20120921,4840,4845,4807,4885,4807,4880,4859,35,14,407950,19823817180,267288
1314,a1305,20120924,4880,4859,4848,4883,4801,4868,4844,9,-15,562558,27252397900,290678
1315,a1305,20120925,4868,4844,4888,4954,4865,4948,4927,104,83,471788,23249295740,314948
1316,a1305,20120926,4948,4927,4931,4973,4887,4898,4930,-29,3,493912,24354033420,297132
1317,a1305,20120927,4898,4930,4882,4908,4852,4877,4880,-53,-50,390664,19066965380,263296
1318,a1305,20120928,4877,4880,4893,4918,4847,4884,4879,4,-1,242754,11846334680,240388
1319,a1305,20121008,4884,4879,4853,4879,4738,4739,4789,-140,-90,397936,19058393480,254472
1320,a1305,20121009,4739,4789,4760,4779,4727,4765,4757,-24,-32,480194,22843668720,284756
1321,a1305,20121010,4765,4757,4732,4760,4694,4748,4723,-9,-34,420672,19868679020,304196
1322,a1305,20121011,4748,4723,4715,4795,4715,4767,4769,44,46,413068,19701548380,307030
1323,a1305,20121012,4767,4769,4785,4819,4729,4735,4773,-34,4,479582,22891520140,313060
1324,a1305,20121015,4735,4773,4700,4751,4690,4735,4724,-38,-49,377424,17833140100,313330
1325,a1305,20121016,4735,4724,4748,4768,4726,4730,4744,6,20,261884,12424554920,298680
1326,a1305,20121017,4730,4744,4710,4744,4706,4734,4725,-10,-19,267268,12630983200,280932
1327,a1305,20121018,4734,4725,4749,4788,4740,4770,4763,45,38,209336,9971629780,282998
1328,a1305,20121019,4770,4763,4790,4794,4761,4771,4770,8,7,149598,7136078700,269114
1329,a1305,20121022,4771,4770,4772,4819,4762,4813,4788,43,18,211454,10124840400,274844
1330,a1305,20121023,4813,4788,4810,4814,4765,4767,4787,-21,-1,196532,9408336400,263146
1331,a1305,20121024,4767,4787,4786,4867,4781,4859,4837,72,50,531772,25725888440,311776
1332,a1305,20121025,4859,4837,4859,4872,4834,4852,4852,15,15,349082,16937704320,305874
1333,a1305,20121026,4852,4852,4850,4881,4833,4869,4858,17,6,523310,25423211440,314926
1334,a1305,20121029,4869,4858,4851,4873,4808,4815,4832,-43,-26,437080,21123722700,300306
1335,a1305,20121030,4815,4832,4801,4812,4778,4804,4793,-28,-39,334166,16017754340,296366
1336,a1305,20121031,4804,4793,4801,4839,4789,4838,4812,45,19,312092,15020118040,295100
1337,a1305,20121101,4838,4812,4838,4962,4836,4940,4918,128,106,996072,48990224500,397592
1338,a1305,20121102,4940,4918,4921,4964,4902,4945,4934,27,16,1185640,58504923860,486930
1339,a1305,20121105,4945,4934,4894,4959,4860,4889,4906,-45,-28,1487456,72980570480,468350
1340,a1305,20121106,4889,4906,4906,4933,4898,4909,4916,3,10,868606,42704207220,483400
1341,a1305,20121107,4909,4916,4916,4919,4855,4866,4880,-50,-36,967670,47224796680,411644
1342,a1305,20121108,4866,4880,4850,4877,4840,4860,4862,-20,-18,441834,21482138660,399574
1343,a1305,20121109,4860,4862,4850,4874,4776,4780,4816,-82,-46,886392,42695450740,396614
1344,a1305,20121112,4780,4816,4720,4734,4634,4733,4698,-83,-118,2197402,1.03238E+11,550212
1345,a1305,20121113,4733,4698,4719,4761,4715,4757,4734,59,36,1170320,55414191840,576164
1346,a1305,20121114,4757,4734,4765,4784,4744,4760,4759,26,25,892732,42490272020,533442
1347,a1305,20121115,4760,4759,4759,4759,4714,4717,4739,-42,-20,817196,38727899220,531486
1348,a1305,20121116,4717,4739,4711,4754,4711,4748,4738,9,-1,713092,33786851300,518526
1349,a1305,20121119,4748,4738,4760,4777,4729,4747,4750,9,12,608070,28887099320,485336
1350,a1305,20121120,4747,4750,4750,4755,4722,4741,4737,-9,-13,567730,26896501720,480288
1351,a1305,20121121,4741,4737,4759,4772,4744,4759,4757,22,20,463778,22065272960,461658
1352,a1305,20121122,4759,4757,4760,4762,4736,4753,4746,-4,-11,406558,19295785340,435694
1353,a1305,20121123,4753,4746,4749,4787,4744,4773,4766,27,20,405486,19327309560,412388
1354,a1305,20121126,4773,4766,4780,4782,4756,4762,4766,-4,0,230432,10982410580,410718
1355,a1305,20121127,4762,4766,4768,4773,4740,4741,4757,-25,-9,315810,15025923140,411532
1356,a1305,20121128,4741,4757,4760,4770,4736,4746,4753,-11,-4,305474,14521148580,407698
1357,a1305,20121129,4746,4753,4752,4770,4733,4769,4755,16,2,367958,17499275140,390870
1358,a1305,20121130,4769,4755,4762,4773,4752,4767,4763,12,8,264316,12589992160,376878
1359,a1305,20121203,4767,4763,4773,4800,4768,4778,4784,15,21,346412,16572433280,355534
1360,a1305,20121204,4778,4784,4762,4775,4731,4753,4745,-31,-39,472250,22412642720,376484
1361,a1305,20121205,4753,4745,4763,4770,4748,4765,4759,20,14,268146,12762885600,359524
1362,a1305,20121206,4765,4759,4786,4789,4759,4765,4775,6,16,264684,12640338260,326732
1363,a1305,20121207,4765,4775,4750,4784,4742,4782,4768,7,-7,314372,14991449720,310106
1364,a1305,20121210,4782,4768,4757,4775,4752,4768,4765,0,-3,184854,8809860000,301270
1365,a1305,20121211,4768,4765,4770,4789,4761,4761,4774,-4,9,182308,8703846080,292652
1366,a1305,20121212,4761,4774,4754,4767,4743,4749,4751,-25,-23,192796,9161113400,298810
1367,a1305,20121213,4749,4751,4753,4776,4752,4763,4764,12,13,146486,6979556100,289256
1368,a1305,20121214,4763,4764,4766,4781,4760,4776,4772,12,8,159140,7595365900,273688
1369,a1305,20121217,4776,4772,4795,4852,4790,4846,4826,74,54,342392,16525302240,276990
1370,a1305,20121218,4846,4826,4837,4873,4821,4822,4845,-4,19,299004,14487481700,280234
1371,a1305,20121219,4822,4845,4802,4817,4776,4791,4795,-54,-50,240974,11555595060,267974
1372,a1305,20121220,4791,4795,4768,4768,4734,4752,4749,-43,-46,186832,8872895560,247302
1373,a1305,20121221,4752,4749,4743,4776,4743,4766,4762,17,13,167848,7993537460,249004
1374,a1305,20121224,4766,4762,4775,4782,4753,4753,4770,-9,8,94850,4525026020,253974
1375,a1305,20121225,4753,4770,4762,4770,4746,4755,4757,-15,-13,111116,5286373540,254110
1376,a1305,20121226,4755,4757,4754,4766,4750,4762,4758,5,1,78908,3754608180,247926
1377,a1305,20121227,4762,4758,4750,4772,4745,4768,4763,10,5,88348,4208373220,235972
1378,a1305,20121228,4768,4763,4766,4775,4742,4743,4755,-20,-8,100584,4783059180,240452
1379,a1305,20121231,4743,4755,4740,4758,4724,4743,4742,-12,-13,107338,5090522460,227030
1380,a1307,20120119,4360,4360,0,0,0,4360,4360,0,0,0,0,0
1381,a1307,20120120,4360,4360,0,0,0,4360,4360,0,0,0,0,0
1382,a1307,20120130,4360,4360,4470,4470,4470,4470,4470,110,110,6,268200,6
1383,a1307,20120131,4470,4470,4440,4440,4440,4440,4440,-30,-30,2,88800,6
1384,a1307,20120201,4440,4440,0,0,0,4440,4440,0,0,0,0,6
1385,a1307,20120202,4440,4440,4540,4540,4500,4518,4520,78,80,82,3706720,46
1386,a1307,20120203,4518,4520,4518,4534,4518,4525,4528,5,8,74,3351240,66
1387,a1307,20120206,4525,4528,4559,4573,4559,4571,4564,43,36,30,1369420,66
1388,a1307,20120207,4571,4564,4575,4575,4555,4562,4563,-2,-1,26,1186600,74
1389,a1307,20120208,4562,4563,4557,4560,4549,4560,4555,-3,-8,14,637740,70
1390,a1307,20120209,4560,4555,4555,4555,4552,4552,4554,-3,-1,14,637580,70
1391,a1307,20120210,4552,4554,4555,4555,4532,4536,4540,-18,-14,20,908060,64
1392,a1307,20120213,4536,4540,4565,4575,4565,4574,4572,34,32,24,1097480,56
1393,a1307,20120214,4574,4572,4580,4588,4577,4577,4581,5,9,50,2290820,78
1394,a1307,20120215,4577,4581,4576,4576,4565,4565,4569,-16,-12,16,731060,78
1395,a1307,20120216,4565,4569,4561,4561,4550,4553,4553,-16,-16,50,2276640,70
1396,a1307,20120217,4553,4553,4579,4579,4570,4570,4571,17,18,60,2742840,54
1397,a1307,20120220,4570,4571,4570,4598,4570,4580,4586,9,15,38,1742820,70
1398,a1307,20120221,4580,4586,4575,4600,4575,4600,4590,14,4,88,4039200,112
1399,a1307,20120222,4600,4590,4588,4588,4588,4588,4588,-2,-2,2,91760,112
1400,a1307,20120223,4588,4588,4575,4579,4567,4574,4574,-14,-14,76,3476720,64
1401,a1307,20120224,4574,4574,4578,4579,4577,4578,4578,4,4,44,2014500,82
1402,a1307,20120227,4578,4578,4595,4595,4594,4594,4594,16,16,4,183780,86
1403,a1307,20120228,4594,4594,4601,4610,4601,4610,4604,16,10,28,1289280,70
1404,a1307,20120229,4610,4604,0,0,0,4604,4604,0,0,0,0,70
1405,a1307,20120301,4604,4604,4608,4612,4586,4590,4595,-14,-9,54,2481400,82
1406,a1307,20120302,4590,4595,4603,4609,4603,4605,4605,10,10,16,736920,80
1407,a1307,20120305,4605,4605,4600,4620,4591,4598,4603,-7,-2,64,2946360,90
1408,a1307,20120306,4598,4603,4583,4595,4580,4580,4583,-23,-20,20,916680,98
1409,a1307,20120307,4580,4583,4589,4589,4572,4589,4575,6,-8,44,2013100,128
1410,a1307,20120308,4589,4575,4577,4577,4576,4576,4576,1,1,14,640740,138
1411,a1307,20120309,4576,4576,4608,4634,4608,4634,4624,58,48,30,1387480,152
1412,a1307,20120312,4634,4624,4618,4619,4614,4614,4617,-10,-7,22,1015860,144
1413,a1307,20120313,4614,4617,4620,4620,4620,4620,4620,3,3,2,92400,144
1414,a1307,20120314,4620,4620,4649,4655,4621,4621,4642,1,22,14,649940,140
1415,a1307,20120315,4621,4642,4622,4622,4606,4606,4614,-36,-28,4,184560,142
1416,a1307,20120316,4606,4614,4623,4623,4606,4606,4617,-8,3,6,277040,140
1417,a1307,20120319,4606,4617,0,0,0,4617,4617,0,0,0,0,140
1418,a1307,20120320,4617,4617,4585,4585,4577,4577,4581,-40,-36,42,1924160,134
1419,a1307,20120321,4577,4581,4580,4580,4580,4580,4580,-1,-1,2,91600,132
1420,a1307,20120322,4580,4580,4595,4595,4595,4595,4595,15,15,10,459500,122
1421,a1307,20120323,4595,4595,4620,4629,4617,4629,4622,34,27,10,462280,122
1422,a1307,20120326,4629,4622,4680,4680,4680,4680,4680,58,58,2,93600,124
1423,a1307,20120327,4680,4680,4665,4667,4665,4667,4666,-13,-14,4,186640,126
1424,a1307,20120328,4667,4666,4669,4670,4669,4670,4669,4,3,20,933900,124
1425,a1307,20120329,4670,4669,4670,4670,4644,4664,4655,-5,-14,8,372440,122
1426,a1307,20120330,4664,4655,0,0,0,4655,4655,0,0,0,0,122
1427,a1307,20120405,4655,4655,4718,4718,4697,4697,4707,42,52,4,188300,120
1428,a1307,20120406,4697,4707,4775,4775,4770,4770,4772,63,65,4,190900,120
1429,a1307,20120409,4770,4772,0,0,0,4772,4772,0,0,0,0,120
1430,a1307,20120410,4772,4772,4840,4864,4831,4849,4849,77,77,44,2133560,122
1431,a1307,20120411,4849,4849,4806,4837,4800,4800,4816,-49,-33,22,1059540,120
1432,a1307,20120412,4800,4816,4804,4804,4790,4796,4800,-20,-16,12,576000,120
1433,a1307,20120413,4796,4800,0,0,0,4800,4800,0,0,0,0,120
1434,a1307,20120416,4800,4800,4789,4789,4755,4789,4778,-11,-22,14,668960,122
1435,a1307,20120417,4789,4778,0,0,0,4778,4778,0,0,0,0,122
1436,a1307,20120418,4778,4778,4785,4785,4746,4748,4759,-30,-19,6,285580,124
1437,a1307,20120419,4748,4759,0,0,0,4759,4759,0,0,0,0,124
1438,a1307,20120420,4759,4759,0,0,0,4759,4759,0,0,0,0,124
1439,a1307,20120423,4759,4759,4783,4795,4783,4784,4788,25,29,18,861880,122
1440,a1307,20120424,4784,4788,4787,4787,4787,4787,4787,-1,-1,2,95740,122
1441,a1307,20120425,4787,4787,0,0,0,4787,4787,0,0,0,0,122
1442,a1307,20120426,4787,4787,4771,4771,4771,4771,4771,-16,-16,2,95420,122
1443,a1307,20120427,4771,4771,4777,4777,4776,4776,4776,5,5,12,573220,120
1444,a1307,20120502,4776,4776,0,0,0,4776,4776,0,0,0,0,120
1445,a1307,20120503,4776,4776,4720,4747,4720,4742,4737,-34,-39,12,568440,122
1446,a1307,20120504,4742,4737,4720,4729,4717,4729,4719,-8,-18,16,755160,120
1447,a1307,20120507,4729,4719,4700,4702,4670,4702,4690,-17,-29,6,281440,122
1448,a1307,20120508,4702,4690,4681,4681,4681,4681,4681,-9,-9,2,93620,120
1449,a1307,20120509,4681,4681,4670,4670,4594,4612,4629,-69,-52,20,925820,118
1450,a1307,20120510,4612,4629,0,0,0,4629,4629,0,0,0,0,118
1451,a1307,20120511,4629,4629,4603,4603,4603,4603,4603,-26,-26,2,92060,118
1452,a1307,20120514,4603,4603,4518,4523,4518,4523,4520,-80,-83,4,180820,118
1453,a1307,20120515,4523,4520,4503,4503,4500,4500,4501,-20,-19,4,180060,118
1454,a1307,20120516,4500,4501,4491,4491,4383,4441,4428,-60,-73,10,442800,118
1455,a1307,20120517,4441,4428,4429,4445,4429,4445,4437,17,9,4,177480,120
1456,a1307,20120518,4445,4437,4401,4401,4401,4401,4401,-36,-36,2,88020,120
1457,a1307,20120521,4401,4401,4428,4428,4428,4428,4428,27,27,4,177120,120
1458,a1307,20120522,4428,4428,4435,4435,4434,4434,4434,6,6,4,177380,120
1459,a1307,20120523,4434,4434,4380,4380,4380,4380,4380,-54,-54,4,175200,118
1460,a1307,20120524,4380,4380,4398,4398,4398,4398,4398,18,18,12,527760,108
1461,a1307,20120525,4398,4398,0,0,0,4398,4398,0,0,0,0,108
1462,a1307,20120528,4398,4398,4417,4425,4417,4425,4421,27,23,20,884200,88
1463,a1307,20120529,4425,4421,0,0,0,4421,4421,0,0,0,0,88
1464,a1307,20120530,4421,4421,4439,4439,4439,4439,4439,18,18,2,88780,90
1465,a1307,20120531,4439,4439,0,0,0,4439,4439,0,0,0,0,90
1466,a1307,20120601,4439,4439,0,0,0,4439,4439,0,0,0,0,90
1467,a1307,20120604,4439,4439,0,0,0,4439,4439,0,0,0,0,90
1468,a1307,20120605,4439,4439,0,0,0,4439,4439,0,0,0,0,90
1469,a1307,20120606,4439,4439,0,0,0,4439,4439,0,0,0,0,90
1470,a1307,20120607,4439,4439,4470,4471,4444,4451,4462,12,23,20,892420,82
1471,a1307,20120608,4451,4462,4477,4477,4477,4477,4477,15,15,2,89540,84
1472,a1307,20120611,4477,4477,0,0,0,4477,4477,0,0,0,0,84
1473,a1307,20120612,4477,4477,4548,4548,4548,4548,4548,71,71,2,90960,82
1474,a1307,20120613,4548,4548,4499,4499,4499,4499,4499,-49,-49,2,89980,82
1475,a1307,20120614,4499,4499,4459,4477,4459,4477,4470,-22,-29,14,625840,82
1476,a1307,20120615,4477,4470,4466,4466,4466,4466,4466,-4,-4,2,89320,82
1477,a1307,20120618,4466,4466,0,0,0,4466,4466,0,0,0,0,82
1478,a1307,20120619,4466,4466,4560,4561,4560,4561,4560,95,94,6,273620,86
1479,a1307,20120620,4561,4560,4578,4578,4578,4578,4578,18,18,2,91560,84
1480,a1307,20120621,4578,4578,0,0,0,4578,4578,0,0,0,0,84
1481,a1307,20120625,4578,4578,0,0,0,4578,4578,0,0,0,0,84
1482,a1307,20120626,4578,4578,4646,4646,4646,4646,4646,68,68,2,92920,86
1483,a1307,20120627,4646,4646,0,0,0,4646,4646,0,0,0,0,86
1484,a1307,20120628,4646,4646,0,0,0,4646,4646,0,0,0,0,86
1485,a1307,20120629,4646,4646,0,0,0,4646,4646,0,0,0,0,86
1486,a1307,20120702,4646,4646,0,0,0,4646,4646,0,0,0,0,86
1487,a1307,20120703,4646,4646,0,0,0,4646,4646,0,0,0,0,86
1488,a1307,20120704,4646,4646,0,0,0,4646,4646,0,0,0,0,86
1489,a1307,20120705,4646,4646,4752,4752,4714,4744,4736,98,90,6,284200,86
1490,a1307,20120706,4744,4736,0,0,0,4736,4736,0,0,0,0,86
1491,a1307,20120709,4736,4736,4780,4888,4775,4888,4817,152,81,8,385360,86
1492,a1307,20120710,4888,4817,4811,4811,4811,4811,4811,-6,-6,2,96220,84
1493,a1307,20120711,4811,4811,4847,4847,4847,4847,4847,36,36,4,193880,84
1494,a1307,20120712,4847,4847,0,0,0,4847,4847,0,0,0,0,84
1495,a1307,20120713,4847,4847,0,0,0,4847,4847,0,0,0,0,84
1496,a1307,20120716,4847,4847,4971,4971,4863,4897,4889,50,42,24,1173440,82
1497,a1307,20120717,4897,4889,0,0,0,4889,4889,0,0,0,0,82
1498,a1307,20120718,4889,4889,4752,4793,4752,4790,4778,-99,-111,20,955640,82
1499,a1307,20120719,4790,4778,4791,4801,4791,4800,4796,22,18,12,575600,80
1500,a1307,20120720,4800,4796,4786,4788,4762,4788,4778,-8,-18,6,286720,78
1501,a1307,20120723,4788,4778,0,0,0,4778,4778,0,0,0,0,78
1502,a1307,20120724,4778,4778,4588,4588,4587,4587,4587,-191,-191,20,917420,88
1503,a1307,20120725,4587,4587,4485,4586,4485,4586,4545,-1,-42,16,727300,78
1504,a1307,20120726,4586,4545,0,0,0,4545,4545,0,0,0,0,78
1505,a1307,20120727,4545,4545,4560,4570,4560,4563,4564,18,19,6,273860,78
1506,a1307,20120730,4563,4564,4701,4701,4701,4701,4701,137,137,2,94020,78
1507,a1307,20120731,4701,4701,4645,4645,4645,4645,4645,-56,-56,2,92900,78
1508,a1307,20120801,4645,4645,4645,4654,4595,4619,4628,-26,-17,182,8423360,80
1509,a1307,20120802,4619,4628,4626,4626,4626,4626,4626,-2,-2,2,92520,78
1510,a1307,20120803,4626,4626,4677,4677,4677,4677,4677,51,51,2,93540,80
1511,a1307,20120806,4677,4677,0,0,0,4677,4677,0,0,0,0,80
1512,a1307,20120807,4677,4677,4679,4679,4645,4672,4666,-5,-11,10,466600,84
1513,a1307,20120808,4672,4666,0,0,0,4666,4666,0,0,0,0,84
1514,a1307,20120809,4666,4666,4713,4713,4661,4678,4684,12,18,6,281040,84
1515,a1307,20120810,4678,4684,4687,4692,4687,4692,4690,8,6,6,281420,84
1516,a1307,20120813,4692,4690,4680,4686,4677,4686,4679,-4,-11,12,561520,88
1517,a1307,20120814,4686,4679,0,0,0,4679,4679,0,0,0,0,88
1518,a1307,20120815,4679,4679,0,0,0,4679,4679,0,0,0,0,88
1519,a1307,20120816,4679,4679,0,0,0,4679,4679,0,0,0,0,88
1520,a1307,20120817,4679,4679,0,0,0,4679,4679,0,0,0,0,88
1521,a1307,20120820,4679,4679,4733,4743,4716,4743,4728,64,49,10,472820,90
1522,a1307,20120821,4743,4728,4782,4782,4782,4782,4782,54,54,2,95640,90
1523,a1307,20120822,4782,4782,0,0,0,4782,4782,0,0,0,0,90
1524,a1307,20120823,4782,4782,0,0,0,4782,4782,0,0,0,0,90
1525,a1307,20120824,4782,4782,0,0,0,4782,4782,0,0,0,0,90
1526,a1307,20120827,4782,4782,0,0,0,4782,4782,0,0,0,0,90
1527,a1307,20120828,4782,4782,4880,4880,4855,4855,4870,73,88,12,584480,90
1528,a1307,20120829,4855,4870,4879,4879,4870,4870,4874,0,4,4,194980,86
1529,a1307,20120830,4870,4874,4904,4918,4884,4918,4905,44,31,34,1667980,94
1530,a1307,20120831,4918,4905,0,0,0,4905,4905,0,0,0,0,94
1531,a1307,20120903,4905,4905,4963,4989,4963,4989,4969,84,64,8,397560,92
1532,a1307,20120904,4989,4969,5025,5037,5025,5037,5029,68,60,6,301780,94
1533,a1307,20120905,5037,5029,5025,5025,5025,5025,5025,-4,-4,2,100500,96
1534,a1307,20120906,5025,5025,0,0,0,5025,5025,0,0,0,0,96
1535,a1307,20120907,5025,5025,4919,4947,4900,4900,4924,-125,-101,16,787880,92
1536,a1307,20120910,4900,4924,4802,4926,4802,4926,4886,2,-38,14,684080,98
1537,a1307,20120911,4926,4886,4883,4883,4879,4879,4880,-7,-6,6,292840,92
1538,a1307,20120912,4879,4880,0,0,0,4880,4880,0,0,0,0,92
1539,a1307,20120913,4880,4880,4926,4975,4910,4946,4936,66,56,56,2764300,94
1540,a1307,20120914,4946,4936,0,0,0,4936,4936,0,0,0,0,94
1541,a1307,20120917,4936,4936,4917,4917,4890,4890,4903,-46,-33,8,392280,90
1542,a1307,20120918,4890,4903,4855,4855,4854,4854,4854,-49,-49,4,194180,86
1543,a1307,20120919,4854,4854,4827,4827,4827,4827,4827,-27,-27,2,96540,86
1544,a1307,20120920,4827,4827,0,0,0,4827,4827,0,0,0,0,86
1545,a1307,20120921,4827,4827,4822,4822,4822,4822,4822,-5,-5,2,96440,88
1546,a1307,20120924,4822,4822,0,0,0,4822,4822,0,0,0,0,88
1547,a1307,20120925,4822,4822,0,0,0,4822,4822,0,0,0,0,88
1548,a1307,20120926,4822,4822,4822,4822,4631,4822,4746,0,-76,22,1044240,108
1549,a1307,20120927,4822,4746,4869,4869,4802,4802,4826,56,80,58,2799500,122
1550,a1307,20120928,4802,4826,4844,4846,4801,4801,4840,-25,14,32,1548820,106
1551,a1307,20121008,4801,4840,4801,4803,4750,4750,4793,-90,-47,26,1246320,82
1552,a1307,20121009,4750,4793,4752,4779,4720,4765,4753,-28,-40,42,1996600,98
1553,a1307,20121010,4765,4753,4739,4774,4686,4748,4729,-5,-24,100,4729460,106
1554,a1307,20121011,4748,4729,4791,4797,4767,4789,4782,60,53,34,1626180,106
1555,a1307,20121012,4789,4782,4802,4802,4756,4762,4773,-20,-9,32,1527660,106
1556,a1307,20121015,4762,4773,4723,4759,4723,4750,4749,-23,-24,30,1424820,100
1557,a1307,20121016,4750,4749,4756,4760,4754,4754,4755,5,6,12,570680,94
1558,a1307,20121017,4754,4755,4749,4749,4749,4749,4749,-6,-6,6,284940,88
1559,a1307,20121018,4749,4749,4767,4778,4767,4778,4772,29,23,4,190900,90
1560,a1307,20121019,4778,4772,4800,4800,4788,4788,4794,16,22,4,191760,90
1561,a1307,20121022,4788,4794,4750,4777,4750,4777,4768,-17,-26,6,286080,92
1562,a1307,20121023,4777,4768,4758,4758,4758,4758,4758,-10,-10,2,95160,92
1563,a1307,20121024,4758,4758,0,0,0,4758,4758,0,0,0,0,92
1564,a1307,20121025,4758,4758,4842,4857,4836,4841,4844,83,86,30,1453400,90
1565,a1307,20121026,4841,4844,4845,4865,4825,4839,4858,-5,14,178,8648360,168
1566,a1307,20121029,4839,4858,4844,4844,4815,4815,4825,-43,-33,16,772120,168
1567,a1307,20121030,4815,4825,4768,4813,4768,4804,4794,-21,-31,24,1150740,170
1568,a1307,20121031,4804,4794,4788,4833,4787,4833,4809,39,15,28,1346580,186
1569,a1307,20121101,4833,4809,4850,4935,4850,4930,4909,121,100,182,8935700,192
1570,a1307,20121102,4930,4909,4921,4958,4893,4958,4916,49,7,126,6195220,204
1571,a1307,20121105,4958,4916,4887,4938,4884,4896,4906,-20,-10,34,1668240,200
1572,a1307,20121106,4896,4906,4914,4928,4882,4919,4915,13,9,28,1376400,200
1573,a1307,20121107,4919,4915,4898,4918,4854,4876,4884,-39,-31,136,6643460,170
1574,a1307,20121108,4876,4884,4858,4875,4843,4843,4862,-41,-22,74,3598420,160
1575,a1307,20121109,4843,4862,4847,4853,4788,4788,4840,-74,-22,38,1839380,144
1576,a1307,20121112,4788,4840,4705,4723,4650,4699,4698,-141,-142,56,2630920,158
1577,a1307,20121113,4699,4698,4711,4751,4711,4746,4727,48,29,88,4160060,112
1578,a1307,20121114,4746,4727,4761,4776,4759,4773,4764,46,37,12,571780,110
1579,a1307,20121115,4773,4764,4744,4756,4730,4730,4745,-34,-19,70,3322020,74
1580,a1307,20121116,4730,4745,4720,4764,4720,4762,4746,17,1,10,474600,74
1581,a1307,20121119,4762,4746,4793,4815,4739,4754,4775,8,29,40,1910080,74
1582,a1307,20121120,4754,4775,4746,4746,4741,4741,4742,-34,-33,10,474200,76
1583,a1307,20121121,4741,4742,0,0,0,4742,4742,0,0,0,0,76
1584,a1307,20121122,4742,4742,4742,4756,4740,4756,4743,14,1,26,1233360,90
1585,a1307,20121123,4756,4743,4763,4764,4763,4764,4763,21,20,6,285800,90
1586,a1307,20121126,4764,4763,4763,4764,4763,4764,4763,1,0,6,285820,90
1587,a1307,20121127,4764,4763,4776,4776,4750,4750,4763,-13,0,12,571560,78
1588,a1307,20121128,4750,4763,4764,4764,4764,4764,4764,1,1,10,476400,78
1589,a1307,20121129,4764,4764,4739,4777,4736,4745,4755,-19,-9,28,1331480,82
1590,a1307,20121130,4745,4755,4786,4786,4760,4761,4766,6,11,8,381340,80
1591,a1307,20121203,4761,4766,4791,4791,4757,4780,4775,14,9,20,955160,78
1592,a1307,20121204,4780,4775,4748,4754,4740,4754,4746,-21,-29,12,569540,74
1593,a1307,20121205,4754,4746,0,0,0,4746,4746,0,0,0,0,74
1594,a1307,20121206,4746,4746,4774,4774,4753,4753,4755,7,9,16,760900,86
1595,a1307,20121207,4753,4755,4797,4812,4765,4775,4791,20,36,42,2012600,76
1596,a1307,20121210,4775,4791,4789,4811,4754,4811,4773,20,-18,12,572860,76
1597,a1307,20121211,4811,4773,4783,4783,4764,4764,4767,-9,-6,12,572060,82
1598,a1307,20121212,4764,4767,4756,4776,4746,4751,4766,-16,-1,18,858000,68
1599,a1307,20121213,4751,4766,4751,4786,4751,4786,4768,20,2,8,381460,66
1600,a1307,20121214,4786,4768,0,0,0,4768,4768,0,0,0,0,66
1601,a1307,20121217,4768,4768,4825,4862,4822,4844,4843,76,75,30,1453040,68
1602,a1307,20121218,4844,4843,4836,4848,4836,4840,4842,-3,-1,10,484280,60
1603,a1307,20121219,4840,4842,4825,4825,4800,4800,4810,-42,-32,22,1058280,68
1604,a1307,20121220,4800,4810,4762,4762,4762,4762,4762,-48,-48,4,190480,68
1605,a1307,20121221,4762,4762,0,0,0,4762,4762,0,0,0,0,68
1606,a1307,20121224,4762,4762,0,0,0,4762,4762,0,0,0,0,68
1607,a1307,20121225,4762,4762,0,0,0,4762,4762,0,0,0,0,68
1608,a1307,20121226,4762,4762,4772,4772,4770,4770,4771,8,9,8,381680,68
1609,a1307,20121227,4770,4771,0,0,0,4771,4771,0,0,0,0,68
1610,a1307,20121228,4771,4771,4782,4782,4760,4760,4769,-11,-2,18,858560,58
1611,a1307,20121231,4760,4769,4755,4775,4755,4762,4764,-7,-5,6,285840,58
1612,a1309,20120316,4669,4663,4669,4669,4629,4660,4652,-3,-11,14,651280,26
1613,a1309,20120319,4660,4652,4669,4669,4652,4653,4659,1,7,40,1863780,42
1614,a1309,20120320,4653,4659,4650,4650,4615,4615,4626,-44,-33,200,9253140,102
1615,a1309,20120321,4615,4626,4600,4622,4600,4622,4616,-4,-10,86,3969980,114
1616,a1309,20120322,4622,4616,4642,4648,4630,4635,4639,19,23,98,4546740,126
1617,a1309,20120323,4635,4639,4653,4678,4642,4678,4662,39,23,242,11283400,266
1618,a1309,20120326,4678,4662,4687,4757,4677,4697,4692,35,30,284,13327020,238
1619,a1309,20120327,4697,4692,4697,4714,4690,4698,4697,6,5,76,3570060,214
1620,a1309,20120328,4698,4697,4685,4700,4685,4690,4691,-7,-6,122,5723740,198
1621,a1309,20120329,4690,4691,4687,4700,4675,4675,4684,-16,-7,68,3185400,188
1622,a1309,20120330,4675,4684,4660,4660,4646,4653,4651,-31,-33,154,7163280,218
1623,a1309,20120405,4653,4651,4700,4755,4700,4750,4729,99,78,318,15041000,224
1624,a1309,20120406,4750,4729,4750,4861,4750,4846,4830,117,101,810,39126160,666
1625,a1309,20120409,4846,4830,4860,4869,4850,4862,4861,32,31,854,41519600,956
1626,a1309,20120410,4862,4861,4859,4905,4853,4902,4891,41,30,3862,188911420,3878
1627,a1309,20120411,4902,4891,4880,4880,4832,4832,4850,-59,-41,2832,137368980,4992
1628,a1309,20120412,4832,4850,4832,4854,4827,4850,4844,0,-6,1914,92717940,6582
1629,a1309,20120413,4850,4844,4886,4894,4840,4840,4871,-4,27,2474,120525760,8204
1630,a1309,20120416,4840,4871,4826,4826,4800,4821,4812,-50,-59,2070,99623940,9370
1631,a1309,20120417,4821,4812,4834,4842,4812,4822,4825,10,13,1260,60804860,9954
1632,a1309,20120418,4822,4825,4826,4840,4777,4786,4798,-39,-27,2186,104891480,10294
1633,a1309,20120419,4786,4798,4750,4803,4750,4799,4786,1,-12,1216,58201900,10614
1634,a1309,20120420,4799,4786,4809,4809,4776,4789,4787,3,1,1592,76215640,11176
1635,a1309,20120423,4789,4787,4828,4841,4815,4815,4828,28,41,1700,82080540,11770
1636,a1309,20120424,4815,4828,4801,4812,4784,4790,4794,-38,-34,1434,68757580,11766
1637,a1309,20120425,4790,4794,4811,4844,4807,4807,4819,13,25,1936,93301080,12070
1638,a1309,20120426,4807,4819,4815,4815,4790,4790,4796,-29,-23,1434,68776140,12288
1639,a1309,20120427,4790,4796,4796,4818,4795,4807,4807,11,11,2806,134895860,12462
1640,a1309,20120502,4807,4807,4820,4822,4789,4789,4796,-18,-11,2144,102845060,13528
1641,a1309,20120503,4789,4796,4788,4791,4756,4758,4771,-38,-25,2322,110796780,14030
1642,a1309,20120504,4758,4771,4756,4785,4739,4782,4761,11,-10,3080,146667920,15470
1643,a1309,20120507,4782,4761,4773,4778,4714,4719,4730,-42,-31,2008,94989560,15812
1644,a1309,20120508,4719,4730,4720,4735,4712,4716,4724,-14,-6,1186,56036380,15912
1645,a1309,20120509,4716,4724,4695,4700,4649,4653,4663,-71,-61,2734,127498700,16796
1646,a1309,20120510,4653,4663,4663,4681,4635,4678,4656,15,-7,4568,212714620,18976
1647,a1309,20120511,4678,4656,4685,4689,4610,4615,4636,-41,-20,2040,94575620,18750
1648,a1309,20120514,4615,4636,4595,4595,4516,4541,4560,-95,-76,3660,166920520,18466
1649,a1309,20120515,4541,4560,4521,4545,4506,4534,4523,-26,-37,2630,118967680,19102
1650,a1309,20120516,4534,4523,4535,4541,4413,4432,4474,-91,-49,4206,188181000,19552
1651,a1309,20120517,4432,4474,4464,4480,4442,4462,4463,-12,-11,1860,83014580,19782
1652,a1309,20120518,4462,4463,4451,4460,4420,4438,4443,-25,-20,1916,85135520,19774
1653,a1309,20120521,4438,4443,4439,4495,4439,4482,4475,39,32,3170,141884340,20194
1654,a1309,20120522,4482,4475,4471,4480,4461,4468,4470,-7,-5,958,42826080,20456
1655,a1309,20120523,4468,4470,4431,4431,4392,4400,4405,-70,-65,1788,78765920,20206
1656,a1309,20120524,4400,4405,4408,4438,4408,4437,4429,32,24,1158,51298240,20182
1657,a1309,20120525,4437,4429,4439,4440,4420,4439,4432,10,3,1220,54077680,20430
1658,a1309,20120528,4439,4432,4439,4471,4437,4467,4456,35,24,1180,52584400,20180
1659,a1309,20120529,4467,4456,4463,4490,4450,4482,4475,26,19,926,41446300,20270
1660,a1309,20120530,4482,4475,4468,4490,4466,4467,4478,-8,3,674,30187600,20284
1661,a1309,20120531,4467,4478,4453,4475,4448,4458,4465,-20,-13,724,32331740,20228
1662,a1309,20120601,4458,4465,4441,4443,4422,4432,4433,-33,-32,938,41590800,20522
1663,a1309,20120604,4432,4433,4424,4441,4390,4410,4410,-23,-23,2766,121991280,21294
1664,a1309,20120605,4410,4410,4421,4477,4420,4460,4450,50,40,1660,73872080,21218
1665,a1309,20120606,4460,4450,4461,4505,4460,4474,4485,24,35,1694,75982520,21748
1666,a1309,20120607,4474,4485,4509,4510,4480,4497,4494,12,9,3382,151999380,23622
1667,a1309,20120608,4497,4494,4521,4521,4467,4486,4496,-8,2,5040,226619620,25712
1668,a1309,20120611,4486,4496,4502,4560,4502,4560,4537,64,41,4828,219086680,26858
1669,a1309,20120612,4560,4537,4537,4578,4528,4574,4556,37,19,3024,137778600,27782
1670,a1309,20120613,4574,4556,4563,4573,4549,4554,4558,-2,2,1494,68107680,28674
1671,a1309,20120614,4554,4558,4530,4548,4493,4493,4517,-65,-41,2418,109230120,29670
1672,a1309,20120615,4493,4517,4495,4524,4493,4519,4514,2,-3,1302,58773100,30056
1673,a1309,20120618,4519,4514,4526,4548,4522,4532,4533,18,19,940,42611980,30078
1674,a1309,20120619,4532,4533,4553,4620,4553,4614,4602,81,69,3018,138895460,29832
1675,a1309,20120620,4614,4602,4632,4661,4629,4646,4641,44,39,1996,92645240,30298
1676,a1309,20120621,4646,4641,4620,4636,4589,4619,4618,-22,-23,1550,71586360,30268
1677,a1309,20120625,4619,4618,4650,4720,4650,4680,4692,62,74,5822,273204500,30474
1678,a1309,20120626,4680,4692,4700,4705,4676,4701,4693,9,1,5596,262645740,28798
1679,a1309,20120627,4701,4693,4692,4727,4692,4711,4713,18,20,5204,245307200,30982
1680,a1309,20120628,4711,4713,4718,4718,4649,4649,4680,-64,-33,3156,147711820,32246
1681,a1309,20120629,4649,4680,4670,4672,4634,4666,4657,-14,-23,4620,215154220,32454
1682,a1309,20120702,4666,4657,4700,4730,4660,4672,4680,15,23,3492,163437820,32248
1683,a1309,20120703,4672,4680,4681,4710,4668,4710,4690,30,10,3016,141461160,31468
1684,a1309,20120704,4710,4690,4722,4771,4721,4763,4745,73,55,8156,387057160,33194
1685,a1309,20120705,4763,4745,4762,4795,4756,4785,4781,40,36,9924,474554200,31278
1686,a1309,20120706,4785,4781,4820,4820,4610,4739,4750,-42,-31,5826,276745200,31512
1687,a1309,20120709,4739,4750,4750,4898,4750,4863,4824,113,74,22838,1101911760,31992
1688,a1309,20120710,4863,4824,4851,4852,4782,4796,4813,-28,-11,10002,481447960,31354
1689,a1309,20120711,4796,4813,4797,4890,4754,4775,4815,-38,2,13348,642736280,29486
1690,a1309,20120712,4775,4815,4760,4765,4723,4725,4745,-90,-70,5368,254735880,28660
1691,a1309,20120713,4725,4745,4745,4799,4741,4794,4775,49,30,6594,314911080,30500
1692,a1309,20120716,4794,4775,4832,4912,4832,4900,4883,125,108,15040,734548380,32762
1693,a1309,20120717,4900,4883,4918,4918,4724,4801,4805,-82,-78,12060,579599940,29858
1694,a1309,20120718,4801,4805,4820,4832,4780,4800,4806,-5,1,6078,292144140,29934
1695,a1309,20120719,4800,4806,4829,4850,4791,4841,4836,35,30,7494,362435520,32880
1696,a1309,20120720,4841,4836,4840,4840,4774,4777,4788,-59,-48,19554,936309060,32254
1697,a1309,20120723,4777,4788,4755,4755,4637,4650,4693,-138,-95,17352,814431400,33486
1698,a1309,20120724,4650,4693,4520,4590,4506,4545,4557,-148,-136,8262,376534360,32682
1699,a1309,20120725,4545,4557,4509,4601,4501,4567,4575,10,18,8246,377318860,32160
1700,a1309,20120726,4567,4575,4600,4600,4570,4582,4581,7,6,6942,318051860,33398
1701,a1309,20120727,4582,4581,4560,4609,4555,4608,4586,27,5,9410,431620960,37504
1702,a1309,20120730,4608,4586,4663,4715,4645,4685,4679,99,93,9274,434005040,38982
1703,a1309,20120731,4685,4679,4660,4676,4630,4665,4653,-14,-26,8314,386931280,40456
1704,a1309,20120801,4665,4653,4668,4688,4632,4632,4660,-21,7,15096,703475740,48206
1705,a1309,20120802,4632,4660,4617,4645,4579,4611,4604,-49,-56,36700,1690000300,63480
1706,a1309,20120803,4611,4604,4572,4667,4572,4628,4637,24,33,24968,1157772000,69058
1707,a1309,20120806,4628,4637,4600,4660,4599,4655,4636,18,-1,23620,1095206020,75238
1708,a1309,20120807,4655,4636,4669,4703,4663,4700,4680,64,44,11518,539059100,75958
1709,a1309,20120808,4700,4680,4700,4706,4660,4661,4681,-19,1,7896,369690300,78138
1710,a1309,20120809,4661,4681,4681,4702,4675,4688,4689,7,8,9230,432886160,79456
1711,a1309,20120810,4688,4689,4739,4739,4689,4702,4701,13,12,13816,649514920,80440
1712,a1309,20120813,4702,4701,4710,4710,4680,4682,4688,-19,-13,7144,334912740,82296
1713,a1309,20120814,4682,4688,4661,4686,4659,4684,4673,-4,-15,15740,735661220,85854
1714,a1309,20120815,4684,4673,4680,4729,4676,4723,4704,50,31,11230,528350660,88168
1715,a1309,20120816,4723,4704,4731,4731,4705,4708,4717,4,13,11734,553511540,85572
1716,a1309,20120817,4708,4717,4725,4725,4704,4715,4716,-2,-1,6398,301792860,87454
1717,a1309,20120820,4715,4716,4720,4732,4720,4727,4727,11,11,5360,253391240,87286
1718,a1309,20120821,4727,4727,4748,4815,4748,4806,4788,79,61,23958,1147269460,80016
1719,a1309,20120822,4806,4788,4850,4912,4835,4877,4880,89,92,18790,917083760,83242
1720,a1309,20120823,4877,4880,4900,4940,4855,4885,4892,5,12,15630,764653600,83224
1721,a1309,20120824,4885,4892,4870,4945,4865,4915,4895,23,3,13598,665656800,81876
1722,a1309,20120827,4915,4895,4948,4990,4942,4959,4969,64,74,18770,932767000,78482
1723,a1309,20120828,4959,4969,4942,4950,4902,4902,4928,-67,-41,14712,725127160,76374
1724,a1309,20120829,4902,4928,4910,4943,4892,4942,4920,14,-8,15778,776353380,75958
1725,a1309,20120830,4942,4920,4958,4961,4931,4956,4947,36,27,10910,539797740,77522
1726,a1309,20120831,4956,4947,4945,4948,4923,4935,4931,-12,-16,9888,487630900,75990
1727,a1309,20120903,4935,4931,4939,5055,4937,5027,5011,96,80,20698,1037334520,72916
1728,a1309,20120904,5027,5011,5032,5086,5020,5079,5063,68,52,16442,832517420,74974
1729,a1309,20120905,5079,5063,5061,5077,5040,5058,5062,-5,-1,13960,706689280,75164
1730,a1309,20120906,5058,5062,5020,5020,4943,4977,4980,-85,-82,22874,1139251100,73390
1731,a1309,20120907,4977,4980,4990,5005,4930,4932,4963,-48,-17,23652,1173848880,77030
1732,a1309,20120910,4932,4963,4931,4993,4911,4976,4958,13,-5,14584,723086380,79686
1733,a1309,20120911,4976,4958,4966,4980,4908,4921,4941,-37,-17,16944,837288220,77628
1734,a1309,20120912,4921,4941,4921,4956,4912,4947,4936,6,-5,11976,591145320,77636
1735,a1309,20120913,4947,4936,4996,4996,4964,4966,4976,30,40,10526,523827200,78104
1736,a1309,20120914,4966,4976,4988,5030,4977,4993,5005,17,29,17898,895795600,76592
1737,a1309,20120917,4993,5005,4960,4965,4898,4899,4937,-106,-68,23502,1160469000,79690
1738,a1309,20120918,4899,4937,4808,4872,4808,4837,4848,-100,-89,33430,1620792560,78992
1739,a1309,20120919,4837,4848,4859,4881,4852,4872,4866,24,18,15166,738076020,80692
1740,a1309,20120920,4872,4866,4880,4886,4848,4876,4872,10,6,19786,964134360,85884
1741,a1309,20120921,4876,4872,4850,4909,4840,4896,4882,24,10,35182,1717832520,91944
1742,a1309,20120924,4896,4882,4856,4890,4832,4880,4861,-2,-21,31110,1512440100,92218
1743,a1309,20120925,4880,4861,4883,4956,4883,4939,4930,78,69,28490,1404696940,96316
1744,a1309,20120926,4939,4930,4930,4949,4884,4890,4919,-40,-11,18410,905749900,95016
1745,a1309,20120927,4890,4919,4871,4897,4860,4872,4879,-47,-40,21324,1040456840,93386
1746,a1309,20120928,4872,4879,4880,4903,4848,4883,4875,4,-4,12944,631128280,93358
1747,a1309,20121008,4883,4875,4858,4860,4761,4764,4794,-111,-81,38198,1831219920,89786
1748,a1309,20121009,4764,4794,4785,4792,4753,4777,4776,-17,-18,27172,1297856580,90668
1749,a1309,20121010,4777,4776,4739,4773,4716,4761,4742,-15,-34,23840,1130683480,94026
1750,a1309,20121011,4761,4742,4731,4810,4730,4783,4784,41,42,14286,683535740,94648
1751,a1309,20121012,4783,4784,4802,4818,4761,4770,4787,-14,3,31888,1526624600,96688
1752,a1309,20121015,4770,4787,4730,4777,4725,4768,4759,-19,-28,27204,1294690740,100520
1753,a1309,20121016,4768,4759,4770,4798,4765,4766,4779,7,20,19612,937351160,98488
1754,a1309,20121017,4766,4779,4750,4776,4748,4768,4760,-11,-19,16594,790004540,95226
1755,a1309,20121018,4768,4760,4775,4799,4769,4793,4782,33,22,19300,923039780,93300
1756,a1309,20121019,4793,4782,4801,4808,4786,4793,4793,11,11,9526,456645320,93818
1757,a1309,20121022,4793,4793,4790,4828,4783,4825,4805,32,12,19440,934148300,94866
1758,a1309,20121023,4825,4805,4821,4828,4780,4781,4800,-24,-5,17514,840782900,94594
1759,a1309,20121024,4781,4800,4797,4859,4792,4854,4837,54,37,37162,1797757900,101714
1760,a1309,20121025,4854,4837,4845,4871,4837,4854,4853,17,16,25794,1251859380,102794
1761,a1309,20121026,4854,4853,4840,4885,4840,4880,4870,27,17,47730,2324451940,110024
1762,a1309,20121029,4880,4870,4868,4890,4830,4835,4849,-35,-21,43428,2106180460,105778
1763,a1309,20121030,4835,4849,4828,4835,4804,4824,4815,-25,-34,29638,1427362880,106214
1764,a1309,20121031,4824,4815,4832,4860,4820,4860,4839,45,24,28612,1384706620,112390
1765,a1309,20121101,4860,4839,4866,4964,4859,4943,4926,104,87,70330,3464528260,122152
1766,a1309,20121102,4943,4926,4934,4968,4916,4952,4940,26,14,71758,3544999940,137464
1767,a1309,20121105,4952,4940,4900,4968,4881,4909,4923,-31,-17,87292,4297530720,136874
1768,a1309,20121106,4909,4923,4927,4950,4920,4933,4935,10,12,41550,2050655640,139814
1769,a1309,20121107,4933,4935,4950,4950,4885,4893,4908,-42,-27,49734,2441060280,140120
1770,a1309,20121108,4893,4908,4883,4904,4874,4893,4893,-15,-15,39570,1936554100,141936
1771,a1309,20121109,4893,4893,4873,4902,4815,4816,4852,-77,-41,64592,3134353520,136842
1772,a1309,20121112,4816,4852,4761,4765,4677,4757,4732,-95,-120,119494,5654564180,139082
1773,a1309,20121113,4757,4732,4756,4785,4742,4774,4757,42,25,67226,3198365520,146370
1774,a1309,20121114,4774,4757,4780,4810,4770,4789,4786,32,29,51386,2459433200,147250
1775,a1309,20121115,4789,4786,4806,4806,4741,4741,4767,-45,-19,35438,1689619940,148236
1776,a1309,20121116,4741,4767,4742,4779,4739,4773,4763,6,-4,37312,1777211040,151612
1777,a1309,20121119,4773,4763,4773,4795,4761,4783,4779,20,16,49408,2361627600,164648
1778,a1309,20121120,4783,4779,4780,4789,4761,4774,4771,-5,-8,38752,1849155460,169158
1779,a1309,20121121,4774,4771,4789,4800,4775,4788,4787,17,16,28996,1388201460,168072
1780,a1309,20121122,4788,4787,4791,4792,4771,4784,4778,-3,-9,21802,1041785300,169980
1781,a1309,20121123,4784,4778,4781,4815,4776,4805,4797,27,19,29896,1434135760,172734
1782,a1309,20121126,4805,4797,4810,4811,4785,4791,4793,-6,-4,30916,1481887820,177008
1783,a1309,20121127,4791,4793,4799,4800,4774,4776,4788,-17,-5,22010,1053941140,174476
1784,a1309,20121128,4776,4788,4800,4800,4772,4779,4787,-9,-1,24026,1150272500,174780
1785,a1309,20121129,4779,4787,4783,4803,4771,4801,4788,14,1,32860,1573496080,176262
1786,a1309,20121130,4801,4788,4794,4805,4787,4798,4795,10,7,25468,1221417760,179478
1787,a1309,20121203,4798,4795,4800,4833,4800,4812,4816,17,21,29176,1405273780,177572
1788,a1309,20121204,4812,4816,4812,4812,4768,4787,4780,-29,-36,42100,2012523640,179386
1789,a1309,20121205,4787,4780,4790,4799,4777,4793,4788,13,8,31754,1520549860,182082
1790,a1309,20121206,4793,4788,4812,4818,4789,4792,4802,4,14,34104,1637805340,181744
1791,a1309,20121207,4792,4802,4793,4814,4773,4809,4797,7,-5,30042,1441383700,179642
1792,a1309,20121210,4809,4797,4789,4805,4782,4797,4794,0,-3,23990,1150266340,179004
1793,a1309,20121211,4797,4794,4809,4820,4791,4792,4803,-2,9,23622,1134714200,177092
1794,a1309,20121212,4792,4803,4796,4796,4776,4779,4781,-24,-22,27026,1292313060,178156
1795,a1309,20121213,4779,4781,4782,4801,4781,4791,4791,10,10,22740,1089478220,178336
1796,a1309,20121214,4791,4791,4795,4810,4787,4805,4799,14,8,24796,1190173220,174010
1797,a1309,20121217,4805,4799,4826,4865,4820,4860,4840,61,41,70294,3402269220,169202
1798,a1309,20121218,4860,4840,4855,4883,4838,4841,4858,1,18,47862,2325294660,171288
1799,a1309,20121219,4841,4858,4821,4839,4801,4815,4816,-43,-42,48402,2331180260,174882
1800,a1309,20121220,4815,4816,4793,4795,4763,4790,4780,-26,-36,61720,2950510520,177334
1801,a1309,20121221,4790,4780,4777,4812,4777,4803,4801,23,21,53208,2554773820,180168
1802,a1309,20121224,4803,4801,4813,4824,4794,4795,4811,-6,10,29170,1403438180,181822
1803,a1309,20121225,4795,4811,4798,4805,4787,4787,4794,-24,-17,49024,2350400940,178518
1804,a1309,20121226,4787,4794,4788,4800,4782,4791,4790,-3,-4,26746,1281379920,178424
1805,a1309,20121227,4791,4790,4780,4802,4777,4796,4793,6,3,28010,1342705300,172342
1806,a1309,20121228,4796,4793,4788,4800,4768,4772,4783,-21,-10,34734,1661349200,167766
1807,a1309,20121231,4772,4783,4772,4781,4752,4757,4766,-26,-17,39028,1860202420,163344
1808,a1311,20120517,4480,4484,4579,4579,4487,4497,4514,13,30,14,632060,4
1809,a1311,20120518,4497,4514,4450,4485,4450,4485,4467,-29,-47,4,178700,4
1810,a1311,20120521,4485,4467,4485,4499,4485,4499,4494,32,27,12,539320,12
1811,a1311,20120522,4499,4494,4499,4499,4499,4499,4499,5,5,6,269940,10
1812,a1311,20120523,4499,4499,4421,4437,4421,4435,4431,-64,-68,12,531800,12
1813,a1311,20120524,4435,4431,0,0,0,4431,4431,0,0,0,0,12
1814,a1311,20120525,4431,4431,4422,4459,4422,4459,4447,28,16,18,800500,22
1815,a1311,20120528,4459,4447,4459,4459,4459,4459,4459,12,12,4,178360,20
1816,a1311,20120529,4459,4459,4450,4507,4450,4507,4488,48,29,32,1436460,46
1817,a1311,20120530,4507,4488,0,0,0,4488,4488,0,0,0,0,46
1818,a1311,20120531,4488,4488,4495,4495,4475,4489,4490,1,2,18,808200,58
1819,a1311,20120601,4489,4490,4452,4452,4452,4452,4452,-38,-38,2,89040,60
1820,a1311,20120604,4452,4452,4449,4449,4449,4449,4449,-3,-3,2,88980,58
1821,a1311,20120605,4449,4449,4435,4495,4435,4490,4452,41,3,112,4986840,122
1822,a1311,20120606,4490,4452,4531,4541,4502,4502,4531,50,79,64,2900040,118
1823,a1311,20120607,4502,4531,4509,4520,4509,4520,4517,-11,-14,8,361380,120
1824,a1311,20120608,4520,4517,0,0,0,4517,4517,0,0,0,0,120
1825,a1311,20120611,4517,4517,4530,4587,4525,4587,4551,70,34,94,4278760,130
1826,a1311,20120612,4587,4551,4540,4585,4540,4575,4569,24,18,44,2010360,146
1827,a1311,20120613,4575,4569,4579,4579,4578,4578,4578,9,9,6,274700,152
1828,a1311,20120614,4578,4578,0,0,0,4578,4578,0,0,0,0,152
1829,a1311,20120615,4578,4578,4537,4537,4537,4537,4537,-41,-41,6,272220,152
1830,a1311,20120618,4537,4537,4560,4560,4560,4560,4560,23,23,2,91200,154
1831,a1311,20120619,4560,4560,4589,4644,4589,4644,4629,84,69,28,1296320,158
1832,a1311,20120620,4644,4629,4660,4660,4653,4653,4656,24,27,4,186260,158
1833,a1311,20120621,4653,4656,4646,4646,4646,4646,4646,-10,-10,2,92920,156
1834,a1311,20120625,4646,4646,4688,4728,4688,4697,4703,51,57,50,2351920,144
1835,a1311,20120626,4697,4703,4700,4719,4690,4716,4699,13,-4,44,2067720,122
1836,a1311,20120627,4716,4699,4730,4733,4700,4705,4720,6,21,32,1510620,138
1837,a1311,20120628,4705,4720,4696,4710,4690,4710,4703,-10,-17,16,752480,142
1838,a1311,20120629,4710,4703,4685,4692,4660,4692,4673,-11,-30,16,747740,138
1839,a1311,20120702,4692,4673,4722,4722,4685,4685,4706,12,33,28,1317700,134
1840,a1311,20120703,4685,4706,4707,4722,4681,4722,4704,16,-2,34,1599560,132
1841,a1311,20120704,4722,4704,4748,4796,4727,4788,4760,84,56,68,3237100,180
1842,a1311,20120705,4788,4760,4800,4800,4770,4783,4785,23,25,30,1435560,188
1843,a1311,20120706,4783,4785,4772,4772,4750,4755,4761,-30,-24,12,571400,188
1844,a1311,20120709,4755,4761,4770,4870,4770,4870,4811,109,50,50,2405660,192
1845,a1311,20120710,4870,4811,4793,4828,4790,4790,4798,-21,-13,10,479860,194
1846,a1311,20120711,4790,4798,4854,4859,4722,4760,4772,-38,-26,48,2290640,208
1847,a1311,20120712,4760,4772,4701,4759,4701,4725,4732,-47,-40,32,1514320,212
1848,a1311,20120713,4725,4732,4740,4770,4740,4770,4758,38,26,18,856560,218
1849,a1311,20120716,4770,4758,4850,4890,4839,4886,4876,128,118,80,3901060,200
1850,a1311,20120717,4886,4876,4790,4826,4770,4770,4800,-106,-76,46,2208020,186
1851,a1311,20120718,4770,4800,4808,4809,4808,4809,4808,9,8,4,192340,182
1852,a1311,20120719,4809,4808,4839,4839,4818,4819,4826,11,18,18,868760,180
1853,a1311,20120720,4819,4826,4800,4818,4800,4817,4816,-9,-10,84,4045700,174
1854,a1311,20120723,4817,4816,4720,4720,4636,4637,4652,-179,-164,34,1581800,152
1855,a1311,20120724,4637,4652,4535,4568,4501,4541,4532,-111,-120,22,997200,152
1856,a1311,20120725,4541,4532,4590,4590,4545,4545,4571,13,39,22,1005660,154
1857,a1311,20120726,4545,4571,4538,4570,4538,4557,4548,-14,-23,10,454820,158
1858,a1311,20120727,4557,4548,4539,4578,4539,4578,4561,30,13,8,364940,152
1859,a1311,20120730,4578,4561,4649,4668,4615,4648,4644,87,83,26,1207540,150
1860,a1311,20120731,4648,4644,4617,4617,4613,4613,4615,-31,-29,14,646100,140
1861,a1311,20120801,4613,4615,4625,4636,4608,4608,4623,-7,8,42,1941900,122
1862,a1311,20120802,4608,4623,4580,4582,4560,4580,4577,-43,-46,12,549280,116
1863,a1311,20120803,4580,4577,4615,4615,4569,4580,4595,3,18,26,1194860,124
1864,a1311,20120806,4580,4595,4602,4602,4586,4598,4595,3,0,16,735300,118
1865,a1311,20120807,4598,4595,4639,4639,4602,4615,4622,20,27,28,1294160,122
1866,a1311,20120808,4615,4622,4629,4631,4602,4602,4617,-20,-5,66,3047800,116
1867,a1311,20120809,4602,4617,4623,4631,4603,4620,4620,3,3,22,1016560,120
1868,a1311,20120810,4620,4620,4615,4618,4615,4618,4616,-2,-4,12,553920,124
1869,a1311,20120813,4618,4616,4609,4609,4609,4609,4609,-7,-7,4,184360,120
1870,a1311,20120814,4609,4609,4600,4600,4574,4600,4592,-9,-17,16,734840,126
1871,a1311,20120815,4600,4592,4609,4621,4605,4620,4612,28,20,44,2029560,116
1872,a1311,20120816,4620,4612,4609,4620,4603,4603,4614,-9,2,46,2122680,112
1873,a1311,20120817,4603,4614,0,0,0,4614,4614,0,0,0,0,112
1874,a1311,20120820,4614,4614,0,0,0,4614,4614,0,0,0,0,112
1875,a1311,20120821,4614,4614,4672,4693,4670,4670,4678,56,64,14,654960,112
1876,a1311,20120822,4670,4678,4710,4736,4710,4729,4725,51,47,20,945180,116
1877,a1311,20120823,4729,4725,4726,4726,4726,4726,4726,1,1,2,94520,118
1878,a1311,20120824,4726,4726,4729,4732,4719,4730,4727,4,1,16,756460,112
1879,a1311,20120827,4730,4727,4759,4759,4759,4759,4759,32,32,2,95180,112
1880,a1311,20120828,4759,4759,4730,4730,4730,4730,4730,-29,-29,2,94600,110
1881,a1311,20120829,4730,4730,4708,4708,4708,4708,4708,-22,-22,2,94160,110
1882,a1311,20120830,4708,4708,4739,4739,4739,4739,4739,31,31,2,94780,110
1883,a1311,20120831,4739,4739,4745,4745,4745,4745,4745,6,6,2,94900,110
1884,a1311,20120903,4745,4745,4776,4834,4774,4834,4798,89,53,32,1535620,108
1885,a1311,20120904,4834,4798,4834,4883,4834,4880,4844,82,46,34,1646980,96
1886,a1311,20120905,4880,4844,4845,4874,4829,4848,4849,4,5,8,387920,94
1887,a1311,20120906,4848,4849,4765,4765,4731,4755,4756,-94,-93,14,665960,88
1888,a1311,20120907,4755,4756,4770,4791,4731,4731,4754,-25,-2,18,855880,80
1889,a1311,20120910,4731,4754,0,0,0,4754,4754,0,0,0,0,80
1890,a1311,20120911,4754,4754,4767,4767,4753,4753,4762,-1,8,6,285740,74
1891,a1311,20120912,4753,4762,4760,4795,4741,4746,4758,-16,-4,24,1142140,74
1892,a1311,20120913,4746,4758,4797,4797,4774,4796,4792,38,34,10,479220,74
1893,a1311,20120914,4796,4792,4820,4820,4820,4820,4820,28,28,2,96400,74
1894,a1311,20120917,4820,4820,4754,4754,4754,4754,4754,-66,-66,38,1806520,72
1895,a1311,20120918,4754,4754,4628,4679,4628,4656,4648,-98,-106,20,929740,72
1896,a1311,20120919,4656,4648,4690,4690,4667,4667,4682,19,34,6,280940,74
1897,a1311,20120920,4667,4682,4679,4679,4679,4679,4679,-3,-3,2,93580,74
1898,a1311,20120921,4679,4679,4697,4699,4689,4693,4694,14,15,8,375560,74
1899,a1311,20120924,4693,4694,4663,4681,4663,4681,4671,-13,-23,8,373700,78
1900,a1311,20120925,4681,4671,0,0,0,4671,4671,0,0,0,0,78
1901,a1311,20120926,4671,4671,4732,4732,4676,4676,4720,5,49,12,566400,74
1902,a1311,20120927,4676,4720,4709,4709,4690,4690,4699,-30,-21,4,187980,70
1903,a1311,20120928,4690,4699,4693,4714,4693,4714,4703,15,4,4,188140,66
1904,a1311,20121008,4714,4703,0,0,0,4703,4703,0,0,0,0,66
1905,a1311,20121009,4703,4703,4589,4589,4589,4589,4589,-114,-114,2,91780,66
1906,a1311,20121010,4589,4589,4604,4604,4587,4587,4593,-2,4,6,275600,62
1907,a1311,20121011,4587,4593,4619,4622,4619,4622,4620,29,27,12,554400,58
1908,a1311,20121012,4622,4620,4597,4632,4597,4598,4608,-22,-12,14,645240,56
1909,a1311,20121015,4598,4608,0,0,0,4608,4608,0,0,0,0,56
1910,a1311,20121016,4608,4608,0,0,0,4608,4608,0,0,0,0,56
1911,a1311,20121017,4608,4608,4616,4616,4616,4616,4616,8,8,2,92320,54
1912,a1311,20121018,4616,4616,4631,4679,4631,4679,4655,63,39,4,186200,54
1913,a1311,20121019,4679,4655,0,0,0,4655,4655,0,0,0,0,54
1914,a1311,20121022,4655,4655,0,0,0,4655,4655,0,0,0,0,54
1915,a1311,20121023,4655,4655,4661,4661,4635,4635,4648,-20,-7,4,185920,52
1916,a1311,20121024,4635,4648,4685,4685,4685,4685,4685,37,37,2,93700,50
1917,a1311,20121025,4685,4685,0,0,0,4685,4685,0,0,0,0,50
1918,a1311,20121026,4685,4685,4753,4753,4714,4714,4727,29,42,6,283620,50
1919,a1311,20121029,4714,4727,4685,4685,4685,4685,4685,-42,-42,2,93700,50
1920,a1311,20121030,4685,4685,0,0,0,4685,4685,0,0,0,0,50
1921,a1311,20121031,4685,4685,4715,4715,4715,4715,4715,30,30,2,94300,50
1922,a1311,20121101,4715,4715,4745,4840,4745,4840,4792,125,77,4,191700,54
1923,a1311,20121102,4840,4792,0,0,0,4792,4792,0,0,0,0,54
1924,a1311,20121105,4792,4792,0,0,0,4792,4792,0,0,0,0,54
1925,a1311,20121106,4792,4792,0,0,0,4792,4792,0,0,0,0,54
1926,a1311,20121107,4792,4792,0,0,0,4792,4792,0,0,0,0,54
1927,a1311,20121108,4792,4792,4771,4771,4771,4771,4771,-21,-21,2,95420,52
1928,a1311,20121109,4771,4771,0,0,0,4771,4771,0,0,0,0,52
1929,a1311,20121112,4771,4771,4693,4693,4612,4612,4639,-159,-132,8,371140,54
1930,a1311,20121113,4612,4639,4735,4735,4682,4716,4707,77,68,18,847280,56
1931,a1311,20121114,4716,4707,0,0,0,4707,4707,0,0,0,0,56
1932,a1311,20121115,4707,4707,4745,4745,4745,4745,4745,38,38,4,189800,52
1933,a1311,20121116,4745,4745,0,0,0,4745,4745,0,0,0,0,52
1934,a1311,20121119,4745,4745,4760,4760,4732,4732,4746,-13,1,4,189840,52
1935,a1311,20121120,4732,4746,4728,4771,4704,4771,4734,25,-12,6,284060,50
1936,a1311,20121121,4771,4734,4810,4810,4740,4740,4768,6,34,22,1049080,60
1937,a1311,20121122,4740,4768,4741,4749,4741,4749,4745,-19,-23,4,189800,60
1938,a1311,20121123,4749,4745,0,0,0,4745,4745,0,0,0,0,60
1939,a1311,20121126,4745,4745,0,0,0,4745,4745,0,0,0,0,60
1940,a1311,20121127,4745,4745,0,0,0,4745,4745,0,0,0,0,60
1941,a1311,20121128,4745,4745,4808,4808,4751,4762,4774,17,29,10,477460,54
1942,a1311,20121129,4762,4774,4775,4784,4768,4784,4775,10,1,6,286540,54
1943,a1311,20121130,4784,4775,4781,4781,4781,4781,4781,6,6,2,95620,56
1944,a1311,20121203,4781,4781,4812,4812,4791,4791,4801,10,20,8,384100,54
1945,a1311,20121204,4791,4801,4772,4773,4772,4772,4772,-29,-29,12,572660,56
1946,a1311,20121205,4772,4772,4741,4756,4741,4756,4748,-16,-24,4,189940,54
1947,a1311,20121206,4756,4748,4758,4791,4758,4761,4764,13,16,26,1238760,32
1948,a1311,20121207,4761,4764,4770,4774,4770,4774,4772,10,8,4,190880,32
1949,a1311,20121210,4774,4772,4834,4834,4794,4794,4814,22,42,4,192560,30
1950,a1311,20121211,4794,4814,4783,4785,4783,4785,4784,-29,-30,8,382760,30
1951,a1311,20121212,4785,4784,4769,4769,4767,4767,4767,-17,-17,6,286060,30
1952,a1311,20121213,4767,4767,4797,4797,4781,4781,4786,14,19,6,287180,28
1953,a1311,20121214,4781,4786,0,0,0,4786,4786,0,0,0,0,28
1954,a1311,20121217,4786,4786,4810,4810,4810,4810,4810,24,24,2,96200,28
1955,a1311,20121218,4810,4810,4859,4859,4816,4819,4835,9,25,12,580260,26
1956,a1311,20121219,4819,4835,0,0,0,4835,4835,0,0,0,0,26
1957,a1311,20121220,4835,4835,4741,4783,4741,4783,4760,-52,-75,6,285600,26
1958,a1311,20121221,4783,4760,0,0,0,4760,4760,0,0,0,0,26
1959,a1311,20121224,4760,4760,0,0,0,4760,4760,0,0,0,0,26
1960,a1311,20121225,4760,4760,0,0,0,4760,4760,0,0,0,0,26
1961,a1311,20121226,4760,4760,0,0,0,4760,4760,0,0,0,0,26
1962,a1311,20121227,4760,4760,0,0,0,4760,4760,0,0,0,0,26
1963,a1311,20121228,4760,4760,4770,4770,4770,4770,4770,10,10,2,95400,26
1964,a1311,20121231,4770,4770,4745,4745,4745,4745,4745,-25,-25,2,94900,26
1965,a1401,20120717,4905,4893,4816,4860,4778,4790,4814,-103,-79,88,4237140,100
1966,a1401,20120718,4790,4814,4788,4817,4782,4782,4795,-32,-19,36,1726440,110
1967,a1401,20120719,4782,4795,4842,4843,4792,4826,4817,31,22,70,3372120,142
1968,a1401,20120720,4826,4817,4786,4807,4765,4772,4779,-45,-38,118,5639580,178
1969,a1401,20120723,4772,4779,4734,4734,4619,4620,4671,-159,-108,1184,55309880,1022
1970,a1401,20120724,4620,4671,4501,4600,4501,4540,4548,-131,-123,128,5821860,1066
1971,a1401,20120725,4540,4548,4520,4590,4517,4550,4569,2,21,142,6488880,1116
1972,a1401,20120726,4550,4569,4551,4566,4551,4559,4559,-10,-10,46,2097440,1132
1973,a1401,20120727,4559,4559,4559,4569,4531,4568,4552,9,-7,132,6008740,1194
1974,a1401,20120730,4568,4552,4648,4658,4606,4630,4637,78,85,228,10572540,1328
1975,a1401,20120731,4630,4637,4530,4656,4530,4613,4593,-24,-44,128,5880080,1342
1976,a1401,20120801,4613,4593,4613,4624,4592,4592,4608,-1,15,152,7004900,1360
1977,a1401,20120802,4592,4608,4560,4599,4550,4583,4579,-25,-29,196,8975720,1350
1978,a1401,20120803,4583,4579,4583,4626,4572,4578,4599,-1,20,136,6255720,1414
1979,a1401,20120806,4578,4599,4584,4609,4580,4600,4593,1,-6,226,10381960,1488
1980,a1401,20120807,4600,4593,4616,4623,4591,4616,4608,23,15,626,28852260,1852
1981,a1401,20120808,4616,4608,4593,4625,4574,4574,4600,-34,-8,550,25305140,2152
1982,a1401,20120809,4574,4600,4588,4617,4588,4608,4606,8,6,414,19070000,2290
1983,a1401,20120810,4608,4606,4619,4655,4602,4610,4615,4,9,374,17260340,2428
1984,a1401,20120813,4610,4615,4598,4612,4587,4591,4593,-24,-22,188,8636120,2552
1985,a1401,20120814,4591,4593,4575,4590,4560,4578,4574,-15,-19,384,17567660,2648
1986,a1401,20120815,4578,4574,4582,4608,4580,4601,4594,27,20,796,36572700,2930
1987,a1401,20120816,4601,4594,4600,4606,4580,4585,4590,-9,-4,254,11660120,3020
1988,a1401,20120817,4585,4590,4590,4594,4580,4585,4587,-5,-3,492,22571380,3336
1989,a1401,20120820,4585,4587,4598,4605,4587,4589,4591,2,4,354,16255060,3592
1990,a1401,20120821,4589,4591,4602,4617,4595,4611,4605,20,14,1142,52589680,4184
1991,a1401,20120822,4611,4605,4628,4648,4620,4636,4637,31,32,1042,48322440,4258
1992,a1401,20120823,4636,4637,4647,4677,4620,4643,4647,6,10,898,41734680,4340
1993,a1401,20120824,4643,4647,4620,4687,4620,4683,4663,36,16,444,20707420,4426
1994,a1401,20120827,4683,4663,4700,4736,4700,4716,4723,53,60,458,21634900,4446
1995,a1401,20120828,4716,4723,4700,4705,4680,4681,4697,-42,-26,470,22076380,4498
1996,a1401,20120829,4681,4697,4689,4723,4682,4723,4703,26,6,550,25870360,4562
1997,a1401,20120830,4723,4703,4722,4740,4714,4739,4730,36,27,376,17788220,4584
1998,a1401,20120831,4739,4730,4724,4725,4705,4718,4716,-12,-14,690,32540980,4658
1999,a1401,20120903,4718,4716,4732,4817,4732,4798,4771,82,55,890,42466780,4772
2000,a1401,20120904,4798,4771,4780,4852,4780,4846,4830,75,59,1178,56899540,5252
2001,a1401,20120905,4846,4830,4820,4840,4817,4827,4828,-3,-2,390,18832620,5400
2002,a1401,20120906,4827,4828,4785,4785,4737,4757,4756,-71,-72,664,31586360,5264
2003,a1401,20120907,4757,4756,4757,4770,4723,4730,4748,-26,-8,722,34285240,5332
2004,a1401,20120910,4730,4748,4708,4778,4708,4775,4759,27,11,422,20086220,5162
2005,a1401,20120911,4775,4759,4775,4782,4721,4733,4748,-26,-11,1270,60302500,5744
2006,a1401,20120912,4733,4748,4730,4757,4730,4751,4741,3,-7,730,34611080,5818
2007,a1401,20120913,4751,4741,4780,4793,4762,4765,4780,24,39,444,21226380,5888
2008,a1401,20120914,4765,4780,4786,4830,4786,4805,4814,25,34,832,40059020,6118
2009,a1401,20120917,4805,4814,4762,4782,4728,4728,4757,-86,-57,712,33872300,6128
2010,a1401,20120918,4728,4757,4699,4720,4681,4687,4698,-70,-59,814,38243340,6018
2011,a1401,20120919,4687,4698,4708,4727,4692,4715,4711,17,13,1166,54931500,6758
2012,a1401,20120920,4715,4711,4728,4728,4682,4703,4705,-8,-6,682,32093600,6976
2013,a1401,20120921,4703,4705,4671,4723,4671,4706,4704,1,-1,1070,50339180,6996
2014,a1401,20120924,4706,4704,4680,4704,4659,4701,4680,-3,-24,1068,49989380,7058
2015,a1401,20120925,4701,4680,4698,4755,4696,4741,4733,61,53,2192,103757180,7664
2016,a1401,20120926,4741,4733,4733,4748,4692,4698,4717,-35,-16,1116,52644440,8098
2017,a1401,20120927,4698,4717,4690,4690,4657,4663,4671,-54,-46,874,40832320,8394
2018,a1401,20120928,4663,4671,4682,4687,4635,4655,4662,-16,-9,1260,58748300,8728
2019,a1401,20121008,4655,4662,4661,4661,4581,4583,4619,-79,-43,996,46013720,8610
2020,a1401,20121009,4583,4619,4600,4618,4597,4608,4607,-11,-12,562,25893840,8690
2021,a1401,20121010,4608,4607,4600,4616,4563,4608,4594,1,-13,1460,67076180,9392
2022,a1401,20121011,4608,4594,4589,4652,4588,4639,4631,45,37,1074,49741440,9528
2023,a1401,20121012,4639,4631,4650,4670,4623,4627,4645,-4,14,510,23689620,9520
2024,a1401,20121015,4627,4645,4600,4636,4600,4635,4622,-10,-23,458,21172040,9544
2025,a1401,20121016,4635,4622,4639,4653,4634,4644,4645,22,23,734,34100080,9834
2026,a1401,20121017,4644,4645,4635,4650,4628,4645,4639,0,-6,576,26724740,9972
2027,a1401,20121018,4645,4639,4659,4674,4652,4665,4663,26,24,506,23596220,10022
2028,a1401,20121019,4665,4663,4680,4680,4657,4664,4661,1,-2,418,19486540,10208
2029,a1401,20121022,4664,4661,4658,4672,4646,4671,4658,10,-3,1214,56549380,11042
2030,a1401,20121023,4671,4658,4664,4664,4640,4645,4650,-13,-8,1396,64925120,11878
2031,a1401,20121024,4645,4650,4650,4689,4650,4681,4673,31,23,4034,188540220,14262
2032,a1401,20121025,4681,4673,4682,4694,4671,4672,4680,-1,7,2022,94643220,15774
2033,a1401,20121026,4672,4680,4669,4707,4664,4707,4686,27,6,1478,69270120,15816
2034,a1401,20121029,4707,4686,4691,4700,4668,4676,4680,-10,-6,1088,50925920,15856
2035,a1401,20121030,4676,4680,4669,4672,4651,4658,4658,-22,-22,876,40812080,15846
2036,a1401,20121031,4658,4658,4613,4692,4613,4690,4679,32,21,1496,70009700,15838
2037,a1401,20121101,4690,4679,4671,4790,4671,4760,4749,81,70,2504,118926900,16010
2038,a1401,20121102,4760,4749,4756,4787,4744,4772,4766,23,17,1634,77879860,16032
2039,a1401,20121105,4772,4766,4740,4770,4702,4720,4733,-46,-33,3154,149306960,17496
2040,a1401,20121106,4720,4733,4728,4753,4728,4741,4740,8,7,3228,153016980,19474
2041,a1401,20121107,4741,4740,4745,4745,4711,4719,4726,-21,-14,1024,48394300,19466
2042,a1401,20121108,4719,4726,4710,4730,4706,4716,4718,-10,-8,292,13779000,19466
2043,a1401,20121109,4716,4718,4710,4728,4654,4654,4684,-64,-34,1032,48345660,19438
2044,a1401,20121112,4654,4684,4620,4620,4538,4615,4594,-69,-90,6828,313687540,19112
2045,a1401,20121113,4615,4594,4626,4668,4604,4664,4638,70,44,6234,289148460,20280
2046,a1401,20121114,4664,4638,4688,4761,4671,4727,4725,89,87,6956,328713380,21772
2047,a1401,20121115,4727,4725,4725,4736,4696,4696,4718,-29,-7,7802,368103360,25282
2048,a1401,20121116,4696,4718,4697,4719,4691,4708,4709,-10,-9,2178,102575980,26278
2049,a1401,20121119,4708,4709,4710,4727,4706,4718,4715,9,6,1246,58753800,26160
2050,a1401,20121120,4718,4715,4718,4721,4706,4712,4713,-3,-2,604,28470620,26160
2051,a1401,20121121,4712,4713,4729,4732,4715,4720,4722,7,9,1118,52797120,26246
2052,a1401,20121122,4720,4722,4717,4720,4709,4716,4713,-6,-9,332,15647780,26258
2053,a1401,20121123,4716,4713,4719,4743,4713,4737,4728,24,15,1128,53333900,26242
2054,a1401,20121126,4737,4728,4743,4748,4721,4730,4727,2,-1,484,22882700,26262
2055,a1401,20121127,4730,4727,4737,4742,4720,4720,4728,-7,1,854,40380260,26196
2056,a1401,20121128,4720,4728,4735,4742,4713,4731,4726,3,-2,884,41781340,26084
2057,a1401,20121129,4731,4726,4731,4737,4706,4735,4721,9,-5,2102,99248580,25726
2058,a1401,20121130,4735,4721,4731,4748,4728,4735,4735,14,14,690,32676480,25724
2059,a1401,20121203,4735,4735,4732,4767,4723,4750,4747,15,12,1728,82036420,25786
2060,a1401,20121204,4750,4747,4743,4743,4715,4729,4724,-18,-23,2116,99960880,25968
2061,a1401,20121205,4729,4724,4737,4739,4723,4733,4730,9,6,1454,68776280,25810
2062,a1401,20121206,4733,4730,4752,4752,4734,4739,4742,9,12,1222,57953400,26082
2063,a1401,20121207,4739,4742,4749,4770,4724,4768,4752,26,10,4604,218802180,26270
2064,a1401,20121210,4768,4752,4747,4773,4742,4767,4762,15,10,2148,102293240,27120
2065,a1401,20121211,4767,4762,4771,4781,4761,4762,4771,0,9,974,46477080,27406
2066,a1401,20121212,4762,4771,4757,4765,4746,4752,4755,-19,-16,1072,50977000,27898
2067,a1401,20121213,4752,4755,4752,4766,4752,4759,4760,4,5,864,41134260,28246
2068,a1401,20121214,4759,4760,4761,4770,4758,4763,4763,3,3,5740,273451980,32164
2069,a1401,20121217,4763,4763,4778,4812,4775,4811,4795,48,32,4518,216644600,33122
2070,a1401,20121218,4811,4795,4800,4832,4791,4792,4806,-3,11,4824,231873300,35378
2071,a1401,20121219,4792,4806,4770,4784,4758,4766,4767,-40,-39,1926,91821240,35242
2072,a1401,20121220,4766,4767,4750,4750,4723,4739,4737,-28,-30,6682,316571700,33404
2073,a1401,20121221,4739,4737,4721,4760,4721,4753,4746,16,9,1918,91030680,33544
2074,a1401,20121224,4753,4746,4770,4772,4746,4746,4761,0,15,614,29233680,33504
2075,a1401,20121225,4746,4761,4750,4759,4741,4746,4749,-15,-12,2136,101459660,32346
2076,a1401,20121226,4746,4749,4750,4755,4741,4745,4746,-4,-3,658,31234620,32306
2077,a1401,20121227,4745,4746,4748,4758,4742,4758,4751,12,5,2350,111651500,32444
2078,a1401,20121228,4758,4751,4758,4760,4730,4738,4741,-13,-10,1728,81941340,32822
2079,a1401,20121231,4738,4741,4735,4754,4732,4746,4746,5,5,2916,138416380,33470
2080,a1403,20120918,4780,4780,0,0,0,4780,4780,0,0,0,0,0
2081,a1403,20120919,4780,4780,0,0,0,4780,4780,0,0,0,0,0
2082,a1403,20120920,4780,4780,0,0,0,4780,4780,0,0,0,0,0
2083,a1403,20120921,4780,4780,0,0,0,4780,4780,0,0,0,0,0
2084,a1403,20120924,4780,4780,0,0,0,4780,4780,0,0,0,0,0
2085,a1403,20120925,4780,4780,0,0,0,4780,4780,0,0,0,0,0
2086,a1403,20120926,4780,4780,0,0,0,4780,4780,0,0,0,0,0
2087,a1403,20120927,4780,4780,0,0,0,4780,4780,0,0,0,0,0
2088,a1403,20120928,4780,4780,0,0,0,4780,4780,0,0,0,0,0
2089,a1403,20121008,4780,4780,0,0,0,4780,4780,0,0,0,0,0
2090,a1403,20121009,4780,4780,4573,4610,4570,4610,4590,-170,-190,8,367240,6
2091,a1403,20121010,4610,4590,4630,4630,4630,4630,4630,40,40,2,92600,6
2092,a1403,20121011,4630,4630,4600,4633,4600,4620,4624,-10,-6,22,1017400,8
2093,a1403,20121012,4620,4624,4625,4625,4625,4625,4625,1,1,2,92500,6
2094,a1403,20121015,4625,4625,0,0,0,4625,4625,0,0,0,0,6
2095,a1403,20121016,4625,4625,4650,4748,4633,4633,4677,8,52,6,280620,4
2096,a1403,20121017,4633,4677,0,0,0,4677,4677,0,0,0,0,4
2097,a1403,20121018,4677,4677,0,0,0,4677,4677,0,0,0,0,4
2098,a1403,20121019,4677,4677,4610,4690,4610,4690,4650,13,-27,4,186000,4
2099,a1403,20121022,4690,4650,4687,4687,4687,4687,4687,37,37,2,93740,4
2100,a1403,20121023,4687,4687,0,0,0,4687,4687,0,0,0,0,4
2101,a1403,20121024,4687,4687,0,0,0,4687,4687,0,0,0,0,4
2102,a1403,20121025,4687,4687,4641,4690,4641,4665,4667,-22,-20,16,746860,8
2103,a1403,20121026,4665,4667,4733,4733,4733,4733,4733,66,66,6,283980,4
2104,a1403,20121029,4733,4733,0,0,0,4733,4733,0,0,0,0,4
2105,a1403,20121030,4733,4733,0,0,0,4733,4733,0,0,0,0,4
2106,a1403,20121031,4733,4733,4733,4733,4717,4717,4727,-16,-6,6,283660,6
2107,a1403,20121101,4717,4727,4770,4770,4770,4770,4770,43,43,2,95400,4
2108,a1403,20121102,4770,4770,0,0,0,4770,4770,0,0,0,0,4
2109,a1403,20121105,4770,4770,0,0,0,4770,4770,0,0,0,0,4
2110,a1403,20121106,4770,4770,0,0,0,4770,4770,0,0,0,0,4
2111,a1403,20121107,4770,4770,0,0,0,4770,4770,0,0,0,0,4
2112,a1403,20121108,4770,4770,0,0,0,4770,4770,0,0,0,0,4
2113,a1403,20121109,4770,4770,0,0,0,4770,4770,0,0,0,0,4
2114,a1403,20121112,4770,4770,4582,4617,4582,4617,4594,-153,-176,6,275680,2
2115,a1403,20121113,4617,4594,4566,4566,4566,4566,4566,-28,-28,4,182640,6
2116,a1403,20121114,4566,4566,4722,4735,4714,4734,4727,168,161,52,2458060,34
2117,a1403,20121115,4734,4727,0,0,0,4727,4727,0,0,0,0,34
2118,a1403,20121116,4727,4727,0,0,0,4727,4727,0,0,0,0,34
2119,a1403,20121119,4727,4727,0,0,0,4727,4727,0,0,0,0,34
2120,a1403,20121120,4727,4727,0,0,0,4727,4727,0,0,0,0,34
2121,a1403,20121121,4727,4727,0,0,0,4727,4727,0,0,0,0,34
2122,a1403,20121122,4727,4727,4715,4723,4715,4722,4720,-5,-7,6,283200,32
2123,a1403,20121123,4722,4720,0,0,0,4720,4720,0,0,0,0,32
2124,a1403,20121126,4720,4720,4728,4730,4727,4730,4728,10,8,8,378300,30
2125,a1403,20121127,4730,4728,0,0,0,4728,4728,0,0,0,0,30
2126,a1403,20121128,4728,4728,0,0,0,4728,4728,0,0,0,0,30
2127,a1403,20121129,4728,4728,0,0,0,4728,4728,0,0,0,0,30
2128,a1403,20121130,4728,4728,4731,4731,4731,4731,4731,3,3,2,94620,30
2129,a1403,20121203,4731,4731,4740,4755,4740,4755,4749,24,18,6,284940,30
2130,a1403,20121204,4755,4749,4702,4732,4702,4732,4720,-17,-29,12,566460,30
2131,a1403,20121205,4732,4720,4764,4764,4741,4741,4752,21,32,4,190100,28
2132,a1403,20121206,4741,4752,4750,4761,4750,4757,4756,5,4,6,285360,26
2133,a1403,20121207,4757,4756,0,0,0,4756,4756,0,0,0,0,26
2134,a1403,20121210,4756,4756,0,0,0,4756,4756,0,0,0,0,26
2135,a1403,20121211,4756,4756,0,0,0,4756,4756,0,0,0,0,26
2136,a1403,20121212,4756,4756,4746,4784,4746,4755,4761,-1,5,12,571360,28
2137,a1403,20121213,4755,4761,4753,4759,4741,4741,4751,-20,-10,24,1140420,22
2138,a1403,20121214,4741,4751,4803,4803,4759,4770,4769,19,18,36,1716920,0
2139,a1403,20121217,4770,4769,0,0,0,4769,4769,0,0,0,0,0
2140,a1403,20121218,4769,4769,0,0,0,4769,4769,0,0,0,0,0
2141,a1403,20121219,4769,4769,0,0,0,4769,4769,0,0,0,0,0
2142,a1403,20121220,4769,4769,0,0,0,4769,4769,0,0,0,0,0
2143,a1403,20121221,4769,4769,0,0,0,4769,4769,0,0,0,0,0
2144,a1403,20121224,4769,4769,0,0,0,4769,4769,0,0,0,0,0
2145,a1403,20121225,4769,4769,0,0,0,4769,4769,0,0,0,0,0
2146,a1403,20121226,4769,4769,4910,4910,4766,4766,4838,-3,69,4,193520,0
2147,a1403,20121227,4766,4838,0,0,0,4838,4838,0,0,0,0,0
2148,a1403,20121228,4838,4838,0,0,0,4838,4838,0,0,0,0,0
2149,a1403,20121231,4838,4838,4622,4800,4622,4800,4711,-38,-127,20,942200,0
2150,a1405,20121116,4743,4743,4741,4764,4730,4740,4746,-3,3,80,3797400,64
2151,a1405,20121119,4740,4746,4759,4770,4742,4755,4751,9,5,36,1710560,72
2152,a1405,20121120,4755,4751,4743,4758,4743,4758,4754,7,3,12,570480,76
2153,a1405,20121121,4758,4754,4758,4772,4758,4761,4763,7,9,8,381100,74
2154,a1405,20121122,4761,4763,4760,4760,4754,4754,4757,-9,-6,10,475720,80
2155,a1405,20121123,4754,4757,4766,4853,4747,4786,4770,29,13,38,1812720,90
2156,a1405,20121126,4786,4770,4784,4793,4776,4784,4783,14,13,38,1817880,90
2157,a1405,20121127,4784,4783,4796,4797,4772,4775,4785,-8,2,68,3254080,98
2158,a1405,20121128,4775,4785,4775,4808,4752,4780,4781,-5,-4,104,4973060,112
2159,a1405,20121129,4780,4781,4778,4797,4770,4787,4786,6,5,38,1818820,112
2160,a1405,20121130,4787,4786,4795,4795,4783,4783,4789,-3,3,4,191560,110
2161,a1405,20121203,4783,4789,4800,4812,4788,4804,4795,15,6,76,3644540,118
2162,a1405,20121204,4804,4795,4779,4785,4737,4776,4776,-19,-19,42,2005960,138
2163,a1405,20121205,4776,4776,4797,4798,4775,4790,4788,14,12,106,5075360,154
2164,a1405,20121206,4790,4788,4801,4811,4793,4793,4801,5,13,54,2593000,176
2165,a1405,20121207,4793,4801,4784,4816,4784,4816,4804,15,3,64,3074800,212
2166,a1405,20121210,4816,4804,4770,4818,4770,4814,4811,10,7,158,7602760,314
2167,a1405,20121211,4814,4811,4821,4826,4812,4812,4819,1,8,46,2216780,320
2168,a1405,20121212,4812,4819,4810,4813,4805,4810,4809,-9,-10,194,9329500,444
2169,a1405,20121213,4810,4809,4811,4814,4806,4808,4810,-1,1,298,14336020,238
2170,a1405,20121214,4808,4810,4808,4815,4801,4801,4809,-9,-1,328,15774520,88
2171,a1405,20121217,4801,4809,4814,4848,4814,4842,4834,33,25,114,5511580,34
2172,a1405,20121218,4842,4834,4846,4976,4832,4850,4854,16,20,44,2135960,18
2173,a1405,20121219,4850,4854,4841,4870,4841,4845,4851,-9,-3,36,1746640,34
2174,a1405,20121220,4845,4851,4791,4827,4791,4810,4802,-41,-49,38,1825100,0
2175,a1405,20121221,4810,4802,4815,4835,4815,4835,4829,33,27,10,482980,8
2176,a1405,20121224,4835,4829,4826,4840,4826,4830,4831,1,2,18,869620,18
2177,a1405,20121225,4830,4831,4837,4851,4837,4851,4839,20,8,14,677480,30
2178,a1405,20121226,4851,4839,4830,4846,4830,4831,4834,-8,-5,18,870240,32
2179,a1405,20121227,4831,4834,4839,4851,4831,4851,4842,17,8,24,1162160,38
2180,a1405,20121228,4851,4842,4840,4840,4828,4834,4832,-8,-10,10,483220,42
2181,a1405,20121231,4834,4832,4832,4835,4812,4829,4825,-3,-7,48,2316440,52
1,a1301,20130104,4610,4617,4590,4625,4590,4625,4590,8,-27,1634,75014700,1974
2,a1301,20130107,4625,4590,0,0,0,4590,4590,0,0,0,0,888
3,a1301,20130108,4590,4590,4646,4646,4613,4622,4625,32,35,200,9250000,1088
4,a1301,20130109,4622,4625,0,0,0,4625,4625,0,0,0,0,1088
5,a1301,20130110,4625,4625,0,0,0,4625,4625,0,0,0,0,400
6,a1301,20130111,4625,4625,0,0,0,4625,4625,0,0,0,0,400
7,a1301,20130114,4625,4625,0,0,0,4625,4625,0,0,0,0,200
8,a1301,20130115,4625,4625,0,0,0,4625,4625,0,0,0,0,200
9,a1301,20130116,4625,4625,0,0,0,4625,4625,0,0,0,0,200
10,a1301,20130117,4625,4625,0,0,0,4625,4594,0,-31,0,0,0
11,a1303,20130104,4711,4711,4731,4731,4686,4707,4709,-4,-2,26,1224520,222
12,a1303,20130107,4707,4709,4723,4736,4704,4704,4721,-5,12,18,849780,228
13,a1303,20130108,4704,4721,4690,4739,4690,4708,4706,-13,-15,8,376540,228
14,a1303,20130109,4708,4706,4739,4739,4707,4707,4723,1,17,4,188920,226
15,a1303,20130110,4707,4723,4723,4736,4723,4730,4725,7,2,46,2173640,190
16,a1303,20130111,4730,4725,4721,4736,4721,4736,4732,11,7,8,378580,186
17,a1303,20130114,4736,4732,0,0,0,4732,4732,0,0,0,0,186
18,a1303,20130115,4732,4732,4757,4773,4757,4761,4763,29,31,6,285820,186
19,a1303,20130116,4761,4763,4769,4804,4769,4804,4782,41,19,8,382600,182
20,a1303,20130117,4804,4782,4777,4777,4771,4771,4772,-11,-10,10,477220,182
21,a1303,20130118,4771,4772,4761,4762,4751,4757,4758,-15,-14,46,2188940,182
22,a1303,20130121,4757,4758,4821,4838,4790,4790,4807,32,49,134,6442000,236
23,a1303,20130122,4790,4807,4779,4781,4779,4779,4779,-28,-28,16,764760,226
24,a1303,20130123,4779,4779,4816,4824,4780,4801,4797,22,18,16,767620,224
25,a1303,20130124,4801,4797,4817,4817,4780,4780,4787,-17,-10,26,1244700,222
26,a1303,20130125,4780,4787,4777,4807,4761,4771,4779,-16,-8,8,382320,218
27,a1303,20130128,4771,4779,0,0,0,4779,4779,0,0,0,0,218
28,a1303,20130129,4779,4779,4793,4793,4791,4791,4792,12,13,8,383400,224
29,a1303,20130130,4791,4792,4790,4800,4790,4800,4793,8,1,78,3738640,160
30,a1303,20130131,4800,4793,4800,4800,4800,4800,4800,7,7,2,96000,160
31,a1303,20130201,4800,4800,4869,4869,4791,4802,4812,2,12,20,962500,154
32,a1303,20130204,4802,4812,0,0,0,4812,4812,0,0,0,0,154
33,a1303,20130205,4812,4812,4794,4819,4794,4819,4812,7,0,8,385020,154
34,a1303,20130206,4819,4812,4788,4802,4788,4801,4792,-11,-20,26,1245960,132
35,a1303,20130207,4801,4792,0,0,0,4792,4792,0,0,0,0,132
36,a1303,20130208,4792,4792,4792,4961,4792,4805,4837,13,45,20,967500,136
37,a1303,20130218,4805,4837,4802,4802,4800,4800,4800,-37,-37,6,288040,136
38,a1303,20130219,4800,4800,4800,4820,4800,4809,4810,9,10,22,1058280,142
39,a1303,20130220,4809,4810,4841,4841,4841,4841,4841,31,31,2,96820,140
40,a1303,20130221,4841,4841,4841,4841,4821,4821,4839,-20,-2,24,1161440,116
41,a1303,20130222,4821,4839,4980,4980,4846,4900,4907,61,68,8,392600,116
42,a1303,20130225,4900,4907,4821,4879,4821,4865,4857,-42,-50,96,4662720,122
43,a1303,20130226,4865,4857,4880,4880,4880,4880,4880,23,23,10,488000,122
44,a1303,20130227,4880,4880,4851,4851,4850,4850,4850,-30,-30,8,388020,130
45,a1303,20130228,4850,4850,4811,5044,4811,5044,4880,194,30,10,488080,132
46,a1303,20130301,5044,4880,4850,4850,4850,4850,4850,-30,-30,10,485000,44
47,a1303,20130304,4850,4850,0,0,0,4850,4850,0,0,0,0,6
48,a1303,20130305,4850,4850,4900,4900,4900,4900,4900,50,50,4,196000,6
49,a1303,20130306,4900,4900,0,0,0,4900,4900,0,0,0,0,2
50,a1303,20130307,4900,4900,0,0,0,4900,4900,0,0,0,0,2
51,a1303,20130308,4900,4900,0,0,0,4900,4900,0,0,0,0,2
52,a1303,20130311,4900,4900,0,0,0,4900,4900,0,0,0,0,2
53,a1303,20130312,4900,4900,5193,5193,5193,5193,5193,293,293,2,103860,0
54,a1303,20130313,5193,5193,0,0,0,5193,5193,0,0,0,0,0
55,a1303,20130314,5193,5193,0,0,0,5193,4905,0,-288,0,0,0
56,a1305,20130104,4743,4742,4720,4752,4682,4740,4730,-2,-12,83298,3940172660,227566
57,a1305,20130107,4740,4730,4721,4765,4718,4731,4741,1,11,105872,5019553820,223224
58,a1305,20130108,4731,4741,4753,4753,4706,4739,4729,-2,-12,106642,5043233120,222558
59,a1305,20130109,4739,4729,4739,4754,4734,4737,4743,8,14,44018,2088194960,219828
60,a1305,20130110,4737,4743,4740,4751,4735,4750,4744,7,1,35326,1676032900,214416
61,a1305,20130111,4750,4744,4749,4793,4743,4755,4764,11,20,144948,6905729580,216392
62,a1305,20130114,4755,4764,4784,4812,4776,4806,4797,42,33,113530,5446703360,216238
63,a1305,20130115,4806,4797,4830,4839,4785,4798,4800,1,3,78972,3791336800,208246
64,a1305,20130116,4798,4800,4807,4816,4794,4813,4807,13,7,53430,2568650880,209528
65,a1305,20130117,4813,4807,4838,4838,4790,4791,4810,-16,3,44234,2127680600,204504
66,a1305,20130118,4791,4810,4799,4819,4787,4816,4805,6,-5,58576,2815133040,197668
67,a1305,20130121,4816,4805,4816,4859,4813,4827,4834,22,29,56158,2715118440,195736
68,a1305,20130122,4827,4834,4836,4846,4822,4844,4835,10,1,44440,2148836420,190730
69,a1305,20130123,4844,4835,4848,4848,4829,4835,4836,0,1,28486,1377741680,184456
70,a1305,20130124,4835,4836,4816,4827,4804,4819,4817,-17,-19,43014,2072390100,179290
71,a1305,20130125,4819,4817,4830,4854,4827,4832,4840,15,23,58236,2819139720,172606
72,a1305,20130128,4832,4840,4848,4855,4827,4851,4847,11,7,33410,1619462960,162716
73,a1305,20130129,4851,4847,4847,4860,4841,4847,4848,0,1,22650,1098126140,161704
74,a1305,20130130,4847,4848,4848,4875,4836,4862,4861,14,13,38098,1852174400,158402
75,a1305,20130131,4862,4861,4876,4891,4847,4855,4862,-6,1,39410,1916447560,150030
76,a1305,20130201,4855,4862,4846,4870,4844,4866,4855,4,-7,22686,1101477600,141856
77,a1305,20130204,4866,4855,4866,4868,4855,4858,4860,3,5,17812,865792580,138076
78,a1305,20130205,4858,4860,4857,4866,4850,4853,4859,-7,-1,16096,782232640,130108
79,a1305,20130206,4853,4859,4858,4873,4856,4871,4867,12,8,11394,554586100,125708
80,a1305,20130207,4871,4867,4870,4870,4848,4863,4858,-4,-9,17824,866031420,114358
81,a1305,20130208,4863,4858,4859,4900,4859,4886,4886,28,28,13338,651716980,108934
82,a1305,20130218,4886,4886,4840,4850,4826,4845,4835,-41,-51,18702,904413520,97588
83,a1305,20130219,4845,4835,4820,4853,4820,4849,4845,14,10,16888,818372140,94626
84,a1305,20130220,4849,4845,4870,4890,4863,4885,4879,40,34,14096,687879880,92416
85,a1305,20130221,4885,4879,4877,4888,4861,4881,4874,2,-5,18180,886216340,89134
86,a1305,20130222,4881,4874,4880,4956,4880,4922,4917,48,43,34688,1705898980,83846
87,a1305,20130225,4922,4917,4891,4910,4865,4889,4885,-28,-32,19058,931109140,80492
88,a1305,20130226,4889,4885,4878,4905,4851,4852,4880,-33,-5,23276,1135921460,83140
89,a1305,20130227,4852,4880,4870,4890,4847,4854,4859,-26,-21,15998,777469220,81142
90,a1305,20130228,4854,4859,4874,4879,4851,4854,4868,-5,9,13386,651635200,76476
91,a1305,20130301,4854,4868,4875,4881,4855,4878,4869,10,1,9892,481729340,73448
92,a1305,20130304,4878,4869,4870,4882,4866,4868,4874,-1,5,6092,296955820,72718
93,a1305,20130305,4868,4874,4878,4893,4877,4884,4886,10,12,7646,373656700,69080
94,a1305,20130306,4884,4886,4884,4890,4881,4890,4886,4,0,4742,231731140,68478
95,a1305,20130307,4890,4886,4885,4896,4885,4894,4891,8,5,5548,271393360,67250
96,a1305,20130308,4894,4891,4899,4906,4897,4901,4902,10,11,6218,304831700,66068
97,a1305,20130311,4901,4902,4901,4905,4890,4891,4895,-11,-7,5250,256992200,63844
98,a1305,20130312,4891,4895,4896,4902,4878,4885,4885,-10,-10,4462,218001880,63354
99,a1305,20130313,4885,4885,4883,4885,4865,4881,4877,-4,-8,5260,256567380,61140
100,a1305,20130314,4881,4877,4848,4881,4848,4877,4869,0,-8,4336,211153220,59488
101,a1305,20130315,4877,4869,4878,4896,4878,4893,4892,24,23,8684,424855000,54996
102,a1305,20130318,4893,4892,4878,4883,4863,4882,4877,-10,-15,2428,118425460,54512
103,a1305,20130319,4882,4877,4883,4890,4875,4886,4883,9,6,1102,53812600,54450
104,a1305,20130320,4886,4883,4886,4900,4880,4895,4893,12,10,3214,157275980,52344
105,a1305,20130321,4895,4893,4900,4915,4896,4910,4904,17,11,5044,247390900,50378
106,a1305,20130322,4910,4904,4917,4931,4903,4926,4917,22,13,2910,143108220,50170
107,a1305,20130325,4926,4917,4906,4970,4906,4965,4957,48,40,6342,314381340,50766
108,a1305,20130326,4965,4957,4960,5006,4960,4999,4990,42,33,13078,652698480,49994
109,a1305,20130327,4999,4990,5012,5018,4986,4995,4998,5,8,7808,390310140,49878
110,a1305,20130328,4995,4998,4995,5007,4991,4996,5000,-2,2,4284,214209800,49866
111,a1305,20130329,4996,5000,4969,5015,4950,5000,4996,0,-4,8376,418510300,47226
112,a1305,20130401,5000,4996,4998,5009,4986,4988,4996,-8,0,5186,259096540,44186
113,a1305,20130402,4988,4996,4996,4998,4982,4991,4987,-5,-9,5374,268051980,42212
114,a1305,20130403,4991,4987,4981,5018,4972,5003,5002,16,15,7870,393675300,39434
115,a1305,20130408,5003,5002,5052,5052,4990,5040,5023,38,21,7396,371550780,35066
116,a1305,20130409,5040,5023,5041,5064,5033,5041,5047,18,24,4014,202613180,34222
117,a1305,20130410,5041,5047,5040,5049,5030,5044,5041,-3,-6,2454,123717260,32614
118,a1305,20130411,5044,5041,5042,5044,5034,5036,5037,-5,-4,2678,134916040,31536
119,a1305,20130412,5036,5037,5039,5043,5024,5038,5030,1,-7,2374,119417780,30980
120,a1305,20130415,5038,5030,5031,5037,5027,5032,5032,2,2,2760,138901640,29566
121,a1305,20130416,5032,5032,5024,5031,5017,5029,5025,-3,-7,8146,409357900,22552
122,a1305,20130417,5029,5025,5028,5037,5025,5027,5028,2,3,2534,127433880,21358
123,a1305,20130418,5027,5028,5030,5039,5018,5032,5029,4,1,2840,142846640,19536
124,a1305,20130419,5032,5029,5028,5032,5015,5015,5026,-14,-3,3242,162963740,17376
125,a1305,20130422,5015,5026,5011,5011,4995,5001,5004,-25,-22,2186,109395680,15716
126,a1305,20130423,5001,5004,4997,5002,4997,5000,4999,-4,-5,1998,99896740,14070
127,a1305,20130424,5000,4999,5000,5014,4992,4999,5000,0,1,2786,139309860,12366
128,a1305,20130425,4999,5000,4999,4999,4950,4950,4967,-50,-33,3676,182619880,9040
129,a1305,20130426,4950,4967,4952,5000,4719,4719,4922,-248,-45,9004,443208780,5746
130,a1305,20130502,4719,4922,4879,4899,4879,4899,4888,-23,-34,34,1662080,5444
131,a1305,20130503,4899,4888,4820,4840,4820,4840,4820,-48,-68,176,8484000,4986
132,a1305,20130506,4840,4820,0,0,0,4820,4820,0,0,0,0,3124
133,a1305,20130507,4820,4820,0,0,0,4820,4820,0,0,0,0,3124
134,a1305,20130508,4820,4820,0,0,0,4820,4820,0,0,0,0,2872
135,a1305,20130509,4820,4820,4750,4750,4750,4750,4750,-70,-70,24,1140000,2872
136,a1305,20130510,4750,4750,4800,4800,4720,4730,4733,-20,-17,670,31713800,2968
137,a1305,20130513,4730,4733,4730,4739,4720,4730,4731,-3,-2,242,11450400,2988
138,a1305,20130514,4730,4731,4730,4750,4720,4720,4728,-11,-3,338,15982400,2210
139,a1305,20130515,4720,4728,4730,4730,4720,4720,4743,-8,15,232,10965820,0
140,a1307,20130104,4762,4764,4732,4740,4732,4740,4736,-24,-28,4,189440,58
141,a1307,20130107,4740,4736,4772,4772,4751,4751,4761,15,25,4,190460,56
142,a1307,20130108,4751,4761,4730,4738,4730,4738,4735,-23,-26,12,568220,62
143,a1307,20130109,4738,4735,4774,4774,4753,4753,4763,18,28,14,666840,62
144,a1307,20130110,4753,4763,4759,4763,4759,4763,4761,0,-2,12,571320,50
145,a1307,20130111,4763,4761,4760,4765,4760,4764,4763,3,2,6,285780,52
146,a1307,20130114,4764,4763,4799,4814,4799,4814,4805,51,42,20,961040,38
147,a1307,20130115,4814,4805,0,0,0,4805,4805,0,0,0,0,38
148,a1307,20130116,4805,4805,0,0,0,4805,4805,0,0,0,0,38
149,a1307,20130117,4805,4805,4822,4822,4793,4793,4811,-12,6,6,288700,38
150,a1307,20130118,4793,4811,4814,4839,4814,4839,4826,28,15,8,386120,38
151,a1307,20130121,4839,4826,4842,4852,4834,4852,4841,26,15,12,580920,32
152,a1307,20130122,4852,4841,0,0,0,4841,4841,0,0,0,0,32
153,a1307,20130123,4841,4841,4848,4848,4835,4835,4841,-6,0,4,193660,32
154,a1307,20130124,4835,4841,4816,4816,4816,4816,4816,-25,-25,2,96320,34
155,a1307,20130125,4816,4816,4829,4829,4829,4829,4829,13,13,4,193160,34
156,a1307,20130128,4829,4829,4841,4846,4831,4840,4839,11,10,10,483940,36
157,a1307,20130129,4840,4839,4836,4843,4832,4839,4836,0,-3,14,677080,30
158,a1307,20130130,4839,4836,4836,4869,4836,4855,4854,19,18,8,388360,26
159,a1307,20130131,4855,4854,4857,4857,4850,4851,4852,-3,-2,10,485220,26
160,a1307,20130201,4851,4852,4858,4858,4855,4855,4856,3,4,4,194260,22
161,a1307,20130204,4855,4856,4851,4851,4851,4851,4851,-5,-5,4,194040,22
162,a1307,20130205,4851,4851,4895,4895,4895,4895,4895,44,44,2,97900,22
163,a1307,20130206,4895,4895,4859,4865,4859,4865,4862,-30,-33,4,194480,20
164,a1307,20130207,4865,4862,4838,4838,4838,4838,4838,-24,-24,2,96760,22
165,a1307,20130208,4838,4838,4900,4900,4889,4889,4897,51,59,8,391780,16
166,a1307,20130218,4889,4897,4821,4821,4821,4821,4821,-76,-76,2,96420,16
167,a1307,20130219,4821,4821,0,0,0,4821,4821,0,0,0,0,16
168,a1307,20130220,4821,4821,4885,4885,4841,4856,4865,35,44,18,875840,14
169,a1307,20130221,4856,4865,0,0,0,4865,4865,0,0,0,0,14
170,a1307,20130222,4865,4865,0,0,0,4865,4865,0,0,0,0,14
171,a1307,20130225,4865,4865,0,0,0,4865,4865,0,0,0,0,14
172,a1307,20130226,4865,4865,4812,4812,4793,4793,4802,-72,-63,4,192100,14
173,a1307,20130227,4793,4802,4741,4765,4741,4765,4750,-37,-52,12,570040,14
174,a1307,20130228,4765,4750,0,0,0,4750,4750,0,0,0,0,14
175,a1307,20130301,4750,4750,4794,4794,4794,4794,4794,44,44,6,287640,10
176,a1307,20130304,4794,4794,0,0,0,4794,4794,0,0,0,0,10
177,a1307,20130305,4794,4794,0,0,0,4794,4794,0,0,0,0,10
178,a1307,20130306,4794,4794,4783,4783,4783,4783,4783,-11,-11,6,286980,16
179,a1307,20130307,4783,4783,4792,4794,4792,4793,4793,10,10,6,287580,10
180,a1307,20130308,4793,4793,0,0,0,4793,4793,0,0,0,0,10
181,a1307,20130311,4793,4793,0,0,0,4793,4793,0,0,0,0,10
182,a1307,20130312,4793,4793,0,0,0,4793,4793,0,0,0,0,10
183,a1307,20130313,4793,4793,4769,4770,4769,4770,4769,-23,-24,12,572380,22
184,a1307,20130314,4770,4769,4767,4767,4767,4767,4767,-2,-2,2,95340,20
185,a1307,20130315,4767,4767,4702,4839,4702,4799,4776,32,9,10,477620,22
186,a1307,20130318,4799,4776,4837,4837,4778,4778,4791,2,15,22,1054120,32
187,a1307,20130319,4778,4791,0,0,0,4791,4791,0,0,0,0,32
188,a1307,20130320,4791,4791,4797,4818,4797,4816,4810,25,19,6,288620,28
189,a1307,20130321,4816,4810,4820,4836,4820,4836,4830,26,20,12,579640,28
190,a1307,20130322,4836,4830,4826,4826,4826,4826,4826,-4,-4,4,193040,32
191,a1307,20130325,4826,4826,4924,4924,4710,4860,4847,34,21,94,4556940,28
192,a1307,20130326,4860,4847,4860,4860,4848,4860,4857,13,10,10,485740,32
193,a1307,20130327,4860,4857,4859,4859,4854,4854,4856,-3,-1,4,194260,30
194,a1307,20130328,4854,4856,4860,4884,4860,4884,4880,28,24,12,585600,38
195,a1307,20130329,4884,4880,4718,4855,4718,4855,4786,-25,-94,20,957280,36
196,a1307,20130401,4855,4786,4804,4881,4804,4851,4854,65,68,50,2427420,68
197,a1307,20130402,4851,4854,4854,4881,4849,4856,4860,2,6,28,1360920,88
198,a1307,20130403,4856,4860,4896,4896,4871,4875,4877,15,17,10,487780,88
199,a1307,20130408,4875,4877,4863,4868,4863,4868,4866,-9,-11,16,778680,88
200,a1307,20130409,4868,4866,4910,4910,4890,4903,4905,37,39,18,882900,98
201,a1307,20130410,4903,4905,4923,4939,4912,4930,4921,25,16,52,2559300,126
202,a1307,20130411,4930,4921,4912,4912,4912,4912,4912,-9,-9,2,98240,126
203,a1307,20130412,4912,4912,4936,4936,4912,4929,4930,17,18,32,1577780,142
204,a1307,20130415,4929,4930,4918,4933,4917,4931,4925,1,-5,20,985080,150
205,a1307,20130416,4931,4925,4919,4926,4874,4926,4906,1,-19,6,294380,150
206,a1307,20130417,4926,4906,4953,4953,4931,4933,4938,27,32,10,493880,150
207,a1307,20130418,4933,4938,4940,4940,4940,4940,4940,2,2,18,889200,150
208,a1307,20130419,4940,4940,4948,4981,4939,4939,4950,-1,10,28,1386140,152
209,a1307,20130422,4939,4950,4919,4919,4877,4877,4891,-73,-59,76,3717280,210
210,a1307,20130423,4877,4891,4905,4905,4899,4900,4902,9,11,44,2157200,220
211,a1307,20130424,4900,4902,4897,4897,4877,4877,4884,-25,-18,12,586080,222
212,a1307,20130425,4877,4884,4851,4851,4850,4850,4850,-34,-34,42,2037360,236
213,a1307,20130426,4850,4850,4867,4881,4834,4836,4848,-14,-2,84,4072960,284
214,a1307,20130502,4836,4848,4801,4832,4760,4765,4787,-83,-61,80,3829600,282
215,a1307,20130503,4765,4787,4770,4790,4755,4760,4771,-27,-16,22,1049620,280
216,a1307,20130506,4760,4771,4768,4768,4740,4750,4756,-21,-15,10,475660,280
217,a1307,20130507,4750,4756,4757,4774,4757,4774,4762,18,6,18,857260,274
218,a1307,20130508,4774,4762,4799,4800,4799,4800,4799,38,37,16,767880,290
219,a1307,20130509,4800,4799,4797,4799,4797,4799,4797,0,-2,6,287860,286
220,a1307,20130510,4799,4797,0,0,0,4797,4797,0,0,0,0,286
221,a1307,20130513,4797,4797,4796,4796,4763,4763,4784,-34,-13,30,1435440,286
222,a1307,20130514,4763,4784,4740,4768,4740,4755,4754,-29,-30,8,380380,290
223,a1307,20130515,4755,4754,4769,4781,4769,4781,4774,27,20,74,3533160,346
224,a1307,20130516,4781,4774,4800,4815,4793,4815,4809,41,35,28,1346560,364
225,a1307,20130517,4815,4809,0,0,0,4814,4814,5,5,0,0,364
226,a1307,20130520,4814,4814,4867,4867,4832,4833,4844,19,30,6,290640,366
227,a1307,20130521,4833,4844,4837,4837,4837,4837,4837,-7,-7,4,193480,364
228,a1307,20130522,4837,4837,4826,4855,4826,4850,4846,13,9,12,581540,364
229,a1307,20130523,4850,4846,4851,4875,4851,4858,4856,12,10,18,874100,364
230,a1307,20130524,4858,4856,4860,4871,4855,4865,4867,9,11,28,1362900,364
231,a1307,20130527,4865,4867,4870,4873,4860,4865,4871,-2,4,94,4578820,366
232,a1307,20130528,4865,4871,4869,4880,4869,4879,4873,8,2,10,487360,366
233,a1307,20130529,4879,4873,4866,4866,4845,4845,4859,-28,-14,234,11372020,370
234,a1307,20130530,4845,4859,4840,4840,4840,4840,4840,-19,-19,2,96800,370
235,a1307,20130531,4840,4840,4849,4849,4820,4835,4829,-5,-11,78,3766900,410
236,a1307,20130603,4835,4829,4850,4850,4791,4824,4820,-5,-9,242,11664640,616
237,a1307,20130604,4824,4820,4826,4829,4810,4810,4822,-10,2,222,10706360,776
238,a1307,20130605,4810,4822,4823,4823,4811,4822,4818,0,-4,6,289120,774
239,a1307,20130606,4822,4818,4817,4817,4770,4770,4797,-48,-21,104,4989680,814
240,a1307,20130607,4770,4797,4785,4788,4761,4788,4781,-9,-16,14,669360,814
241,a1307,20130613,4788,4781,0,0,0,4781,4781,0,0,0,0,814
242,a1307,20130614,4781,4781,4768,4768,4767,4767,4767,-14,-14,4,190700,814
243,a1307,20130617,4767,4767,4701,4754,4701,4754,4724,-13,-43,14,661420,818
244,a1307,20130618,4754,4724,4741,4755,4701,4701,4734,-23,10,8,378760,818
245,a1307,20130619,4701,4734,0,0,0,4734,4734,0,0,0,0,818
246,a1307,20130620,4734,4734,4660,4739,4660,4730,4709,-4,-25,6,282580,818
247,a1307,20130621,4730,4709,4735,4735,4651,4651,4692,-58,-17,24,1126280,818
248,a1307,20130624,4651,4692,4610,4610,4610,4610,4610,-82,-82,14,645400,822
249,a1307,20130625,4610,4610,4650,4680,4606,4654,4648,44,38,46,2138200,810
250,a1307,20130626,4654,4648,4740,4740,4650,4650,4708,2,60,38,1789240,816
251,a1307,20130627,4650,4708,4663,4690,4662,4666,4678,-42,-30,22,1029240,824
252,a1307,20130628,4666,4678,4700,4700,4670,4670,4685,-8,7,4,187400,822
253,a1307,20130701,4670,4685,4674,4674,4674,4674,4674,-11,-11,6,280440,822
254,a1307,20130702,4674,4674,0,0,0,4674,4674,0,0,0,0,822
255,a1307,20130703,4674,4674,0,0,0,4674,4674,0,0,0,0,822
256,a1307,20130704,4674,4674,0,0,0,4670,4670,-4,-4,0,0,822
257,a1307,20130705,4670,4670,0,0,0,4670,4670,0,0,0,0,822
258,a1307,20130708,4670,4670,0,0,0,4670,4670,0,0,0,0,822
259,a1307,20130709,4670,4670,0,0,0,4670,4670,0,0,0,0,822
260,a1307,20130710,4670,4670,0,0,0,4670,4670,0,0,0,0,822
261,a1307,20130711,4670,4670,0,0,0,4670,4670,0,0,0,0,808
262,a1307,20130712,4670,4670,0,0,0,4674,4674,4,4,0,0,0
263,a1309,20130104,4757,4766,4739,4773,4715,4761,4752,-5,-14,35660,1694820500,163634
264,a1309,20130107,4761,4752,4747,4792,4742,4746,4763,-6,11,56808,2705857380,168462
265,a1309,20130108,4746,4763,4765,4768,4721,4757,4746,-6,-17,53078,2519198720,169102
266,a1309,20130109,4757,4746,4760,4772,4751,4754,4763,8,17,28634,1363889840,173804
267,a1309,20130110,4754,4763,4762,4769,4754,4763,4762,0,-1,18006,857615740,175302
268,a1309,20130111,4763,4762,4761,4806,4756,4771,4778,9,16,57336,2740031960,178442
269,a1309,20130114,4771,4778,4798,4825,4792,4822,4813,44,35,62106,2989485100,174066
270,a1309,20130115,4822,4813,4840,4847,4803,4812,4818,-1,5,39804,1917903440,168874
271,a1309,20130116,4812,4818,4830,4830,4811,4829,4821,11,3,23672,1141459560,169726
272,a1309,20130117,4829,4821,4835,4846,4806,4809,4826,-12,5,24232,1169437260,166470
273,a1309,20130118,4809,4826,4819,4825,4804,4823,4818,-3,-8,38574,1858652640,168940
274,a1309,20130121,4823,4818,4825,4858,4820,4834,4839,16,21,45960,2224356500,169454
275,a1309,20130122,4834,4839,4820,4839,4820,4833,4830,-6,-9,26976,1302978680,166362
276,a1309,20130123,4833,4830,4835,4836,4817,4821,4823,-9,-7,22948,1106905960,166906
277,a1309,20130124,4821,4823,4804,4814,4779,4784,4791,-39,-32,39874,1910392400,162280
278,a1309,20130125,4784,4791,4791,4812,4785,4786,4796,-5,5,29874,1433027460,161866
279,a1309,20130128,4786,4796,4800,4820,4795,4819,4804,23,8,21646,1040061900,160958
280,a1309,20130129,4819,4804,4815,4825,4805,4812,4813,8,9,20200,972263880,161468
281,a1309,20130130,4812,4813,4810,4850,4810,4837,4831,24,18,27030,1305963200,157106
282,a1309,20130131,4837,4831,4869,4869,4833,4838,4847,7,16,37474,1816547600,155102
283,a1309,20130201,4838,4847,4837,4857,4828,4854,4844,7,-3,39942,1934832860,157210
284,a1309,20130204,4854,4844,4857,4865,4837,4841,4847,-3,3,35242,1708386200,153612
285,a1309,20130205,4841,4847,4848,4848,4829,4833,4839,-14,-8,30106,1456852940,149398
286,a1309,20130206,4833,4839,4835,4846,4833,4835,4838,-4,-1,16170,782384540,145372
287,a1309,20130207,4835,4838,4828,4837,4812,4816,4818,-22,-20,22716,1094560320,136500
288,a1309,20130208,4816,4818,4825,4856,4824,4828,4834,10,16,21334,1031358500,131968
289,a1309,20130218,4828,4834,4800,4800,4753,4782,4778,-52,-56,40458,1933291900,130006
290,a1309,20130219,4782,4778,4780,4794,4777,4783,4783,5,5,34880,1668640100,132440
291,a1309,20130220,4783,4783,4803,4821,4791,4815,4809,32,26,41952,2017873220,132944
292,a1309,20130221,4815,4809,4818,4818,4778,4794,4792,-15,-17,56046,2686121720,137126
293,a1309,20130222,4794,4792,4795,4918,4788,4857,4862,65,70,221904,10790157680,148264
294,a1309,20130225,4857,4862,4808,4829,4769,4797,4800,-65,-62,126796,6087292180,138000
295,a1309,20130226,4797,4800,4790,4835,4738,4739,4785,-61,-15,125062,5985044900,153356
296,a1309,20130227,4739,4785,4752,4785,4715,4725,4739,-60,-46,128232,6077341520,166916
297,a1309,20130228,4725,4739,4756,4757,4724,4724,4738,-15,-1,92528,4384431420,172368
298,a1309,20130301,4724,4738,4734,4755,4721,4748,4740,10,2,82160,3895099780,164032
299,a1309,20130304,4748,4740,4741,4751,4733,4739,4742,-1,2,52156,2473572000,164316
300,a1309,20130305,4739,4742,4758,4781,4755,4765,4768,23,26,56206,2680385180,154762
301,a1309,20130306,4765,4768,4767,4769,4748,4762,4757,-6,-11,41858,1991199240,156206
302,a1309,20130307,4762,4757,4760,4773,4753,4765,4763,8,6,37720,1796847640,157502
303,a1309,20130308,4765,4763,4779,4786,4767,4779,4778,16,15,34334,1640557760,153008
304,a1309,20130311,4779,4778,4780,4783,4757,4758,4767,-20,-11,34140,1627617700,154292
305,a1309,20130312,4758,4767,4766,4769,4722,4724,4735,-43,-32,66554,3151815940,171278
306,a1309,20130313,4724,4735,4728,4740,4689,4733,4715,-2,-20,114716,5409078280,175512
307,a1309,20130314,4733,4715,4701,4721,4690,4716,4706,1,-9,114278,5378740480,186554
308,a1309,20130315,4716,4706,4720,4780,4720,4768,4758,62,52,115142,5479274080,180682
309,a1309,20130318,4768,4758,4730,4738,4711,4730,4727,-28,-31,88988,4207166800,183930
310,a1309,20130319,4730,4727,4748,4748,4719,4735,4728,8,1,66924,3164832540,178598
311,a1309,20130320,4735,4728,4729,4748,4726,4736,4739,8,11,54648,2589834900,165410
312,a1309,20130321,4736,4739,4748,4785,4740,4779,4766,40,27,78274,3730715880,169422
313,a1309,20130322,4779,4766,4790,4820,4767,4806,4798,40,32,139262,6682152980,194292
314,a1309,20130325,4806,4798,4800,4860,4799,4839,4840,41,42,203842,9866218600,222344
315,a1309,20130326,4839,4840,4838,4852,4828,4844,4840,4,0,108360,5245505360,221396
316,a1309,20130327,4844,4840,4850,4851,4805,4820,4823,-20,-17,130156,6278185600,204834
317,a1309,20130328,4820,4823,4826,4850,4805,4817,4826,-6,3,140714,6790857880,201474
318,a1309,20130329,4817,4826,4783,4806,4746,4801,4785,-25,-41,144732,6925903840,194694
319,a1309,20130401,4801,4785,4795,4818,4767,4778,4791,-7,6,120974,5795891720,200624
320,a1309,20130402,4778,4791,4783,4796,4756,4779,4777,-12,-14,82962,3963497300,196614
321,a1309,20130403,4779,4777,4760,4772,4741,4758,4755,-19,-22,90306,4294447720,196434
322,a1309,20130408,4758,4755,4731,4782,4731,4782,4755,27,0,104082,4950052860,205174
323,a1309,20130409,4782,4755,4782,4797,4770,4780,4783,25,28,68790,3290579860,209890
324,a1309,20130410,4780,4783,4790,4817,4783,4814,4799,31,16,89534,4297518020,212822
325,a1309,20130411,4814,4799,4802,4824,4802,4813,4811,14,12,93290,4488592180,224366
326,a1309,20130412,4813,4811,4819,4823,4797,4817,4809,6,-2,65084,3130335740,213208
327,a1309,20130415,4817,4809,4806,4807,4774,4795,4790,-14,-19,94890,4545408280,220582
328,a1309,20130416,4795,4790,4765,4818,4761,4801,4793,11,3,144506,6926682800,229842
329,a1309,20130417,4801,4793,4805,4822,4794,4803,4808,10,15,105134,5055206820,217382
330,a1309,20130418,4803,4808,4793,4818,4785,4808,4803,0,-5,81650,3921920020,216504
331,a1309,20130419,4808,4803,4815,4830,4794,4796,4812,-7,9,80360,3867435700,215208
332,a1309,20130422,4796,4812,4780,4796,4770,4779,4782,-33,-30,101228,4840916760,227746
333,a1309,20130423,4779,4782,4780,4795,4770,4794,4786,12,4,113908,5452475620,231544
334,a1309,20130424,4794,4786,4790,4793,4741,4748,4761,-38,-25,222762,10605699780,254398
335,a1309,20130425,4748,4761,4740,4765,4732,4741,4748,-20,-13,130796,6210447100,249480
336,a1309,20130426,4741,4748,4778,4778,4750,4767,4765,19,17,117592,5603726240,223664
337,a1309,20130502,4767,4765,4749,4770,4735,4768,4756,3,-9,76140,3621841300,224066
338,a1309,20130503,4768,4756,4768,4780,4763,4777,4772,21,16,46058,2198092780,220530
339,a1309,20130506,4777,4772,4775,4799,4771,4798,4787,26,15,75162,3598667860,219724
340,a1309,20130507,4798,4787,4780,4788,4775,4776,4782,-11,-5,45546,2178379380,217936
341,a1309,20130508,4776,4782,4780,4796,4778,4790,4789,8,7,40162,1923757160,212642
342,a1309,20130509,4790,4789,4785,4794,4779,4781,4786,-8,-3,32162,1539304540,209440
343,a1309,20130510,4781,4786,4786,4808,4782,4794,4790,8,4,48996,2347285920,202796
344,a1309,20130513,4794,4790,4785,4795,4766,4767,4779,-23,-11,42914,2051026120,205806
345,a1309,20130514,4767,4779,4780,4787,4769,4774,4778,-5,-1,45204,2160144480,204906
346,a1309,20130515,4774,4778,4775,4777,4761,4774,4770,-4,-8,32130,1532759480,206658
347,a1309,20130516,4774,4770,4770,4790,4765,4789,4781,19,11,64780,3097634640,197282
348,a1309,20130517,4789,4781,4799,4800,4787,4798,4795,17,14,47510,2278458260,186294
349,a1309,20130520,4798,4795,4801,4830,4801,4815,4818,20,23,52596,2534141860,183494
350,a1309,20130521,4815,4818,4816,4830,4802,4816,4818,-2,0,30584,1473592540,183814
351,a1309,20130522,4816,4818,4816,4827,4812,4826,4820,8,2,20998,1012272380,181086
352,a1309,20130523,4826,4820,4840,4840,4801,4807,4823,-13,3,36382,1754877720,176510
353,a1309,20130524,4807,4823,4780,4810,4780,4801,4801,-22,-22,35716,1714810440,178226
354,a1309,20130527,4801,4801,4793,4804,4790,4800,4797,-1,-4,9918,475862400,177022
355,a1309,20130528,4800,4797,4800,4809,4797,4809,4801,12,4,9444,453499140,174050
356,a1309,20130529,4809,4801,4811,4830,4801,4808,4819,7,18,40716,1962348880,154740
357,a1309,20130530,4808,4819,4819,4819,4795,4799,4800,-20,-19,32732,1571282700,148450
358,a1309,20130531,4799,4800,4800,4812,4796,4809,4805,9,5,16880,811234560,147432
359,a1309,20130603,4809,4805,4820,4839,4808,4836,4825,31,20,42398,2046042160,131844
360,a1309,20130604,4836,4825,4837,4838,4821,4828,4827,3,2,12980,626587800,130390
361,a1309,20130605,4828,4827,4837,4849,4829,4830,4836,3,9,25144,1215969560,126312
362,a1309,20130606,4830,4836,4820,4829,4809,4820,4819,-16,-17,15710,757088060,117800
363,a1309,20130607,4820,4819,4820,4826,4800,4811,4808,-8,-11,18636,896141920,106566
364,a1309,20130613,4811,4808,4819,4822,4795,4795,4803,-13,-5,11466,550722920,102806
365,a1309,20130614,4795,4803,4794,4800,4786,4799,4793,-4,-10,10552,505783880,100192
366,a1309,20130617,4799,4793,4790,4795,4780,4787,4787,-6,-6,11200,536189860,97682
367,a1309,20130618,4787,4787,4787,4800,4787,4789,4794,2,7,5572,267155300,95928
368,a1309,20130619,4789,4794,4783,4797,4782,4792,4794,-2,0,8674,415845380,92556
369,a1309,20130620,4792,4794,4797,4799,4786,4795,4794,1,0,8900,426689840,89524
370,a1309,20130621,4795,4794,4781,4790,4765,4771,4777,-23,-17,24580,1174311300,80130
371,a1309,20130624,4771,4777,4760,4777,4756,4762,4765,-15,-12,7816,372434280,77864
372,a1309,20130625,4762,4765,4781,4791,4770,4791,4782,26,17,10978,525006600,72696
373,a1309,20130626,4791,4782,4792,4796,4781,4788,4789,6,7,5964,285623880,70858
374,a1309,20130627,4788,4789,4788,4800,4781,4791,4789,2,0,9268,443925340,67044
375,a1309,20130628,4791,4789,4789,4792,4784,4789,4789,0,0,5938,284378380,64086
376,a1309,20130701,4789,4789,4777,4779,4763,4765,4770,-24,-19,12876,614309060,55710
377,a1309,20130702,4765,4770,4760,4786,4750,4779,4773,9,3,4850,231506520,53546
378,a1309,20130703,4779,4773,4783,4790,4780,4784,4786,11,13,4446,212808720,51648
379,a1309,20130704,4784,4786,4788,4793,4782,4783,4788,-3,2,5360,256683640,48814
380,a1309,20130705,4783,4788,4783,4792,4782,4784,4786,-4,-2,3332,159489640,47562
381,a1309,20130708,4784,4786,4777,4780,4769,4772,4773,-14,-13,4114,196385000,45516
382,a1309,20130709,4772,4773,4783,4800,4783,4791,4791,18,18,4370,209369040,43714
383,a1309,20130710,4791,4791,4788,4805,4782,4784,4789,-7,-2,3794,181725440,41838
384,a1309,20130711,4784,4789,4792,4795,4785,4788,4789,-1,0,4310,206424040,40118
385,a1309,20130712,4788,4789,4790,4797,4785,4786,4791,-3,2,3626,173725800,38896
386,a1309,20130715,4786,4791,4771,4778,4759,4778,4773,-13,-18,2326,111034420,37968
387,a1309,20130716,4778,4773,4786,4795,4778,4786,4784,13,11,3716,177800140,35768
388,a1309,20130717,4786,4784,4791,4797,4788,4791,4791,7,7,3920,187843760,34404
389,a1309,20130718,4791,4791,4785,4790,4781,4782,4785,-9,-6,1848,88428260,33838
390,a1309,20130719,4782,4785,4781,4787,4770,4774,4776,-11,-9,3392,162032940,33328
391,a1309,20130722,4774,4776,4776,4784,4768,4780,4774,4,-2,3666,175023060,32590
392,a1309,20130723,4780,4774,4789,4794,4772,4780,4779,6,5,3240,154846240,30600
393,a1309,20130724,4780,4779,4768,4768,4739,4748,4750,-31,-29,7018,333394940,30230
394,a1309,20130725,4748,4750,4720,4724,4570,4574,4642,-176,-108,33308,1546301360,25164
395,a1309,20130726,4574,4642,4500,4572,4458,4480,4512,-162,-130,30092,1357834440,20486
396,a1309,20130729,4480,4512,4495,4539,4476,4520,4509,8,-3,9396,423674160,18452
397,a1309,20130730,4520,4509,4534,4602,4518,4580,4567,71,58,6472,295603980,18096
398,a1309,20130731,4580,4567,4552,4640,4547,4612,4604,45,37,8910,410252240,17532
399,a1309,20130801,4612,4604,4601,4608,4570,4570,4583,-34,-21,3236,148313560,16524
400,a1309,20130802,4570,4583,4550,4580,4546,4563,4564,-20,-19,1620,73951920,16154
401,a1309,20130805,4563,4564,4540,4576,4540,4559,4558,-5,-6,1446,65909740,15688
402,a1309,20130806,4559,4558,4559,4576,4541,4544,4554,-14,-4,1564,71227040,14612
403,a1309,20130807,4544,4554,4500,4520,4470,4475,4488,-79,-66,2366,106208820,14656
404,a1309,20130808,4475,4488,4478,4540,4473,4529,4523,41,35,1014,45869520,14418
405,a1309,20130809,4529,4523,4533,4555,4533,4545,4549,22,26,1142,51949740,13952
406,a1309,20130812,4545,4549,4568,4568,4538,4551,4554,2,5,1472,67046500,12952
407,a1309,20130813,4551,4554,4596,4600,4582,4590,4591,36,37,1966,90277920,11756
408,a1309,20130814,4590,4591,4590,4594,4542,4548,4571,-43,-20,1666,76165980,10658
409,a1309,20130815,4548,4571,4576,4580,4541,4547,4560,-24,-11,636,29006740,10374
410,a1309,20130816,4547,4560,4581,4595,4554,4557,4575,-3,15,868,39713520,9836
411,a1309,20130819,4557,4575,4599,4600,4525,4532,4557,-43,-18,518,23608200,9498
412,a1309,20130820,4532,4557,4580,4580,4501,4506,4529,-51,-28,692,31344920,9022
413,a1309,20130821,4506,4529,4489,4513,4466,4467,4481,-62,-48,1060,47500120,8322
414,a1309,20130822,4467,4481,4470,4470,4405,4405,4423,-76,-58,1310,57950680,7786
415,a1309,20130823,4405,4423,4400,4426,4379,4382,4395,-41,-28,1130,49666980,6860
416,a1309,20130826,4382,4395,4441,4457,4357,4449,4424,54,29,3518,155666880,5082
417,a1309,20130827,4449,4424,4440,4442,4398,4429,4419,5,-5,1936,85561060,3744
418,a1309,20130828,4429,4419,4400,4423,4396,4396,4414,-23,-5,726,32052780,3344
419,a1309,20130829,4396,4414,4396,4403,4358,4386,4380,-28,-34,1504,65879220,2144
420,a1309,20130830,4386,4380,4366,4366,4321,4346,4332,-34,-48,2016,87340660,1180
421,a1309,20130902,4346,4332,4321,4321,4321,4321,4321,-11,-11,6,259260,968
422,a1309,20130903,4321,4321,4330,4359,4330,4346,4346,25,25,140,6084740,868
423,a1309,20130904,4346,4346,0,0,0,4346,4346,0,0,0,0,868
424,a1309,20130905,4346,4346,0,0,0,4346,4346,0,0,0,0,868
425,a1309,20130906,4346,4346,4346,4346,4346,4346,4346,0,0,2,86920,868
426,a1309,20130909,4346,4346,4398,4398,4398,4398,4398,52,52,2,87960,826
427,a1309,20130910,4398,4398,0,0,0,4397,4397,-1,-1,4,175920,826
428,a1309,20130911,4397,4397,0,0,0,4397,4397,0,0,0,0,826
429,a1309,20130912,4397,4397,0,0,0,4397,4397,0,0,14,617180,826
430,a1309,20130913,4397,4397,4443,4443,4443,4443,4353,46,-44,2,88860,0
431,a1311,20130104,4745,4745,4712,4731,4712,4731,4721,-14,-24,4,188860,24
432,a1311,20130107,4731,4721,4756,4756,4756,4756,4756,35,35,6,285360,28
433,a1311,20130108,4756,4756,4758,4758,4739,4739,4748,-17,-8,4,189940,28
434,a1311,20130109,4739,4748,4770,4770,4770,4770,4770,22,22,4,190800,28
435,a1311,20130110,4770,4770,4745,4767,4745,4767,4756,-3,-14,4,190240,26
436,a1311,20130111,4767,4756,0,0,0,4756,4756,0,0,0,0,26
437,a1311,20130114,4756,4756,0,0,0,4756,4756,0,0,0,0,26
438,a1311,20130115,4756,4756,4823,4823,4823,4823,4823,67,67,2,96460,28
439,a1311,20130116,4823,4823,4811,4811,4811,4811,4811,-12,-12,2,96220,26
440,a1311,20130117,4811,4811,4811,4811,4810,4810,4810,-1,-1,4,192420,26
441,a1311,20130118,4810,4810,0,0,0,4810,4810,0,0,0,0,26
442,a1311,20130121,4810,4810,0,0,0,4810,4810,0,0,0,0,26
443,a1311,20130122,4810,4810,0,0,0,4810,4810,0,0,0,0,26
444,a1311,20130123,4810,4810,4827,4827,4810,4810,4814,0,4,10,481440,30
445,a1311,20130124,4810,4814,0,0,0,4814,4814,0,0,0,0,30
446,a1311,20130125,4814,4814,0,0,0,4814,4814,0,0,0,0,30
447,a1311,20130128,4814,4814,0,0,0,4814,4814,0,0,0,0,30
448,a1311,20130129,4814,4814,0,0,0,4814,4814,0,0,0,0,30
449,a1311,20130130,4814,4814,4797,4797,4797,4797,4797,-17,-17,2,95940,32
450,a1311,20130131,4797,4797,4809,4809,4792,4800,4802,3,5,14,672340,24
451,a1311,20130201,4800,4802,0,0,0,4802,4802,0,0,0,0,24
452,a1311,20130204,4802,4802,0,0,0,4802,4802,0,0,0,0,24
453,a1311,20130205,4802,4802,4808,4808,4791,4791,4804,-11,2,10,480460,24
454,a1311,20130206,4791,4804,0,0,0,4804,4804,0,0,0,0,24
455,a1311,20130207,4804,4804,0,0,0,4804,4804,0,0,0,0,24
456,a1311,20130208,4804,4804,4813,4813,4813,4813,4813,9,9,2,96260,24
457,a1311,20130218,4813,4813,4750,4750,4750,4750,4750,-63,-63,6,285000,22
458,a1311,20130219,4750,4750,0,0,0,4750,4750,0,0,0,0,22
459,a1311,20130220,4750,4750,4782,4787,4765,4787,4777,37,27,8,382200,22
460,a1311,20130221,4787,4777,0,0,0,4777,4777,0,0,0,0,22
461,a1311,20130222,4777,4777,4787,4839,4787,4824,4820,47,43,22,1060440,40
462,a1311,20130225,4824,4820,4772,4795,4743,4767,4768,-53,-52,350,16688920,196
463,a1311,20130226,4767,4768,4772,4772,4740,4740,4750,-28,-18,18,855060,194
464,a1311,20130227,4740,4750,4740,4740,4718,4718,4724,-32,-26,18,850360,200
465,a1311,20130228,4718,4724,4713,4713,4713,4713,4713,-11,-11,2,94260,200
466,a1311,20130301,4713,4713,0,0,0,4713,4713,0,0,0,0,200
467,a1311,20130304,4713,4713,0,0,0,4713,4713,0,0,0,0,200
468,a1311,20130305,4713,4713,4736,4736,4736,4736,4736,23,23,2,94720,198
469,a1311,20130306,4736,4736,4719,4730,4719,4730,4724,-6,-12,4,188980,200
470,a1311,20130307,4730,4724,0,0,0,4724,4724,0,0,0,0,200
471,a1311,20130308,4724,4724,4747,4749,4747,4749,4748,25,24,14,664820,190
472,a1311,20130311,4749,4748,0,0,0,4748,4748,0,0,0,0,190
473,a1311,20130312,4748,4748,4724,4724,4709,4709,4714,-39,-34,6,282840,190
474,a1311,20130313,4709,4714,4680,4697,4680,4697,4688,-17,-26,16,750160,190
475,a1311,20130314,4697,4688,4684,4700,4666,4666,4688,-22,0,16,750180,186
476,a1311,20130315,4666,4688,4728,4729,4728,4729,4728,41,40,10,472860,186
477,a1311,20130318,4729,4728,4701,4705,4701,4705,4704,-23,-24,10,470420,180
478,a1311,20130319,4705,4704,4706,4706,4705,4705,4705,1,1,4,188220,182
479,a1311,20130320,4705,4705,4705,4719,4661,4712,4708,7,3,32,1506760,188
480,a1311,20130321,4712,4708,4712,4741,4712,4741,4726,33,18,18,850840,176
481,a1311,20130322,4741,4726,4768,4771,4768,4771,4769,45,43,8,381580,172
482,a1311,20130325,4771,4769,4802,4802,4786,4786,4794,17,25,16,767140,174
483,a1311,20130326,4786,4794,4785,4787,4780,4787,4783,-7,-11,10,478380,172
484,a1311,20130327,4787,4783,4775,4775,4757,4757,4763,-26,-20,6,285780,170
485,a1311,20130328,4757,4763,4765,4816,4760,4765,4783,2,20,58,2774260,162
486,a1311,20130329,4765,4783,4699,4739,4699,4737,4732,-46,-51,14,662480,164
487,a1311,20130401,4737,4732,4745,4745,4736,4736,4740,4,8,4,189620,160
488,a1311,20130402,4736,4740,4730,4733,4711,4711,4723,-29,-17,12,566800,154
489,a1311,20130403,4711,4723,4712,4712,4695,4706,4700,-17,-23,52,2444360,156
490,a1311,20130408,4706,4700,4698,4712,4698,4712,4704,12,4,12,564480,148
491,a1311,20130409,4712,4704,4720,4725,4714,4715,4717,11,13,20,943480,134
492,a1311,20130410,4715,4717,4737,4737,4737,4737,4737,20,20,2,94740,134
493,a1311,20130411,4737,4737,4731,4731,4731,4731,4731,-6,-6,2,94620,134
494,a1311,20130412,4731,4731,0,0,0,4731,4731,0,0,0,0,134
495,a1311,20130415,4731,4731,0,0,0,4713,4713,-18,-18,0,0,134
496,a1311,20130416,4713,4713,4689,4721,4689,4721,4700,8,-13,10,470060,134
497,a1311,20130417,4721,4700,4738,4738,4738,4738,4738,38,38,2,94760,132
498,a1311,20130418,4738,4738,4728,4736,4728,4735,4731,-3,-7,12,567800,130
499,a1311,20130419,4735,4731,4734,4734,4727,4727,4730,-4,-1,4,189220,128
500,a1311,20130422,4727,4730,4715,4715,4705,4711,4710,-19,-20,24,1130440,124
501,a1311,20130423,4711,4710,4707,4713,4707,4713,4708,3,-2,8,376680,122
502,a1311,20130424,4713,4708,4671,4672,4666,4670,4669,-38,-39,30,1400980,122
503,a1311,20130425,4670,4669,4672,4672,4672,4672,4672,3,3,2,93440,122
504,a1311,20130426,4672,4672,4669,4669,4669,4669,4669,-3,-3,2,93380,122
505,a1311,20130502,4669,4669,4653,4676,4653,4663,4661,-6,-8,8,372900,122
506,a1311,20130503,4663,4661,4671,4671,4670,4670,4670,9,9,4,186820,122
507,a1311,20130506,4670,4670,4676,4720,4676,4700,4690,30,20,12,562900,122
508,a1311,20130507,4700,4690,4693,4708,4692,4692,4696,2,6,8,375720,120
509,a1311,20130508,4692,4696,4698,4705,4698,4705,4701,9,5,4,188060,120
510,a1311,20130509,4705,4701,4727,4727,4714,4714,4720,13,19,60,2832400,154
511,a1311,20130510,4714,4720,4728,4728,4719,4719,4723,-1,3,4,188940,154
512,a1311,20130513,4719,4723,4721,4721,4707,4707,4716,-16,-7,14,660280,150
513,a1311,20130514,4707,4716,4710,4715,4710,4715,4714,-1,-2,12,565680,142
514,a1311,20130515,4715,4714,4715,4715,4705,4705,4710,-9,-4,22,1036320,154
515,a1311,20130516,4705,4710,0,0,0,4710,4710,0,0,0,0,154
516,a1311,20130517,4710,4710,4710,4732,4710,4732,4721,22,11,4,188840,154
517,a1311,20130520,4732,4721,4772,4773,4755,4755,4761,34,40,24,1142640,164
518,a1311,20130521,4755,4761,4770,4770,4748,4748,4761,-13,0,16,761760,176
519,a1311,20130522,4748,4761,0,0,0,4761,4761,0,0,0,0,176
520,a1311,20130523,4761,4761,0,0,0,4761,4761,0,0,0,0,176
521,a1311,20130524,4761,4761,4782,4782,4733,4756,4757,-5,-4,14,666080,174
522,a1311,20130527,4756,4757,4760,4760,4760,4760,4760,3,3,4,190400,174
523,a1311,20130528,4760,4760,0,0,0,4760,4760,0,0,0,0,174
524,a1311,20130529,4760,4760,0,0,0,4760,4760,0,0,0,0,174
525,a1311,20130530,4760,4760,4741,4764,4741,4754,4757,-6,-3,26,1236960,196
526,a1311,20130531,4754,4757,4803,4803,4803,4803,4803,46,46,6,288180,202
527,a1311,20130603,4803,4803,4800,4800,4780,4790,4786,-13,-17,10,478600,202
528,a1311,20130604,4790,4786,4816,4816,4783,4805,4796,19,10,32,1535000,196
529,a1311,20130605,4805,4796,4807,4807,4804,4804,4805,8,9,4,192220,196
530,a1311,20130606,4804,4805,0,0,0,4805,4805,0,0,0,0,196
531,a1311,20130607,4805,4805,0,0,0,4805,4805,0,0,0,0,196
532,a1311,20130613,4805,4805,4782,4783,4782,4783,4782,-22,-23,4,191300,196
533,a1311,20130614,4783,4782,0,0,0,4782,4782,0,0,0,0,196
534,a1311,20130617,4782,4782,4793,4793,4773,4773,4783,-9,1,4,191320,198
535,a1311,20130618,4773,4783,0,0,0,4783,4783,0,0,0,0,198
536,a1311,20130619,4783,4783,4786,4787,4777,4777,4784,-6,1,8,382720,194
537,a1311,20130620,4777,4784,4781,4781,4774,4774,4775,-10,-9,8,382060,194
538,a1311,20130621,4774,4775,4767,4767,4759,4759,4761,-16,-14,6,285700,194
539,a1311,20130624,4759,4761,0,0,0,4761,4761,0,0,0,0,194
540,a1311,20130625,4761,4761,4771,4795,4771,4791,4790,30,29,22,1053800,194
541,a1311,20130626,4791,4790,0,0,0,4790,4790,0,0,0,0,194
542,a1311,20130627,4790,4790,4796,4796,4796,4796,4796,6,6,2,95920,194
543,a1311,20130628,4796,4796,4780,4785,4780,4785,4782,-11,-14,8,382620,196
544,a1311,20130701,4785,4782,4755,4763,4755,4763,4758,-19,-24,14,666240,196
545,a1311,20130702,4763,4758,4772,4774,4768,4768,4769,10,11,14,667720,198
546,a1311,20130703,4768,4769,4776,4776,4774,4774,4775,5,6,4,191000,198
547,a1311,20130704,4774,4775,4789,4789,4789,4789,4789,14,14,2,95780,198
548,a1311,20130705,4789,4789,0,0,0,4789,4789,0,0,0,0,198
549,a1311,20130708,4789,4789,4770,4779,4770,4779,4774,-10,-15,4,190980,196
550,a1311,20130709,4779,4774,4800,4800,4797,4798,4798,24,24,10,479860,198
551,a1311,20130710,4798,4798,4786,4817,4712,4800,4785,2,-13,248,11868160,288
552,a1311,20130711,4800,4785,0,0,0,4789,4789,4,4,0,0,288
553,a1311,20130712,4789,4789,4815,4815,4801,4801,4808,12,19,4,192320,290
554,a1311,20130715,4801,4808,4792,4793,4787,4787,4790,-21,-18,22,1053980,282
555,a1311,20130716,4787,4790,4795,4804,4793,4803,4798,13,8,86,4126820,244
556,a1311,20130717,4803,4798,4795,4825,4795,4806,4808,8,10,8,384640,244
557,a1311,20130718,4806,4808,4805,4805,4799,4799,4800,-9,-8,20,960000,232
558,a1311,20130719,4799,4800,4809,4809,4799,4799,4804,-1,4,4,192160,232
559,a1311,20130722,4799,4804,0,0,0,4804,4804,0,0,0,0,232
560,a1311,20130723,4804,4804,4808,4808,4806,4806,4807,2,3,6,288420,232
561,a1311,20130724,4806,4807,4798,4798,4790,4793,4795,-14,-12,56,2685440,194
562,a1311,20130725,4793,4795,4783,4785,4668,4669,4729,-126,-66,182,8608280,170
563,a1311,20130726,4669,4729,4597,4639,4540,4540,4575,-189,-154,196,8968360,150
564,a1311,20130729,4540,4575,4510,4530,4451,4480,4490,-95,-85,324,14547960,142
565,a1311,20130730,4480,4490,4478,4478,4460,4473,4470,-17,-20,78,3487060,138
566,a1311,20130731,4473,4470,4480,4539,4480,4495,4499,25,29,58,2609680,164
567,a1311,20130801,4495,4499,4495,4520,4460,4519,4501,20,2,36,1620420,156
568,a1311,20130802,4519,4501,4613,4613,4525,4558,4547,57,46,94,4274460,140
569,a1311,20130805,4558,4547,4516,4547,4516,4544,4541,-3,-6,20,908340,132
570,a1311,20130806,4544,4541,4549,4549,4511,4511,4543,-30,2,14,636020,134
571,a1311,20130807,4511,4543,4505,4520,4459,4459,4481,-84,-62,176,7887460,130
572,a1311,20130808,4459,4481,4501,4501,4501,4501,4501,20,20,2,90020,128
573,a1311,20130809,4501,4501,4629,4629,4475,4534,4518,33,17,16,722960,124
574,a1311,20130812,4534,4518,0,0,0,4518,4518,0,0,0,0,124
575,a1311,20130813,4518,4518,4605,4605,4548,4560,4572,42,54,16,731600,118
576,a1311,20130814,4560,4572,4547,4569,4547,4562,4559,-10,-13,6,273560,118
577,a1311,20130815,4562,4559,4581,4581,4525,4525,4532,-34,-27,54,2447680,108
578,a1311,20130816,4525,4532,4538,4560,4525,4526,4535,-6,3,42,1904900,76
579,a1311,20130819,4526,4535,4502,4571,4502,4517,4520,-18,-15,28,1265720,64
580,a1311,20130820,4517,4520,4507,4547,4462,4519,4507,-1,-13,28,1262220,58
581,a1311,20130821,4519,4507,4520,4520,4485,4485,4508,-22,1,6,270500,60
582,a1311,20130822,4485,4508,0,0,0,4508,4508,0,0,0,0,60
583,a1311,20130823,4508,4508,4455,4455,4455,4455,4455,-53,-53,4,178200,60
584,a1311,20130826,4455,4455,4548,4549,4548,4549,4548,94,93,8,363880,62
585,a1311,20130827,4549,4548,4501,4501,4501,4501,4501,-47,-47,2,90020,62
586,a1311,20130828,4501,4501,0,0,0,4501,4501,0,0,0,0,62
587,a1311,20130829,4501,4501,4485,4485,4485,4485,4485,-16,-16,2,89700,64
588,a1311,20130830,4485,4485,4406,4499,4400,4400,4440,-85,-45,10,444060,64
589,a1311,20130902,4400,4440,4503,4504,4460,4483,4489,43,49,22,987740,64
590,a1311,20130903,4483,4489,4482,4482,4481,4481,4481,-8,-8,6,268880,64
591,a1311,20130904,4481,4481,4431,4435,4431,4435,4433,-46,-48,4,177320,60
592,a1311,20130905,4435,4433,4473,4473,4440,4445,4448,12,15,24,1067660,68
593,a1311,20130906,4445,4448,0,0,0,4452,4452,4,4,0,0,68
594,a1311,20130909,4452,4452,4460,4470,4460,4470,4466,18,14,12,535940,68
595,a1311,20130910,4470,4466,4445,4469,4445,4469,4451,3,-15,16,712160,72
596,a1311,20130911,4469,4451,4510,4510,4510,4510,4510,59,59,2,90200,74
597,a1311,20130912,4510,4510,0,0,0,4510,4510,0,0,0,0,74
598,a1311,20130913,4510,4510,4512,4548,4509,4544,4521,34,11,32,1446720,60
599,a1311,20130916,4544,4521,4461,4499,4461,4499,4480,-22,-41,4,179200,58
600,a1311,20130917,4499,4480,4471,4471,4471,4471,4471,-9,-9,4,178840,58
601,a1311,20130918,4471,4471,4484,4502,4484,4493,4492,22,21,12,539080,54
602,a1311,20130923,4493,4492,4441,4495,4408,4490,4474,-2,-18,30,1342460,54
603,a1311,20130924,4490,4474,4495,4505,4495,4500,4500,26,26,8,360060,58
604,a1311,20130925,4500,4500,0,0,0,4505,4505,5,5,0,0,58
605,a1311,20130926,4505,4505,4511,4512,4511,4512,4511,7,6,8,360920,54
606,a1311,20130927,4512,4511,4576,4576,4525,4525,4550,14,39,4,182020,52
607,a1311,20130930,4525,4550,4545,4559,4539,4550,4548,0,-2,14,636800,50
608,a1311,20131008,4550,4548,4560,4567,4552,4567,4562,19,14,18,821280,40
609,a1311,20131009,4567,4562,0,0,0,4564,4564,2,2,0,0,40
610,a1311,20131010,4564,4564,4610,4637,4565,4634,4601,70,37,30,1380520,38
611,a1311,20131011,4634,4601,4625,4625,4625,4625,4625,24,24,2,92500,38
612,a1311,20131014,4625,4625,4620,4620,4620,4620,4620,-5,-5,12,554400,50
613,a1311,20131015,4620,4620,4601,4601,4580,4580,4592,-40,-28,26,1194060,68
614,a1311,20131016,4580,4592,4592,4592,4581,4581,4586,-11,-6,4,183460,66
615,a1311,20131017,4581,4586,4587,4587,4525,4555,4560,-31,-26,10,456020,68
616,a1311,20131018,4555,4560,4558,4559,4547,4547,4553,-13,-7,8,364240,68
617,a1311,20131021,4547,4553,4555,4555,4540,4542,4548,-11,-5,22,1000700,50
618,a1311,20131022,4542,4548,4547,4547,4489,4534,4512,-14,-36,12,541440,46
619,a1311,20131023,4534,4512,4548,4560,4495,4500,4515,-12,3,26,1174000,54
620,a1311,20131024,4500,4515,4421,4518,4421,4490,4478,-25,-37,22,985260,48
621,a1311,20131025,4490,4478,4466,4500,4466,4500,4483,22,5,8,358640,48
622,a1311,20131028,4500,4483,4537,4537,4427,4427,4461,-56,-22,20,892320,46
623,a1311,20131029,4427,4461,4334,4413,4334,4400,4397,-61,-64,14,615680,44
624,a1311,20131030,4400,4397,0,0,0,4397,4397,0,0,0,0,44
625,a1311,20131031,4397,4397,4407,4407,4320,4320,4334,-77,-63,12,520140,42
626,a1311,20131101,4320,4334,4594,4594,4594,4594,4594,260,260,2,91880,42
627,a1311,20131104,4594,4594,0,0,0,4450,4450,-144,-144,0,0,42
628,a1311,20131105,4450,4450,4459,4459,4459,4459,4459,9,9,2,89180,12
629,a1311,20131106,4459,4459,0,0,0,4450,4450,-9,-9,0,0,12
630,a1311,20131107,4450,4450,0,0,0,4450,4450,0,0,0,0,12
631,a1311,20131108,4450,4450,0,0,0,4450,4450,0,0,0,0,12
632,a1311,20131111,4450,4450,0,0,0,4450,4450,0,0,0,0,12
633,a1311,20131112,4450,4450,0,0,0,4450,4450,0,0,0,0,12
634,a1311,20131113,4450,4450,4419,4419,4419,4419,4419,-31,-31,12,530280,0
635,a1311,20131114,4419,4419,0,0,0,4445,4445,26,26,0,0,0
636,a1401,20130104,4746,4746,4740,4768,4725,4765,4748,19,2,7914,375778960,38458
637,a1401,20130107,4765,4748,4748,4789,4748,4765,4776,17,28,5354,255745480,39418
638,a1401,20130108,4765,4776,4776,4784,4750,4780,4769,4,-7,5754,274460640,40462
639,a1401,20130109,4780,4769,4775,4789,4772,4773,4780,4,11,2092,100007220,41126
640,a1401,20130110,4773,4780,4772,4780,4762,4767,4773,-13,-7,908,43339260,41052
641,a1401,20130111,4767,4773,4760,4791,4755,4769,4772,-4,-1,1884,89916500,41416
642,a1401,20130114,4769,4772,4788,4805,4788,4801,4798,29,26,2940,141087040,42618
643,a1401,20130115,4801,4798,4815,4820,4791,4800,4804,2,6,1534,73700940,42770
644,a1401,20130116,4800,4804,4805,4820,4800,4818,4810,14,6,1578,75902900,42838
645,a1401,20130117,4818,4810,4825,4827,4812,4812,4816,2,6,1266,60980760,42956
646,a1401,20130118,4812,4816,4807,4819,4802,4809,4808,-7,-8,2820,135608480,44028
647,a1401,20130121,4809,4808,4808,4834,4807,4818,4821,10,13,1920,92577600,44126
648,a1401,20130122,4818,4821,4818,4828,4798,4819,4814,-2,-7,2160,103985180,44598
649,a1401,20130123,4819,4814,4821,4821,4802,4806,4809,-8,-5,1458,70116640,44354
650,a1401,20130124,4806,4809,4800,4803,4766,4770,4778,-39,-31,5930,283361760,43480
651,a1401,20130125,4770,4778,4750,4791,4750,4771,4779,-7,1,1976,94439020,43258
652,a1401,20130128,4771,4779,4781,4790,4775,4789,4785,10,6,1618,77425220,43844
653,a1401,20130129,4789,4785,4789,4799,4770,4775,4777,-10,-8,2516,120209720,43234
654,a1401,20130130,4775,4777,4778,4791,4777,4786,4782,9,5,4050,193671080,44382
655,a1401,20130131,4786,4782,4800,4803,4787,4789,4793,7,11,4142,198530860,46406
656,a1401,20130201,4789,4793,4790,4801,4782,4790,4792,-3,-1,3886,186235260,47004
657,a1401,20130204,4790,4792,4800,4801,4784,4787,4792,-5,0,2356,112908020,46750
658,a1401,20130205,4787,4792,4790,4790,4778,4783,4785,-9,-7,1340,64126000,46726
659,a1401,20130206,4783,4785,4784,4788,4778,4778,4784,-7,-1,844,40377820,46774
660,a1401,20130207,4778,4784,4771,4778,4759,4763,4766,-21,-18,2188,104284300,46370
661,a1401,20130208,4763,4766,4759,4778,4759,4763,4768,-3,2,2126,101371440,45952
662,a1401,20130218,4763,4768,4736,4748,4725,4729,4733,-39,-35,6632,313955300,48842
663,a1401,20130219,4729,4733,4731,4739,4730,4737,4735,4,2,7598,359773060,52480
664,a1401,20130220,4737,4735,4746,4753,4740,4748,4745,13,10,3778,179271380,52772
665,a1401,20130221,4748,4745,4740,4745,4721,4728,4729,-17,-16,7276,344140640,53930
666,a1401,20130222,4728,4729,4735,4799,4725,4749,4753,20,24,11804,561086080,54388
667,a1401,20130225,4749,4753,4735,4735,4680,4713,4712,-40,-41,8978,423125000,56472
668,a1401,20130226,4713,4712,4706,4727,4703,4703,4715,-9,3,11634,548594540,59680
669,a1401,20130227,4703,4715,4713,4724,4699,4704,4709,-11,-6,14072,662739740,65348
670,a1401,20130228,4704,4709,4710,4719,4697,4701,4708,-8,-1,10324,486069820,66980
671,a1401,20130301,4701,4708,4710,4713,4694,4704,4702,-4,-6,6764,318062360,65762
672,a1401,20130304,4704,4702,4701,4707,4692,4693,4698,-9,-4,3608,169523960,66724
673,a1401,20130305,4693,4698,4699,4710,4699,4705,4706,7,8,6018,283208460,66592
674,a1401,20130306,4705,4706,4706,4714,4702,4709,4707,3,1,5786,272398480,68876
675,a1401,20130307,4709,4707,4708,4720,4705,4714,4713,7,6,5646,266125620,71288
676,a1401,20130308,4714,4713,4718,4726,4715,4725,4721,12,8,6272,296102780,73002
677,a1401,20130311,4725,4721,4723,4726,4705,4707,4716,-14,-5,8286,390819660,76770
678,a1401,20130312,4707,4716,4709,4717,4676,4680,4688,-36,-28,10936,512725840,81120
679,a1401,20130313,4680,4688,4681,4697,4658,4691,4678,3,-10,15690,733990040,85604
680,a1401,20130314,4691,4678,4680,4693,4663,4688,4679,10,1,10706,500996840,86882
681,a1401,20130315,4688,4679,4692,4733,4692,4726,4717,47,38,15862,748241560,84696
682,a1401,20130318,4726,4717,4710,4710,4681,4702,4698,-15,-19,14710,691217620,84210
683,a1401,20130319,4702,4698,4701,4715,4701,4709,4708,11,10,6374,300117140,83898
684,a1401,20130320,4709,4708,4708,4723,4704,4716,4716,8,8,5656,266793020,84170
685,a1401,20130321,4716,4716,4724,4751,4717,4746,4737,30,21,14728,697716380,85308
686,a1401,20130322,4746,4737,4755,4778,4741,4769,4758,32,21,13202,628225240,87426
687,a1401,20130325,4769,4758,4760,4796,4759,4781,4784,23,26,18512,885634360,91558
688,a1401,20130326,4781,4784,4788,4790,4776,4786,4783,2,-1,7612,364118700,91512
689,a1401,20130327,4786,4783,4798,4800,4756,4768,4771,-15,-12,13474,642846700,94486
690,a1401,20130328,4768,4771,4771,4776,4749,4754,4762,-17,-9,12996,618959560,94794
691,a1401,20130329,4754,4762,4724,4739,4700,4729,4726,-33,-36,15014,709618780,95360
692,a1401,20130401,4729,4726,4725,4739,4710,4715,4726,-11,0,10684,504927780,95088
693,a1401,20130402,4715,4726,4719,4735,4711,4729,4725,3,-1,11550,545804740,94192
694,a1401,20130403,4729,4725,4728,4728,4697,4702,4707,-23,-18,16540,778633740,97092
695,a1401,20130408,4702,4707,4680,4714,4671,4714,4699,7,-8,15164,712645080,96948
696,a1401,20130409,4714,4699,4700,4724,4700,4706,4710,7,11,10762,506935460,95718
697,a1401,20130410,4706,4710,4720,4720,4705,4718,4711,8,1,9652,454790100,95504
698,a1401,20130411,4718,4711,4716,4720,4708,4716,4713,5,2,12100,570327840,95518
699,a1401,20130412,4716,4713,4720,4723,4712,4721,4716,8,3,6152,290184780,95036
700,a1401,20130415,4721,4716,4719,4719,4690,4698,4700,-18,-16,15896,747255480,98488
701,a1401,20130416,4698,4700,4680,4718,4673,4713,4699,13,-1,22748,1069056880,105304
702,a1401,20130417,4713,4699,4718,4739,4707,4713,4722,14,23,17380,820770720,104074
703,a1401,20130418,4713,4722,4707,4760,4700,4723,4719,1,-3,15230,718806160,101322
704,a1401,20130419,4723,4719,4728,4738,4715,4715,4726,-4,7,12052,569619360,102240
705,a1401,20130422,4715,4726,4702,4710,4695,4698,4702,-28,-24,13194,620466860,106048
706,a1401,20130423,4698,4702,4695,4708,4691,4702,4699,0,-3,17120,804484960,107068
707,a1401,20130424,4702,4699,4693,4704,4641,4641,4663,-58,-36,55642,2594647360,121894
708,a1401,20130425,4641,4663,4640,4658,4612,4614,4632,-49,-31,58488,2709542100,129952
709,a1401,20130426,4614,4632,4635,4645,4601,4622,4621,-10,-11,63716,2944855500,134782
710,a1401,20130502,4622,4621,4603,4635,4593,4632,4615,11,-6,52688,2431767120,133226
711,a1401,20130503,4632,4615,4629,4652,4621,4647,4637,32,22,29592,1372189100,129220
712,a1401,20130506,4647,4637,4651,4688,4635,4686,4665,49,28,40400,1884922900,123938
713,a1401,20130507,4686,4665,4669,4682,4665,4670,4674,5,9,19808,925863780,125872
714,a1401,20130508,4670,4674,4675,4697,4672,4687,4688,13,14,17632,826680640,124028
715,a1401,20130509,4687,4688,4696,4696,4673,4680,4681,-8,-7,13666,639762880,123560
716,a1401,20130510,4680,4681,4698,4699,4678,4691,4686,10,5,18304,857737140,124340
717,a1401,20130513,4691,4686,4685,4685,4651,4652,4665,-34,-21,23382,1090937820,128158
718,a1401,20130514,4652,4665,4665,4670,4646,4646,4660,-19,-5,21772,1014630980,131258
719,a1401,20130515,4646,4660,4645,4667,4645,4662,4656,2,-4,25844,1203501120,127704
720,a1401,20130516,4662,4656,4650,4683,4650,4679,4671,23,15,27994,1307706420,127894
721,a1401,20130517,4679,4671,4690,4698,4676,4697,4689,26,18,32180,1509175640,130990
722,a1401,20130520,4697,4689,4702,4728,4682,4682,4703,-7,14,53350,2509405560,128188
723,a1401,20130521,4682,4703,4685,4702,4669,4682,4685,-21,-18,19596,918250800,131626
724,a1401,20130522,4682,4685,4690,4694,4676,4691,4684,6,-1,11888,556946420,130706
725,a1401,20130523,4691,4684,4705,4708,4672,4674,4691,-10,7,17126,803471340,129348
726,a1401,20130524,4674,4691,4680,4680,4654,4654,4660,-37,-31,39594,1845399520,134746
727,a1401,20130527,4654,4660,4644,4665,4633,4663,4655,3,-5,20274,943896880,132268
728,a1401,20130528,4663,4655,4665,4679,4662,4679,4669,24,14,13318,621854040,131336
729,a1401,20130529,4679,4669,4703,4715,4685,4699,4703,30,34,47764,2246791320,136102
730,a1401,20130530,4699,4703,4695,4700,4672,4681,4686,-22,-17,21554,1010028500,133468
731,a1401,20130531,4681,4686,4686,4696,4674,4681,4681,-5,-5,35906,1680795220,126756
732,a1401,20130603,4681,4681,4690,4732,4682,4722,4711,41,30,53518,2521744500,127688
733,a1401,20130604,4722,4711,4726,4729,4702,4708,4713,-3,2,30826,1453093640,124714
734,a1401,20130605,4708,4713,4702,4725,4702,4717,4715,4,2,22506,1061317380,125988
735,a1401,20130606,4717,4715,4700,4718,4697,4713,4709,-2,-6,18950,892544300,122674
736,a1401,20130607,4713,4709,4716,4725,4693,4699,4703,-10,-6,24724,1162839240,119428
737,a1401,20130613,4699,4703,4699,4707,4674,4685,4685,-18,-18,21960,1028857160,119686
738,a1401,20130614,4685,4685,4680,4687,4670,4687,4679,2,-6,16640,778632420,120284
739,a1401,20130617,4687,4679,4680,4684,4660,4674,4672,-5,-7,23628,1103982260,121400
740,a1401,20130618,4674,4672,4675,4690,4675,4679,4683,7,11,14434,676035580,120512
741,a1401,20130619,4679,4683,4672,4682,4662,4668,4672,-15,-11,14998,700794760,122764
742,a1401,20130620,4668,4672,4675,4684,4652,4656,4666,-16,-6,26086,1217393360,124670
743,a1401,20130621,4656,4666,4650,4659,4622,4629,4636,-37,-30,52132,2416972080,129734
744,a1401,20130624,4629,4636,4604,4635,4604,4610,4617,-26,-19,23690,1093816860,131306
745,a1401,20130625,4610,4617,4629,4645,4620,4639,4631,22,14,29596,1370757400,129192
746,a1401,20130626,4639,4631,4635,4646,4626,4632,4634,1,3,17960,832359360,128476
747,a1401,20130627,4632,4634,4623,4635,4605,4628,4620,-6,-14,29040,1341816120,131108
748,a1401,20130628,4628,4620,4623,4635,4613,4617,4621,-3,1,13014,601462760,131876
749,a1401,20130701,4617,4621,4596,4602,4556,4587,4586,-34,-35,42576,1952790560,147476
750,a1401,20130702,4587,4586,4580,4608,4571,4608,4597,22,11,25722,1182687220,145894
751,a1401,20130703,4608,4597,4606,4617,4598,4609,4606,12,9,17672,814122240,146046
752,a1401,20130704,4609,4606,4610,4629,4609,4625,4621,19,15,20076,927855760,142172
753,a1401,20130705,4625,4621,4630,4636,4621,4626,4627,5,6,10912,504932420,142170
754,a1401,20130708,4626,4627,4615,4616,4600,4606,4607,-21,-20,15494,713868780,145236
755,a1401,20130709,4606,4607,4619,4642,4618,4634,4634,27,27,29152,1350907220,142162
756,a1401,20130710,4634,4634,4645,4657,4635,4646,4643,12,9,18088,839982960,139592
757,a1401,20130711,4646,4643,4653,4663,4643,4658,4652,15,9,22570,1050024540,134780
758,a1401,20130712,4658,4652,4663,4673,4643,4644,4657,-8,5,18808,875957320,134006
759,a1401,20130715,4644,4657,4629,4632,4616,4624,4625,-33,-32,17770,821897840,136550
760,a1401,20130716,4624,4625,4630,4653,4630,4646,4639,21,14,12310,571123960,136808
761,a1401,20130717,4646,4639,4655,4658,4644,4651,4652,12,13,16344,760348540,135542
762,a1401,20130718,4651,4652,4645,4645,4625,4634,4632,-18,-20,22648,1049104840,134714
763,a1401,20130719,4634,4632,4625,4632,4613,4614,4621,-18,-11,31624,1461513440,129990
764,a1401,20130722,4614,4621,4621,4636,4617,4631,4627,10,6,23992,1110147540,128684
765,a1401,20130723,4631,4627,4638,4651,4629,4651,4640,24,13,23834,1105953060,125340
766,a1401,20130724,4651,4640,4620,4632,4601,4606,4613,-34,-27,44166,2037537200,130250
767,a1401,20130725,4606,4613,4592,4592,4526,4533,4550,-80,-63,122936,5594280140,149042
768,a1401,20130726,4533,4550,4495,4495,4368,4368,4434,-182,-116,240514,10665110840,186306
769,a1401,20130729,4368,4434,4351,4362,4305,4345,4333,-89,-101,320586,13892427760,199734
770,a1401,20130730,4345,4333,4343,4350,4303,4320,4322,-13,-11,221912,9591208520,212000
771,a1401,20130731,4320,4322,4285,4412,4263,4409,4360,87,38,495190,21591970840,216912
772,a1401,20130801,4409,4360,4400,4435,4376,4419,4407,59,47,391838,17270925580,210608
773,a1401,20130802,4419,4407,4402,4424,4382,4423,4404,16,-3,323784,14261263080,211166
774,a1401,20130805,4423,4404,4403,4413,4366,4404,4392,0,-12,263664,11582500380,212426
775,a1401,20130806,4404,4392,4391,4411,4386,4410,4401,18,9,106994,4709524100,206160
776,a1401,20130807,4410,4401,4380,4390,4310,4320,4332,-81,-69,355760,15411698560,236118
777,a1401,20130808,4320,4332,4323,4378,4323,4354,4351,22,19,181370,7892290120,208318
778,a1401,20130809,4354,4351,4375,4392,4352,4357,4371,6,20,127928,5592409260,206796
779,a1401,20130812,4357,4371,4371,4405,4361,4401,4385,30,14,97716,4285772660,192312
780,a1401,20130813,4401,4385,4450,4468,4433,4450,4451,65,66,103724,4617336980,183250
781,a1401,20130814,4450,4451,4435,4445,4408,4408,4424,-43,-27,101822,4505575760,189670
782,a1401,20130815,4408,4424,4450,4455,4419,4421,4439,-3,15,88374,3923080660,182358
783,a1401,20130816,4421,4439,4452,4485,4430,4435,4455,-4,16,85132,3792813640,176978
784,a1401,20130819,4435,4455,4490,4490,4448,4450,4460,-5,5,66306,2957550800,177664
785,a1401,20130820,4450,4460,4480,4480,4442,4453,4455,-7,-5,109200,4865948880,179004
786,a1401,20130821,4453,4455,4447,4474,4440,4455,4454,0,-1,86148,3837748040,178682
787,a1401,20130822,4455,4454,4451,4473,4451,4467,4463,13,9,66016,2946518280,181154
788,a1401,20130823,4467,4463,4463,4476,4449,4464,4461,1,-2,89926,4011848720,183786
789,a1401,20130826,4464,4461,4528,4639,4520,4623,4599,162,138,575450,26468710140,202420
790,a1401,20130827,4623,4599,4630,4630,4553,4569,4575,-30,-24,239768,10971411860,171344
791,a1401,20130828,4569,4575,4569,4569,4530,4535,4552,-40,-23,73964,3367580480,167500
792,a1401,20130829,4535,4552,4550,4583,4488,4532,4543,-20,-9,134390,6105689000,161364
793,a1401,20130830,4532,4543,4501,4523,4490,4512,4509,-31,-34,50726,2287565960,158240
794,a1401,20130902,4512,4509,4508,4547,4506,4545,4538,36,29,44454,2017373640,156688
795,a1401,20130903,4545,4538,4560,4560,4522,4548,4540,10,2,58506,2656422060,151404
796,a1401,20130904,4548,4540,4530,4535,4513,4529,4523,-11,-17,29692,1343099720,149116
797,a1401,20130905,4529,4523,4513,4545,4508,4533,4533,10,10,47790,2166624100,143762
798,a1401,20130906,4533,4533,4540,4563,4536,4558,4550,25,17,38534,1753554620,137818
799,a1401,20130909,4558,4550,4558,4569,4545,4560,4556,10,6,22470,1023753880,135294
800,a1401,20130910,4560,4556,4531,4560,4524,4557,4543,1,-13,33138,1505590680,135278
801,a1401,20130911,4557,4543,4560,4603,4560,4593,4584,50,41,108012,4951853600,144376
802,a1401,20130912,4593,4584,4586,4603,4576,4590,4589,6,5,67454,3095625380,138858
803,a1401,20130913,4590,4589,4628,4638,4590,4591,4603,2,14,78056,3593084200,113854
804,a1401,20130916,4591,4603,4562,4577,4541,4542,4560,-61,-43,51068,2329114940,107108
805,a1401,20130917,4542,4560,4530,4560,4523,4560,4546,0,-14,40622,1846877960,103444
806,a1401,20130918,4560,4546,4550,4591,4548,4589,4569,43,23,35528,1623578880,100720
807,a1401,20130923,4589,4569,4568,4587,4549,4574,4570,5,1,31546,1441963300,104790
808,a1401,20130924,4574,4570,4571,4604,4571,4600,4591,30,21,44448,2040683680,101912
809,a1401,20130925,4600,4591,4598,4610,4586,4593,4598,2,7,23458,1078644140,96812
810,a1401,20130926,4593,4598,4593,4607,4583,4592,4593,-6,-5,17834,819206820,91064
811,a1401,20130927,4592,4593,4592,4600,4580,4593,4590,0,-3,24954,1145515140,84166
812,a1401,20130930,4593,4590,4586,4645,4586,4616,4622,26,32,40678,1880139440,84022
813,a1401,20131008,4616,4622,4622,4674,4622,4661,4652,39,30,32894,1530541160,84578
814,a1401,20131009,4661,4652,4660,4660,4640,4648,4648,-4,-4,15232,708098140,84868
815,a1401,20131010,4648,4648,4652,4689,4652,4681,4675,33,27,41620,1946084160,87104
816,a1401,20131011,4681,4675,4675,4698,4658,4658,4675,-17,0,26700,1248381440,85944
817,a1401,20131014,4658,4675,4640,4684,4635,4662,4659,-13,-16,42660,1987654280,84946
818,a1401,20131015,4662,4659,4666,4687,4645,4655,4660,-4,1,39724,1851526280,71314
819,a1401,20131016,4655,4660,4655,4680,4632,4637,4650,-23,-10,46560,2165255360,59780
820,a1401,20131017,4637,4650,4652,4664,4613,4621,4630,-29,-20,26942,1247571920,55822
821,a1401,20131018,4621,4630,4630,4655,4623,4646,4642,16,12,17390,807364400,54408
822,a1401,20131021,4646,4642,4657,4659,4632,4637,4641,-5,-1,12980,602495420,52316
823,a1401,20131022,4637,4641,4641,4644,4576,4580,4599,-61,-42,30754,1414588180,52906
824,a1401,20131023,4580,4599,4580,4589,4535,4560,4567,-39,-32,27508,1256351420,45680
825,a1401,20131024,4560,4567,4569,4569,4527,4538,4542,-29,-25,20048,910681820,44480
826,a1401,20131025,4538,4542,4531,4563,4525,4530,4543,-12,1,15636,710434660,41710
827,a1401,20131028,4530,4543,4524,4534,4516,4528,4525,-15,-18,7158,323922540,40800
828,a1401,20131029,4528,4525,4515,4531,4483,4492,4499,-33,-26,9320,419328880,40578
829,a1401,20131030,4492,4499,4499,4516,4483,4483,4501,-16,2,11502,517712640,37138
830,a1401,20131031,4483,4501,4488,4496,4462,4486,4483,-15,-18,12388,555377180,33816
831,a1401,20131101,4486,4483,4476,4503,4468,4471,4483,-12,0,17418,780997820,28666
832,a1401,20131104,4471,4483,4461,4474,4450,4466,4460,-17,-23,7514,335137720,27078
833,a1401,20131105,4466,4460,4461,4482,4459,4460,4467,0,7,7312,326685800,24176
834,a1401,20131106,4460,4467,4472,4472,4423,4435,4440,-32,-27,12352,548470740,20850
835,a1401,20131107,4435,4440,4433,4451,4429,4451,4438,11,-2,4336,192451260,19500
836,a1401,20131108,4451,4438,4463,4465,4439,4440,4448,2,10,4292,190910740,18174
837,a1401,20131111,4440,4448,4446,4466,4444,4450,4452,2,4,3824,170262900,17152
838,a1401,20131112,4450,4452,4459,4465,4452,4463,4457,11,5,3280,146197160,15544
839,a1401,20131113,4463,4457,4470,4474,4457,4457,4462,0,5,2410,107543440,14780
840,a1401,20131114,4457,4462,4457,4463,4447,4451,4454,-11,-8,2608,116172240,14534
841,a1401,20131115,4451,4454,4451,4455,4430,4443,4441,-11,-13,2556,113528340,13958
842,a1401,20131118,4443,4441,4448,4449,4438,4441,4442,0,1,2500,111050340,13420
843,a1401,20131119,4441,4442,4449,4449,4420,4420,4431,-22,-11,1648,73036600,12876
844,a1401,20131120,4420,4431,4424,4424,4386,4389,4396,-42,-35,3646,160308380,11960
845,a1401,20131121,4389,4396,4392,4393,4351,4365,4367,-31,-29,2476,108145300,11892
846,a1401,20131122,4365,4367,4374,4376,4342,4342,4353,-25,-14,2202,95856240,11752
847,a1401,20131125,4342,4353,4350,4351,4321,4321,4339,-32,-14,2686,116551040,11396
848,a1401,20131126,4321,4339,4339,4343,4290,4319,4330,-20,-9,2168,93876960,10898
849,a1401,20131127,4319,4330,4330,4338,4320,4332,4332,2,2,1058,45839160,10384
850,a1401,20131128,4332,4332,4343,4343,4292,4297,4305,-35,-27,2420,104185800,10106
851,a1401,20131129,4297,4305,4298,4307,4290,4297,4299,-8,-6,1174,50476340,9808
852,a1401,20131202,4297,4299,4299,4337,4299,4331,4322,32,23,3254,140665040,8470
853,a1401,20131203,4331,4322,4321,4352,4320,4348,4338,26,16,1774,76973340,7670
854,a1401,20131204,4348,4338,4348,4385,4348,4382,4371,44,33,1704,74491880,7048
855,a1401,20131205,4382,4371,4383,4415,4373,4380,4396,9,25,1920,84409580,6328
856,a1401,20131206,4380,4396,4382,4405,4380,4405,4394,9,-2,1878,82531960,5836
857,a1401,20131209,4405,4394,4407,4434,4395,4427,4419,33,25,2032,89797740,6046
858,a1401,20131210,4427,4419,4442,4442,4428,4434,4433,15,14,1398,61975620,6046
859,a1401,20131211,4434,4433,4443,4444,4427,4434,4433,1,0,364,16139320,5840
860,a1401,20131212,4434,4433,4450,4450,4432,4435,4435,2,2,2942,130482420,5586
861,a1401,20131213,4435,4435,4430,4445,4428,4445,4435,10,0,884,39211840,5256
862,a1401,20131216,4445,4435,4466,4467,4438,4440,4441,5,6,540,23982400,2834
863,a1401,20131217,4440,4441,4440,4445,4431,4442,4436,1,-5,464,20584660,2778
864,a1401,20131218,4442,4436,4437,4442,4434,4440,4437,4,1,616,27335080,2796
865,a1401,20131219,4440,4437,4439,4445,4432,4443,4440,6,3,198,8791220,2722
866,a1401,20131220,4443,4440,4436,4444,4435,4439,4438,-1,-2,100,4438260,2676
867,a1401,20131223,4439,4438,4439,4440,4424,4439,4433,1,-5,192,8511980,2628
868,a1401,20131224,4439,4433,4431,4439,4421,4428,4433,-5,0,134,5940540,2520
869,a1401,20131225,4428,4433,4427,4436,4427,4429,4432,-4,-1,138,6116220,2484
870,a1401,20131226,4429,4432,4415,4426,4400,4415,4419,-17,-13,64,2828600,2470
871,a1401,20131227,4415,4419,4402,4418,4396,4405,4407,-14,-12,582,25653500,2378
872,a1401,20131230,4405,4407,4321,4432,4320,4400,4388,-7,-19,534,23434480,2342
873,a1401,20131231,4400,4388,4419,4427,4320,4370,4420,-18,32,1478,65337660,2112
874,a1403,20130104,4800,4711,0,0,0,4711,4711,0,0,0,0,0
875,a1403,20130107,4711,4711,0,0,0,4711,4711,0,0,0,0,0
876,a1403,20130108,4711,4711,0,0,0,4711,4711,0,0,0,0,0
877,a1403,20130109,4711,4711,0,0,0,4711,4711,0,0,0,0,0
878,a1403,20130110,4711,4711,0,0,0,4711,4711,0,0,0,0,0
879,a1403,20130111,4711,4711,0,0,0,4711,4711,0,0,0,0,0
880,a1403,20130114,4711,4711,0,0,0,4711,4711,0,0,0,0,0
881,a1403,20130115,4711,4711,0,0,0,4711,4711,0,0,0,0,0
882,a1403,20130116,4711,4711,0,0,0,4711,4711,0,0,0,0,0
883,a1403,20130117,4711,4711,0,0,0,4711,4711,0,0,0,0,0
884,a1403,20130118,4711,4711,0,0,0,4711,4711,0,0,0,0,0
885,a1403,20130121,4711,4711,4707,4878,4707,4878,4792,167,81,4,191700,0
886,a1403,20130122,4878,4792,0,0,0,4792,4792,0,0,0,0,0
887,a1403,20130123,4792,4792,0,0,0,4792,4792,0,0,0,0,0
888,a1403,20130124,4792,4792,0,0,0,4792,4792,0,0,0,0,0
889,a1403,20130125,4792,4792,0,0,0,4792,4792,0,0,0,0,0
890,a1403,20130128,4792,4792,0,0,0,4792,4792,0,0,0,0,0
891,a1403,20130129,4792,4792,0,0,0,4792,4792,0,0,0,0,0
892,a1403,20130130,4792,4792,0,0,0,4792,4792,0,0,0,0,0
893,a1403,20130131,4792,4792,0,0,0,4792,4792,0,0,0,0,0
894,a1403,20130201,4792,4792,0,0,0,4792,4792,0,0,0,0,0
895,a1403,20130204,4792,4792,0,0,0,4792,4792,0,0,0,0,0
896,a1403,20130205,4792,4792,0,0,0,4792,4792,0,0,0,0,0
897,a1403,20130206,4792,4792,0,0,0,4792,4792,0,0,0,0,0
898,a1403,20130207,4792,4792,0,0,0,4792,4792,0,0,0,0,0
899,a1403,20130208,4792,4792,0,0,0,4792,4792,0,0,0,0,0
900,a1403,20130218,4792,4792,0,0,0,4792,4792,0,0,0,0,0
901,a1403,20130219,4792,4792,0,0,0,4792,4792,0,0,0,0,0
902,a1403,20130220,4792,4792,0,0,0,4792,4792,0,0,0,0,0
903,a1403,20130221,4792,4792,0,0,0,4792,4792,0,0,0,0,0
904,a1403,20130222,4792,4792,0,0,0,4792,4792,0,0,0,0,0
905,a1403,20130225,4792,4792,0,0,0,4792,4792,0,0,0,0,0
906,a1403,20130226,4792,4792,0,0,0,4792,4792,0,0,0,0,0
907,a1403,20130227,4792,4792,4733,4739,4733,4739,4734,-53,-58,8,378760,8
908,a1403,20130228,4739,4734,4731,4731,4731,4731,4731,-3,-3,2,94620,10
909,a1403,20130301,4731,4731,4726,4726,4726,4726,4726,-5,-5,2,94520,8
910,a1403,20130304,4726,4726,0,0,0,4726,4726,0,0,0,0,8
911,a1403,20130305,4726,4726,0,0,0,4726,4726,0,0,0,0,8
912,a1403,20130306,4726,4726,0,0,0,4726,4726,0,0,0,0,8
913,a1403,20130307,4726,4726,0,0,0,4726,4726,0,0,0,0,8
914,a1403,20130308,4726,4726,4757,4757,4757,4757,4757,31,31,10,475700,18
915,a1403,20130311,4757,4757,0,0,0,4757,4757,0,0,0,0,18
916,a1403,20130312,4757,4757,4730,4730,4730,4730,4730,-27,-27,2,94600,16
917,a1403,20130313,4730,4730,0,0,0,4730,4730,0,0,0,0,16
918,a1403,20130314,4730,4730,0,0,0,4730,4730,0,0,0,0,16
919,a1403,20130315,4730,4730,0,0,0,4730,4730,0,0,0,0,16
920,a1403,20130318,4730,4730,4728,4729,4728,4729,4728,-1,-2,4,189140,18
921,a1403,20130319,4729,4728,0,0,0,4728,4728,0,0,0,0,18
922,a1403,20130320,4728,4728,0,0,0,4728,4728,0,0,0,0,18
923,a1403,20130321,4728,4728,4761,4764,4761,4764,4763,36,35,10,476340,12
924,a1403,20130322,4764,4763,4791,4791,4791,4791,4791,28,28,2,95820,10
925,a1403,20130325,4791,4791,0,0,0,4791,4791,0,0,0,0,10
926,a1403,20130326,4791,4791,4800,4808,4797,4797,4800,6,9,12,576100,14
927,a1403,20130327,4797,4800,0,0,0,4800,4800,0,0,0,0,14
928,a1403,20130328,4800,4800,0,0,0,4800,4800,0,0,0,0,14
929,a1403,20130329,4800,4800,4736,4750,4736,4750,4743,-50,-57,4,189720,14
930,a1403,20130401,4750,4743,4750,4750,4740,4740,4745,-3,2,8,379600,10
931,a1403,20130402,4740,4745,0,0,0,4745,4745,0,0,0,0,10
932,a1403,20130403,4745,4745,4739,4744,4739,4744,4742,-1,-3,8,379420,10
933,a1403,20130408,4744,4742,4733,4733,4733,4733,4733,-9,-9,2,94660,10
934,a1403,20130409,4733,4733,4740,4740,4740,4740,4740,7,7,2,94800,10
935,a1403,20130410,4740,4740,0,0,0,4740,4740,0,0,0,0,10
936,a1403,20130411,4740,4740,0,0,0,4740,4740,0,0,0,0,10
937,a1403,20130412,4740,4740,0,0,0,4740,4740,0,0,0,0,10
938,a1403,20130415,4740,4740,0,0,0,4740,4740,0,0,0,0,10
939,a1403,20130416,4740,4740,0,0,0,4740,4740,0,0,0,0,10
940,a1403,20130417,4740,4740,0,0,0,4740,4740,0,0,0,0,10
941,a1403,20130418,4740,4740,0,0,0,4740,4740,0,0,0,0,10
942,a1403,20130419,4740,4740,0,0,0,4740,4740,0,0,0,0,10
943,a1403,20130422,4740,4740,0,0,0,4740,4740,0,0,0,0,10
944,a1403,20130423,4740,4740,0,0,0,4740,4740,0,0,0,0,10
945,a1403,20130424,4740,4740,4683,4684,4683,4684,4683,-56,-57,4,187340,12
946,a1403,20130425,4684,4683,4677,4677,4645,4645,4666,-38,-17,8,373300,8
947,a1403,20130426,4645,4666,0,0,0,4666,4666,0,0,0,0,8
948,a1403,20130502,4666,4666,4639,4639,4639,4639,4639,-27,-27,2,92780,8
949,a1403,20130503,4639,4639,4657,4657,4657,4657,4657,18,18,2,93140,6
950,a1403,20130506,4657,4657,0,0,0,4657,4657,0,0,0,0,6
951,a1403,20130507,4657,4657,0,0,0,4657,4657,0,0,0,0,6
952,a1403,20130508,4657,4657,4703,4703,4691,4691,4697,34,40,4,187880,8
953,a1403,20130509,4691,4697,4671,4671,4671,4671,4671,-26,-26,2,93420,8
954,a1403,20130510,4671,4671,0,0,0,4679,4679,8,8,0,0,8
955,a1403,20130513,4679,4679,0,0,0,4665,4665,-14,-14,0,0,8
956,a1403,20130514,4665,4665,4663,4663,4663,4663,4663,-2,-2,2,93260,8
957,a1403,20130515,4663,4663,4654,4654,4651,4651,4652,-12,-11,4,186100,4
958,a1403,20130516,4651,4652,4647,4666,4647,4666,4656,14,4,4,186260,4
959,a1403,20130517,4666,4656,0,0,0,4657,4657,1,1,0,0,4
960,a1403,20130520,4657,4657,0,0,0,4670,4670,13,13,0,0,4
961,a1403,20130521,4670,4670,0,0,0,4670,4670,0,0,0,0,4
962,a1403,20130522,4670,4670,0,0,0,4670,4670,0,0,0,0,4
963,a1403,20130523,4670,4670,0,0,0,4670,4670,0,0,0,0,4
964,a1403,20130524,4670,4670,4664,4664,4664,4664,4664,-6,-6,2,93280,2
965,a1403,20130527,4664,4664,0,0,0,4664,4664,0,0,0,0,2
966,a1403,20130528,4664,4664,0,0,0,4664,4664,0,0,0,0,2
967,a1403,20130529,4664,4664,0,0,0,4664,4664,0,0,0,0,2
968,a1403,20130530,4664,4664,4674,4674,4650,4650,4662,-14,-2,4,186480,4
969,a1403,20130531,4650,4662,0,0,0,4660,4660,-2,-2,0,0,4
970,a1403,20130603,4660,4660,0,0,0,4675,4675,15,15,0,0,4
971,a1403,20130604,4675,4675,0,0,0,4675,4675,0,0,0,0,4
972,a1403,20130605,4675,4675,0,0,0,4676,4676,1,1,0,0,4
973,a1403,20130606,4676,4676,0,0,0,4671,4671,-5,-5,0,0,4
974,a1403,20130607,4671,4671,0,0,0,4666,4666,-5,-5,0,0,4
975,a1403,20130613,4666,4666,0,0,0,4666,4666,0,0,0,0,4
976,a1403,20130614,4666,4666,0,0,0,4666,4666,0,0,0,0,4
977,a1403,20130617,4666,4666,0,0,0,4666,4666,0,0,0,0,4
978,a1403,20130618,4666,4666,0,0,0,4676,4676,10,10,0,0,4
979,a1403,20130619,4676,4676,0,0,0,4666,4666,-10,-10,0,0,4
980,a1403,20130620,4666,4666,0,0,0,4661,4661,-5,-5,0,0,4
981,a1403,20130621,4661,4661,0,0,0,4617,4617,-44,-44,0,0,4
982,a1403,20130624,4617,4617,0,0,0,4599,4599,-18,-18,0,0,4
983,a1403,20130625,4599,4599,4615,4615,4615,4615,4615,16,16,2,92300,4
984,a1403,20130626,4615,4615,0,0,0,4615,4615,0,0,0,0,4
985,a1403,20130627,4615,4615,0,0,0,4615,4615,0,0,0,0,4
986,a1403,20130628,4615,4615,0,0,0,4600,4600,-15,-15,0,0,4
987,a1403,20130701,4600,4600,0,0,0,4597,4597,-3,-3,0,0,4
988,a1403,20130702,4597,4597,0,0,0,4597,4597,0,0,0,0,4
989,a1403,20130703,4597,4597,0,0,0,4597,4597,0,0,0,0,4
990,a1403,20130704,4597,4597,0,0,0,4597,4597,0,0,0,0,4
991,a1403,20130705,4597,4597,4603,4603,4603,4603,4603,6,6,2,92060,4
992,a1403,20130708,4603,4603,0,0,0,4603,4603,0,0,0,0,4
993,a1403,20130709,4603,4603,0,0,0,4603,4603,0,0,0,0,4
994,a1403,20130710,4603,4603,0,0,0,4611,4611,8,8,0,0,4
995,a1403,20130711,4611,4611,0,0,0,4611,4611,0,0,0,0,4
996,a1403,20130712,4611,4611,4638,4638,4638,4638,4638,27,27,2,92760,4
997,a1403,20130715,4638,4638,0,0,0,4638,4638,0,0,0,0,4
998,a1403,20130716,4638,4638,0,0,0,4652,4652,14,14,0,0,4
999,a1403,20130717,4652,4652,0,0,0,4652,4652,0,0,0,0,4
1000,a1403,20130718,4652,4652,0,0,0,4652,4652,0,0,0,0,4
1001,a1403,20130719,4652,4652,4619,4619,4596,4596,4607,-56,-45,4,184300,4
1002,a1403,20130722,4596,4607,0,0,0,4607,4607,0,0,0,0,4
1003,a1403,20130723,4607,4607,0,0,0,4607,4607,0,0,0,0,4
1004,a1403,20130724,4607,4607,0,0,0,4607,4607,0,0,0,0,4
1005,a1403,20130725,4607,4607,4519,4519,4519,4519,4519,-88,-88,2,90380,2
1006,a1403,20130726,4519,4519,4484,4484,4444,4444,4464,-75,-55,4,178560,2
1007,a1403,20130729,4444,4464,0,0,0,4363,4363,-101,-101,0,0,2
1008,a1403,20130730,4363,4363,0,0,0,4352,4352,-11,-11,0,0,2
1009,a1403,20130731,4352,4352,0,0,0,4390,4390,38,38,0,0,2
1010,a1403,20130801,4390,4390,4324,4401,4324,4401,4362,11,-28,6,261760,6
1011,a1403,20130802,4401,4362,4384,4384,4384,4384,4384,22,22,2,87680,4
1012,a1403,20130805,4384,4384,4219,4379,4219,4379,4299,-5,-85,22,945780,4
1013,a1403,20130806,4379,4299,0,0,0,4322,4322,23,23,0,0,4
1014,a1403,20130807,4322,4322,4251,4251,4251,4251,4251,-71,-71,2,85020,4
1015,a1403,20130808,4251,4251,0,0,0,4266,4266,15,15,0,0,4
1016,a1403,20130809,4266,4266,4266,4266,4266,4266,4266,0,0,2,85320,6
1017,a1403,20130812,4266,4266,0,0,0,4318,4318,52,52,0,0,6
1018,a1403,20130813,4318,4318,0,0,0,4382,4382,64,64,0,0,6
1019,a1403,20130814,4382,4382,0,0,0,4381,4381,-1,-1,0,0,6
1020,a1403,20130815,4381,4381,4409,4409,4409,4409,4409,28,28,2,88180,4
1021,a1403,20130816,4409,4409,0,0,0,4424,4424,15,15,0,0,4
1022,a1403,20130819,4424,4424,0,0,0,4424,4424,0,0,0,0,4
1023,a1403,20130820,4424,4424,0,0,0,4420,4420,-4,-4,0,0,4
1024,a1403,20130821,4420,4420,0,0,0,4420,4420,0,0,0,0,4
1025,a1403,20130822,4420,4420,0,0,0,4420,4420,0,0,0,0,4
1026,a1403,20130823,4420,4420,0,0,0,4419,4419,-1,-1,0,0,4
1027,a1403,20130826,4419,4419,4550,4583,4519,4583,4554,164,135,18,819880,6
1028,a1403,20130827,4583,4554,4580,4580,4580,4580,4580,26,26,2,91600,6
1029,a1403,20130828,4580,4580,4504,4504,4504,4504,4504,-76,-76,2,90080,6
1030,a1403,20130829,4504,4504,0,0,0,4496,4496,-8,-8,0,0,6
1031,a1403,20130830,4496,4496,0,0,0,4496,4496,0,0,0,0,6
1032,a1403,20130902,4496,4496,0,0,0,4496,4496,0,0,0,0,6
1033,a1403,20130903,4496,4496,0,0,0,4497,4497,1,1,0,0,6
1034,a1403,20130904,4497,4497,4443,4491,4443,4491,4475,-6,-22,6,268500,2
1035,a1403,20130905,4491,4475,0,0,0,4485,4485,10,10,0,0,2
1036,a1403,20130906,4485,4485,0,0,0,4517,4517,32,32,0,0,2
1037,a1403,20130909,4517,4517,4520,4520,4520,4520,4520,3,3,2,90400,4
1038,a1403,20130910,4520,4520,0,0,0,4521,4521,1,1,0,0,4
1039,a1403,20130911,4521,4521,4540,4558,4526,4558,4541,37,20,6,272480,4
1040,a1403,20130912,4558,4541,0,0,0,4545,4545,4,4,0,0,4
1041,a1403,20130913,4545,4545,0,0,0,4558,4558,13,13,0,0,4
1042,a1403,20130916,4558,4558,0,0,0,4516,4516,-42,-42,0,0,4
1043,a1403,20130917,4516,4516,4526,4526,4506,4506,4514,-10,-2,16,722360,8
1044,a1403,20130918,4506,4514,4528,4528,4489,4489,4508,-25,-6,4,180340,8
1045,a1403,20130923,4489,4508,4493,4493,4493,4493,4493,-15,-15,2,89860,10
1046,a1403,20130924,4493,4493,0,0,0,4513,4513,20,20,0,0,10
1047,a1403,20130925,4513,4513,4553,4553,4553,4553,4553,40,40,2,91060,8
1048,a1403,20130926,4553,4553,0,0,0,4553,4553,0,0,0,0,8
1049,a1403,20130927,4553,4553,4530,4530,4385,4385,4465,-168,-88,6,267940,12
1050,a1403,20130930,4385,4465,4547,4563,4500,4537,4541,72,76,22,999100,6
1051,a1403,20131008,4537,4541,4568,4568,4568,4568,4568,27,27,2,91360,8
1052,a1403,20131009,4568,4568,4559,4559,4559,4559,4559,-9,-9,4,182360,4
1053,a1403,20131010,4559,4559,0,0,0,4585,4585,26,26,0,0,4
1054,a1403,20131011,4585,4585,4575,4575,4575,4575,4575,-10,-10,2,91500,2
1055,a1403,20131014,4575,4575,0,0,0,4560,4560,-15,-15,0,0,2
1056,a1403,20131015,4560,4560,4562,4562,4562,4562,4562,2,2,2,91240,2
1057,a1403,20131016,4562,4562,0,0,0,4553,4553,-9,-9,0,0,2
1058,a1403,20131017,4553,4553,0,0,0,4553,4553,0,0,0,0,2
1059,a1403,20131018,4553,4553,0,0,0,4564,4564,11,11,0,0,2
1060,a1403,20131021,4564,4564,4623,4623,4623,4623,4623,59,59,76,3513480,78
1061,a1403,20131022,4623,4623,4586,4586,4545,4545,4567,-78,-56,110,5024660,38
1062,a1403,20131023,4545,4567,4558,4558,4532,4532,4551,-35,-16,20,910280,24
1063,a1403,20131024,4532,4551,4529,4529,4529,4529,4529,-22,-22,6,271740,18
1064,a1403,20131025,4529,4529,4514,4514,4501,4501,4504,-28,-25,8,360340,16
1065,a1403,20131028,4501,4504,0,0,0,4487,4487,-17,-17,0,0,16
1066,a1403,20131029,4487,4487,0,0,0,4487,4487,0,0,0,0,16
1067,a1403,20131030,4487,4487,4470,4470,4470,4470,4470,-17,-17,2,89400,16
1068,a1403,20131031,4470,4470,0,0,0,4453,4453,-17,-17,0,0,16
1069,a1403,20131101,4453,4453,4487,4507,4487,4507,4498,54,45,34,1529520,32
1070,a1403,20131104,4507,4498,4499,4499,4499,4499,4499,1,1,10,449900,42
1071,a1403,20131105,4499,4499,4495,4495,4488,4488,4492,-11,-7,6,269540,44
1072,a1403,20131106,4488,4492,4500,4500,4500,4500,4500,8,8,6,270000,44
1073,a1403,20131107,4500,4500,0,0,0,4500,4500,0,0,0,0,44
1074,a1403,20131108,4500,4500,0,0,0,4500,4500,0,0,0,0,44
1075,a1403,20131111,4500,4500,0,0,0,4504,4504,4,4,0,0,44
1076,a1403,20131112,4504,4504,0,0,0,4504,4504,0,0,0,0,44
1077,a1403,20131113,4504,4504,0,0,0,4504,4504,0,0,0,0,44
1078,a1403,20131114,4504,4504,0,0,0,4504,4504,0,0,0,0,44
1079,a1403,20131115,4504,4504,0,0,0,4504,4504,0,0,0,0,44
1080,a1403,20131118,4504,4504,0,0,0,4504,4504,0,0,0,0,44
1081,a1403,20131119,4504,4504,0,0,0,4494,4494,-10,-10,0,0,44
1082,a1403,20131120,4494,4494,0,0,0,4494,4494,0,0,0,0,44
1083,a1403,20131121,4494,4494,4432,4432,4432,4432,4432,-62,-62,2,88640,42
1084,a1403,20131122,4432,4432,0,0,0,4418,4418,-14,-14,0,0,42
1085,a1403,20131125,4418,4418,0,0,0,4418,4418,0,0,0,0,42
1086,a1403,20131126,4418,4418,4413,4413,4413,4413,4413,-5,-5,2,88260,42
1087,a1403,20131127,4413,4413,0,0,0,4415,4415,2,2,0,0,42
1088,a1403,20131128,4415,4415,0,0,0,4388,4388,-27,-27,0,0,42
1089,a1403,20131129,4388,4388,0,0,0,4382,4382,-6,-6,0,0,42
1090,a1403,20131202,4382,4382,0,0,0,4405,4405,23,23,0,0,42
1091,a1403,20131203,4405,4405,0,0,0,4421,4421,16,16,0,0,42
1092,a1403,20131204,4421,4421,4446,4454,4446,4454,4448,33,27,6,266920,44
1093,a1403,20131205,4454,4448,4451,4471,4451,4471,4461,23,13,4,178440,42
1094,a1403,20131206,4471,4461,0,0,0,4461,4461,0,0,0,0,42
1095,a1403,20131209,4461,4461,4468,4468,4468,4468,4468,7,7,6,268080,40
1096,a1403,20131210,4468,4468,4507,4507,4479,4479,4493,11,25,4,179720,40
1097,a1403,20131211,4479,4493,4472,4472,4472,4472,4472,-21,-21,2,89440,40
1098,a1403,20131212,4472,4472,4492,4492,4473,4473,4485,1,13,6,269120,42
1099,a1403,20131213,4473,4485,4456,4488,4456,4486,4478,1,-7,10,447800,44
1100,a1403,20131216,4486,4478,4507,4507,4507,4507,4507,29,29,14,630980,36
1101,a1403,20131217,4507,4507,4499,4499,4499,4499,4499,-8,-8,2,89980,36
1102,a1403,20131218,4499,4499,4488,4488,4488,4488,4488,-11,-11,2,89760,36
1103,a1403,20131219,4488,4488,0,0,0,4488,4488,0,0,0,0,36
1104,a1403,20131220,4488,4488,0,0,0,4488,4488,0,0,0,0,36
1105,a1403,20131223,4488,4488,0,0,0,4490,4490,2,2,0,0,36
1106,a1403,20131224,4490,4490,0,0,0,4490,4490,0,0,0,0,36
1107,a1403,20131225,4490,4490,0,0,0,4490,4490,0,0,0,0,36
1108,a1403,20131226,4490,4490,0,0,0,4490,4490,0,0,0,0,36
1109,a1403,20131227,4490,4490,0,0,0,4490,4490,0,0,0,0,36
1110,a1403,20131230,4490,4490,4414,4414,4397,4397,4404,-93,-86,6,264280,32
1111,a1403,20131231,4397,4404,0,0,0,4414,4414,10,10,0,0,32
1112,a1405,20130104,4829,4825,4812,4840,4812,4828,4818,3,-7,52,2505800,88
1113,a1405,20130107,4828,4818,4834,4847,4827,4827,4832,9,14,68,3285900,114
1114,a1405,20130108,4827,4832,4828,4850,4825,4844,4836,12,4,32,1547580,136
1115,a1405,20130109,4844,4836,4841,4841,4830,4830,4835,-6,-1,34,1644020,140
1116,a1405,20130110,4830,4835,4844,4844,4822,4827,4831,-8,-4,122,5894420,214
1117,a1405,20130111,4827,4831,4817,4847,4815,4831,4827,0,-4,58,2799960,254
1118,a1405,20130114,4831,4827,4860,4864,4844,4858,4852,31,25,60,2911500,262
1119,a1405,20130115,4858,4852,4870,4870,4840,4843,4850,-9,-2,126,6111060,296
1120,a1405,20130116,4843,4850,4845,4860,4845,4858,4851,8,1,152,7373540,372
1121,a1405,20130117,4858,4851,4865,4867,4854,4855,4860,4,9,146,7096620,406
1122,a1405,20130118,4855,4860,4856,4888,4852,4870,4874,10,14,342,16671140,290
1123,a1405,20130121,4870,4874,4880,4890,4875,4880,4879,6,5,64,3122920,302
1124,a1405,20130122,4880,4879,4880,4880,4872,4874,4875,-5,-4,16,780120,304
1125,a1405,20130123,4874,4875,4873,4874,4866,4866,4868,-9,-7,52,2531560,308
1126,a1405,20130124,4866,4868,4864,4864,4835,4841,4846,-27,-22,98,4749700,366
1127,a1405,20130125,4841,4846,4853,4856,4835,4835,4844,-11,-2,76,3681580,386
1128,a1405,20130128,4835,4844,4845,4845,4837,4843,4842,-1,-2,46,2227740,416
1129,a1405,20130129,4843,4842,4842,4848,4834,4836,4838,-6,-4,100,4838940,454
1130,a1405,20130130,4836,4838,4847,4852,4843,4852,4845,14,7,80,3876560,454
1131,a1405,20130131,4852,4845,4880,4880,4853,4853,4865,8,20,138,6714220,516
1132,a1405,20130201,4853,4865,4844,4859,4843,4859,4847,-6,-18,64,3102620,520
1133,a1405,20130204,4859,4847,4855,4855,4845,4845,4850,-2,3,126,6112160,540
1134,a1405,20130205,4845,4850,4849,4850,4844,4844,4847,-6,-3,44,2133080,550
1135,a1405,20130206,4844,4847,4851,4855,4848,4848,4850,1,3,44,2134080,566
1136,a1405,20130207,4848,4850,4859,4859,4842,4850,4850,0,0,120,5820180,662
1137,a1405,20130208,4850,4850,4857,4859,4851,4851,4856,1,6,130,6313420,758
1138,a1405,20130218,4851,4856,4840,4840,4818,4818,4826,-38,-30,578,27898700,1182
1139,a1405,20130219,4818,4826,4822,4826,4817,4821,4820,-5,-6,634,30560980,1474
1140,a1405,20130220,4821,4820,4825,4835,4821,4821,4826,1,6,96,4633420,1514
1141,a1405,20130221,4821,4826,4823,4830,4811,4815,4817,-11,-9,618,29774980,1812
1142,a1405,20130222,4815,4817,4814,4870,4814,4834,4834,17,17,206,9959840,1842
1143,a1405,20130225,4834,4834,4834,4834,4772,4797,4802,-37,-32,672,32276140,2210
1144,a1405,20130226,4797,4802,4804,4810,4793,4793,4797,-9,-5,238,11418060,2338
1145,a1405,20130227,4793,4797,4812,4814,4786,4786,4794,-11,-3,418,20042920,2432
1146,a1405,20130228,4786,4794,4803,4804,4785,4787,4794,-7,0,370,17740020,2496
1147,a1405,20130301,4787,4794,4794,4796,4782,4789,4789,-5,-5,238,11398820,2528
1148,a1405,20130304,4789,4789,4784,4793,4780,4782,4784,-7,-5,236,11292440,2634
1149,a1405,20130305,4782,4784,4784,4795,4784,4791,4790,7,6,214,10251820,2686
1150,a1405,20130306,4791,4790,4791,4795,4788,4794,4791,4,1,266,12746320,2766
1151,a1405,20130307,4794,4791,4792,4800,4792,4798,4796,7,5,140,6714480,2738
1152,a1405,20130308,4798,4796,4802,4808,4802,4808,4806,12,10,136,6536640,2738
1153,a1405,20130311,4808,4806,4803,4804,4790,4790,4797,-16,-9,88,4222000,2752
1154,a1405,20130312,4790,4797,4800,4802,4764,4768,4773,-29,-24,772,36853200,3224
1155,a1405,20130313,4768,4773,4762,4781,4746,4775,4760,2,-13,570,27135800,3394
1156,a1405,20130314,4775,4760,4757,4777,4751,4773,4762,13,2,476,22668160,3484
1157,a1405,20130315,4773,4762,4773,4818,4773,4810,4802,48,40,538,25836280,3422
1158,a1405,20130318,4810,4802,4786,4793,4764,4786,4782,-16,-20,354,16928460,3484
1159,a1405,20130319,4786,4782,4800,4800,4785,4794,4791,12,9,268,12841980,3596
1160,a1405,20130320,4794,4791,4788,4807,4788,4803,4799,12,8,126,6047200,3608
1161,a1405,20130321,4803,4799,4808,4826,4805,4823,4814,24,15,422,20319280,3628
1162,a1405,20130322,4823,4814,4830,4847,4823,4840,4836,26,22,622,30085320,3708
1163,a1405,20130325,4840,4836,4837,4866,4836,4852,4852,16,16,294,14267100,3732
1164,a1405,20130326,4852,4852,4861,4877,4850,4853,4855,1,3,172,8352040,3778
1165,a1405,20130327,4853,4855,4856,4858,4833,4843,4843,-12,-12,240,11624580,3820
1166,a1405,20130328,4843,4843,4833,4860,4827,4834,4836,-9,-7,258,12479160,3822
1167,a1405,20130329,4834,4836,4802,4818,4780,4813,4806,-23,-30,598,28745560,3960
1168,a1405,20130401,4813,4806,4808,4827,4787,4789,4800,-17,-6,562,26981600,4232
1169,a1405,20130402,4789,4800,4798,4809,4789,4800,4797,0,-3,202,9691340,4248
1170,a1405,20130403,4800,4797,4786,4792,4780,4780,4783,-17,-14,884,42282740,4846
1171,a1405,20130408,4780,4783,4770,4788,4759,4781,4779,-2,-4,982,46938880,4958
1172,a1405,20130409,4781,4779,4789,4797,4780,4781,4784,2,5,472,22580500,5160
1173,a1405,20130410,4781,4784,4793,4795,4781,4795,4787,11,3,364,17425820,4974
1174,a1405,20130411,4795,4787,4786,4794,4783,4792,4788,5,1,174,8332580,4974
1175,a1405,20130412,4792,4788,4787,4795,4787,4794,4790,6,2,310,14851360,4976
1176,a1405,20130415,4794,4790,4790,4790,4767,4774,4776,-16,-14,784,37449360,5356
1177,a1405,20130416,4774,4776,4765,4789,4750,4784,4775,8,-1,828,39538980,5282
1178,a1405,20130417,4784,4775,4785,4805,4776,4783,4790,8,15,526,25195560,5272
1179,a1405,20130418,4783,4790,4777,4822,4776,4793,4791,3,1,218,10445640,5284
1180,a1405,20130419,4793,4791,4805,4805,4785,4785,4794,-6,3,336,16109140,5270
1181,a1405,20130422,4785,4794,4778,4782,4766,4768,4775,-26,-19,348,16618180,5472
1182,a1405,20130423,4768,4775,4765,4777,4765,4770,4770,-5,-5,102,4865480,5456
1183,a1405,20130424,4770,4770,4770,4773,4716,4717,4737,-53,-33,1094,51830740,6044
1184,a1405,20130425,4717,4737,4712,4729,4686,4686,4706,-51,-31,692,32569180,6048
1185,a1405,20130426,4686,4706,4706,4717,4676,4696,4695,-10,-11,1026,48172660,6092
1186,a1405,20130502,4696,4695,4677,4705,4667,4693,4684,-2,-11,1246,58368300,6124
1187,a1405,20130503,4693,4684,4693,4717,4688,4717,4706,33,22,882,41514480,5930
1188,a1405,20130506,4717,4706,4718,4740,4699,4740,4721,34,15,894,42209860,5912
1189,a1405,20130507,4740,4721,4730,4739,4717,4726,4725,5,4,594,28069200,5926
1190,a1405,20130508,4726,4725,4735,4750,4733,4745,4741,20,16,322,15269220,5898
1191,a1405,20130509,4745,4741,4741,4741,4711,4712,4720,-29,-21,2370,111875540,7260
1192,a1405,20130510,4712,4720,4722,4735,4671,4672,4693,-48,-27,5668,266024060,10152
1193,a1405,20130513,4672,4693,4650,4665,4621,4622,4645,-71,-48,9888,459392760,12520
1194,a1405,20130514,4622,4645,4622,4638,4598,4599,4611,-46,-34,14912,687709720,18564
1195,a1405,20130515,4599,4611,4580,4641,4580,4638,4613,27,2,11438,527734780,19960
1196,a1405,20130516,4638,4613,4570,4664,4570,4661,4636,48,23,8134,377167220,21856
1197,a1405,20130517,4661,4636,4685,4691,4660,4691,4677,55,41,4058,189809820,20408
1198,a1405,20130520,4691,4677,4745,4745,4700,4702,4725,25,48,11816,558406100,20040
1199,a1405,20130521,4702,4725,4707,4717,4672,4684,4690,-41,-35,4292,201337280,21362
1200,a1405,20130522,4684,4690,4697,4699,4674,4686,4685,-4,-5,1816,85080140,21702
1201,a1405,20130523,4686,4685,4698,4704,4672,4678,4690,-7,5,2070,97090640,22180
1202,a1405,20130524,4678,4690,4681,4681,4642,4645,4653,-45,-37,7166,333437040,21234
1203,a1405,20130527,4645,4653,4638,4650,4627,4640,4643,-13,-10,3632,168640940,21182
1204,a1405,20130528,4640,4643,4647,4650,4633,4638,4639,-5,-4,7210,334471940,22386
1205,a1405,20130529,4638,4639,4649,4676,4636,4644,4653,5,14,15016,698796020,28430
1206,a1405,20130530,4644,4653,4640,4648,4627,4638,4637,-15,-16,3730,172962540,29604
1207,a1405,20130531,4638,4637,4645,4645,4631,4634,4635,-3,-2,2816,130541900,31268
1208,a1405,20130603,4634,4635,4645,4680,4644,4676,4667,41,32,8662,404333260,33366
1209,a1405,20130604,4676,4667,4688,4688,4662,4665,4670,-2,3,7742,361607880,34062
1210,a1405,20130605,4665,4670,4670,4680,4668,4674,4673,4,3,7568,353711900,33226
1211,a1405,20130606,4674,4673,4660,4675,4652,4672,4668,-1,-5,4004,186946380,33470
1212,a1405,20130607,4672,4668,4676,4679,4657,4660,4664,-8,-4,3384,157859880,33624
1213,a1405,20130613,4660,4664,4662,4667,4639,4649,4647,-15,-17,5842,271480960,35802
1214,a1405,20130614,4649,4647,4636,4653,4636,4650,4647,3,0,3756,174554280,37582
1215,a1405,20130617,4650,4647,4642,4653,4633,4644,4643,-3,-4,5674,263490100,38626
1216,a1405,20130618,4644,4643,4646,4657,4645,4647,4649,4,6,3640,169252060,38594
1217,a1405,20130619,4647,4649,4645,4651,4633,4636,4640,-13,-9,4060,188412200,39780
1218,a1405,20130620,4636,4640,4622,4643,4622,4623,4631,-17,-9,5456,252684120,41384
1219,a1405,20130621,4623,4631,4615,4620,4594,4594,4603,-37,-28,13812,635845500,47666
1220,a1405,20130624,4594,4603,4570,4618,4570,4580,4588,-23,-15,5854,268617720,49656
1221,a1405,20130625,4580,4588,4592,4608,4590,4605,4598,17,10,3878,178312420,49158
1222,a1405,20130626,4605,4598,4600,4608,4590,4595,4596,-3,-2,3020,138799360,49162
1223,a1405,20130627,4595,4596,4599,4599,4578,4588,4587,-8,-9,4838,221923340,49326
1224,a1405,20130628,4588,4587,4587,4592,4579,4582,4584,-5,-3,1706,78207240,49554
1225,a1405,20130701,4582,4584,4570,4570,4539,4555,4557,-29,-27,5326,242711380,51196
1226,a1405,20130702,4555,4557,4546,4573,4542,4572,4561,15,4,2804,127912720,50800
1227,a1405,20130703,4572,4561,4560,4578,4560,4576,4573,15,12,2596,118719900,50970
1228,a1405,20130704,4576,4573,4576,4593,4575,4590,4587,17,14,2430,111478960,50876
1229,a1405,20130705,4590,4587,4600,4602,4589,4594,4594,7,7,3688,169460400,51344
1230,a1405,20130708,4594,4594,4572,4586,4572,4577,4579,-17,-15,3032,138845100,53008
1231,a1405,20130709,4577,4579,4595,4611,4592,4604,4604,25,25,7604,350160900,52906
1232,a1405,20130710,4604,4604,4614,4617,4603,4612,4610,8,6,3044,140328560,52982
1233,a1405,20130711,4612,4610,4617,4620,4610,4618,4614,8,4,3744,172771580,52402
1234,a1405,20130712,4618,4614,4618,4628,4605,4606,4618,-8,4,2970,137172300,52514
1235,a1405,20130715,4606,4618,4600,4600,4586,4591,4591,-27,-27,4430,203411720,54880
1236,a1405,20130716,4591,4591,4601,4613,4596,4608,4602,17,11,2092,96275520,54914
1237,a1405,20130717,4608,4602,4617,4618,4608,4611,4613,9,11,2790,128714280,54624
1238,a1405,20130718,4611,4613,4604,4610,4588,4594,4592,-19,-21,5244,240854140,55934
1239,a1405,20130719,4594,4592,4589,4592,4560,4560,4572,-32,-20,12446,569123860,61288
1240,a1405,20130722,4560,4572,4564,4572,4555,4567,4565,-5,-7,7146,326236920,61698
1241,a1405,20130723,4567,4565,4576,4589,4570,4587,4577,22,12,4674,213968820,61266
1242,a1405,20130724,4587,4577,4572,4572,4552,4562,4561,-15,-16,6284,286644060,61676
1243,a1405,20130725,4562,4561,4552,4555,4487,4491,4508,-70,-53,34418,1551574800,73476
1244,a1405,20130726,4491,4508,4465,4468,4328,4328,4390,-180,-118,71940,3158214460,98202
1245,a1405,20130729,4328,4390,4333,4334,4256,4286,4285,-104,-105,76292,3269514880,111418
1246,a1405,20130730,4286,4285,4298,4298,4220,4233,4247,-52,-38,75676,3214268500,124170
1247,a1405,20130731,4233,4247,4184,4328,4184,4322,4278,75,31,109842,4699544460,107544
1248,a1405,20130801,4322,4278,4312,4345,4291,4314,4313,36,35,80760,3483787120,111174
1249,a1405,20130802,4314,4313,4308,4320,4291,4318,4307,5,-6,47146,2030989740,108400
1250,a1405,20130805,4318,4307,4295,4313,4271,4300,4291,-7,-16,40964,1757805520,110530
1251,a1405,20130806,4300,4291,4295,4315,4291,4314,4304,23,13,17338,746311300,106302
1252,a1405,20130807,4314,4304,4284,4287,4233,4240,4250,-64,-54,65124,2768354060,110050
1253,a1405,20130808,4240,4250,4237,4293,4237,4266,4267,16,17,32530,1388362820,106664
1254,a1405,20130809,4266,4267,4265,4297,4256,4257,4276,-10,9,22026,942018360,109372
1255,a1405,20130812,4257,4276,4271,4308,4266,4306,4290,30,14,21138,907000660,109986
1256,a1405,20130813,4306,4290,4351,4364,4337,4351,4350,61,60,22760,990265980,103386
1257,a1405,20130814,4351,4350,4348,4348,4313,4317,4333,-33,-17,19302,836451500,103384
1258,a1405,20130815,4317,4333,4340,4355,4327,4330,4346,-3,13,23726,1031289440,102094
1259,a1405,20130816,4330,4346,4359,4391,4343,4348,4367,2,21,20768,907005860,102382
1260,a1405,20130819,4348,4367,4386,4396,4363,4365,4373,-2,6,12212,534151200,103842
1261,a1405,20130820,4365,4373,4393,4394,4353,4361,4367,-12,-6,22886,999607780,102820
1262,a1405,20130821,4361,4367,4361,4378,4349,4362,4361,-5,-6,14162,617705440,102986
1263,a1405,20130822,4362,4361,4360,4373,4358,4372,4366,11,5,12830,560181900,102732
1264,a1405,20130823,4372,4366,4365,4383,4360,4372,4369,6,3,16542,722839160,101870
1265,a1405,20130826,4372,4369,4413,4533,4413,4511,4497,142,128,132764,5970514240,93216
1266,a1405,20130827,4511,4497,4516,4521,4448,4458,4467,-39,-30,44900,2005979940,88562
1267,a1405,20130828,4458,4467,4455,4459,4425,4425,4445,-42,-22,20146,895506420,88978
1268,a1405,20130829,4425,4445,4444,4455,4389,4421,4426,-24,-19,28014,1239929760,86120
1269,a1405,20130830,4421,4426,4405,4416,4391,4406,4405,-20,-21,13772,606673940,85312
1270,a1405,20130902,4406,4405,4412,4438,4404,4436,4428,31,23,12554,555944080,83994
1271,a1405,20130903,4436,4428,4456,4457,4412,4436,4432,8,4,9588,424944260,83740
1272,a1405,20130904,4436,4432,4420,4423,4404,4416,4412,-16,-20,6146,271186900,84840
1273,a1405,20130905,4416,4412,4402,4424,4397,4413,4413,1,1,8332,367749940,85898
1274,a1405,20130906,4413,4413,4415,4432,4404,4431,4421,18,8,9710,429281660,85052
1275,a1405,20130909,4431,4421,4433,4440,4420,4430,4428,9,7,6848,303270320,84568
1276,a1405,20130910,4430,4428,4410,4427,4400,4427,4414,-1,-14,10482,462685320,82550
1277,a1405,20130911,4427,4414,4438,4468,4432,4459,4453,45,39,22568,1005178700,83000
1278,a1405,20130912,4459,4453,4452,4480,4445,4466,4465,13,12,26972,1204480200,85888
1279,a1405,20130913,4466,4465,4494,4508,4473,4473,4483,8,18,16260,728943640,81474
1280,a1405,20130916,4473,4483,4451,4451,4430,4431,4441,-52,-42,9886,439094560,80736
1281,a1405,20130917,4431,4441,4425,4455,4414,4445,4440,4,-1,20590,914371300,81684
1282,a1405,20130918,4445,4440,4430,4470,4430,4467,4456,27,16,15338,683506640,80170
1283,a1405,20130923,4467,4456,4432,4466,4430,4457,4451,1,-5,17006,757035720,79126
1284,a1405,20130924,4457,4451,4450,4491,4450,4489,4478,38,27,27548,1233684440,78272
1285,a1405,20130925,4489,4478,4500,4500,4473,4483,4482,5,4,13632,611067220,76640
1286,a1405,20130926,4483,4482,4492,4492,4475,4483,4483,1,1,6720,301278360,75368
1287,a1405,20130927,4483,4483,4477,4491,4470,4486,4480,3,-3,21290,953793380,70186
1288,a1405,20130930,4486,4480,4475,4527,4475,4500,4510,20,30,22352,1008256180,65274
1289,a1405,20131008,4500,4510,4510,4550,4507,4547,4530,37,20,9804,444201860,64704
1290,a1405,20131009,4547,4530,4530,4544,4525,4536,4535,6,5,6026,273304160,65622
1291,a1405,20131010,4536,4535,4540,4576,4540,4570,4564,35,29,22664,1034391540,66824
1292,a1405,20131011,4570,4564,4565,4580,4548,4549,4562,-15,-2,9040,412486180,66890
1293,a1405,20131014,4549,4562,4540,4574,4531,4556,4550,-6,-12,11886,540929680,70070
1294,a1405,20131015,4556,4550,4544,4577,4544,4556,4558,6,8,27818,1268173240,72642
1295,a1405,20131016,4556,4558,4553,4593,4553,4574,4576,16,18,54206,2480520120,88786
1296,a1405,20131017,4574,4576,4573,4589,4546,4559,4562,-17,-14,33462,1526648420,86776
1297,a1405,20131018,4559,4562,4579,4587,4559,4574,4572,12,10,17838,815607120,87364
1298,a1405,20131021,4574,4572,4585,4589,4566,4585,4578,13,6,19932,912648120,83196
1299,a1405,20131022,4585,4578,4584,4589,4547,4548,4564,-30,-14,32876,1500565020,91442
1300,a1405,20131023,4548,4564,4545,4564,4516,4539,4543,-25,-21,40412,1835981920,95990
1301,a1405,20131024,4539,4543,4550,4550,4506,4509,4518,-34,-25,37282,1684641140,97072
1302,a1405,20131025,4509,4518,4489,4522,4488,4491,4504,-27,-14,32512,1464453820,100700
1303,a1405,20131028,4491,4504,4502,4502,4465,4481,4482,-23,-22,26332,1180313840,104160
1304,a1405,20131029,4481,4482,4460,4476,4436,4446,4452,-36,-30,30084,1339361420,105824
1305,a1405,20131030,4446,4452,4449,4472,4445,4448,4457,-4,5,22020,981581780,104856
1306,a1405,20131031,4448,4457,4448,4482,4436,4476,4467,19,10,39232,1752685920,109620
1307,a1405,20131101,4476,4467,4465,4505,4459,4481,4489,14,22,48212,2164293680,114642
1308,a1405,20131104,4481,4489,4465,4479,4460,4475,4470,-14,-19,19872,888328980,115006
1309,a1405,20131105,4475,4470,4473,4496,4462,4480,4481,10,11,28204,1263887560,114520
1310,a1405,20131106,4480,4481,4472,4485,4456,4458,4470,-23,-11,34358,1535808700,117216
1311,a1405,20131107,4458,4470,4455,4488,4453,4488,4473,18,3,39942,1786952520,121850
1312,a1405,20131108,4488,4473,4490,4504,4474,4487,4491,14,18,54970,2468739340,121742
1313,a1405,20131111,4487,4491,4501,4563,4493,4514,4516,23,25,57752,2608558000,123800
1314,a1405,20131112,4514,4516,4521,4527,4496,4504,4507,-12,-9,38472,1734086720,126072
1315,a1405,20131113,4504,4507,4506,4518,4503,4508,4507,1,0,27392,1234615740,120442
1316,a1405,20131114,4508,4507,4510,4519,4498,4519,4511,12,4,21482,969242400,118554
1317,a1405,20131115,4519,4511,4520,4525,4504,4508,4512,-3,1,28980,1307851120,120528
1318,a1405,20131118,4508,4512,4515,4515,4477,4489,4488,-23,-24,45118,2025006700,116812
1319,a1405,20131119,4489,4488,4492,4500,4457,4457,4472,-31,-16,41610,1860898840,119168
1320,a1405,20131120,4457,4472,4452,4459,4430,4445,4441,-27,-31,51906,2305203900,119540
1321,a1405,20131121,4445,4441,4441,4448,4420,4427,4432,-14,-9,41918,1857926360,122042
1322,a1405,20131122,4427,4432,4443,4448,4431,4440,4439,8,7,29032,1288912240,119896
1323,a1405,20131125,4440,4439,4460,4460,4430,4431,4444,-8,5,32766,1456247040,114670
1324,a1405,20131126,4431,4444,4440,4444,4403,4410,4417,-34,-27,43146,1906064840,112240
1325,a1405,20131127,4410,4417,4419,4438,4408,4432,4428,15,11,32718,1448777580,106504
1326,a1405,20131128,4432,4428,4424,4425,4384,4386,4396,-42,-32,54652,2402706180,113014
1327,a1405,20131129,4386,4396,4386,4402,4380,4395,4392,-1,-4,30894,1357144420,111972
1328,a1405,20131202,4395,4392,4400,4434,4396,4429,4421,37,29,45970,2032448500,104184
1329,a1405,20131203,4429,4421,4420,4447,4406,4438,4431,17,10,51786,2294640260,96768
1330,a1405,20131204,4438,4431,4435,4457,4435,4455,4448,24,17,33616,1495446240,97052
1331,a1405,20131205,4455,4448,4459,4473,4445,4460,4462,12,14,25786,1150712460,95190
1332,a1405,20131206,4460,4462,4469,4469,4434,4444,4447,-18,-15,27152,1207651920,95538
1333,a1405,20131209,4444,4447,4446,4469,4439,4467,4452,20,5,27602,1229007340,90286
1334,a1405,20131210,4467,4452,4473,4490,4458,4465,4469,13,17,18410,822842660,89382
1335,a1405,20131211,4465,4469,4473,4474,4456,4473,4462,4,-7,13242,590941280,88930
1336,a1405,20131212,4473,4462,4476,4479,4452,4466,4463,4,1,17708,790483280,88084
1337,a1405,20131213,4466,4463,4456,4476,4453,4463,4464,0,1,29272,1306949340,85744
1338,a1405,20131216,4463,4464,4457,4514,4457,4492,4492,28,28,54988,2470109620,80730
1339,a1405,20131217,4492,4492,4502,4519,4491,4506,4506,14,14,38330,1727295380,80338
1340,a1405,20131218,4506,4506,4516,4517,4483,4492,4494,-14,-12,26290,1181489480,78812
1341,a1405,20131219,4492,4494,4480,4496,4471,4490,4488,-4,-6,17554,787866780,78460
1342,a1405,20131220,4490,4488,4495,4500,4475,4499,4489,11,1,15416,692095620,77334
1343,a1405,20131223,4499,4489,4504,4515,4498,4511,4506,22,17,18086,815065300,76508
1344,a1405,20131224,4511,4506,4501,4506,4468,4486,4486,-20,-20,27342,1226665540,75288
1345,a1405,20131225,4486,4486,4489,4495,4474,4487,4485,1,-1,18404,825498140,74636
1346,a1405,20131226,4487,4485,4490,4497,4476,4476,4484,-9,-1,10338,463657900,74378
1347,a1405,20131227,4476,4484,4465,4492,4457,4488,4479,4,-5,19268,863124140,73522
1348,a1405,20131230,4488,4479,4460,4480,4358,4411,4412,-68,-67,215014,9488153860,70770
1349,a1405,20131231,4411,4412,4411,4450,4405,4441,4434,29,22,60974,2704131920,66464
1350,a1407,20130121,4851,4851,0,0,0,4851,4851,0,0,0,0,0
1351,a1407,20130122,4851,4851,0,0,0,4851,4851,0,0,0,0,0
1352,a1407,20130123,4851,4851,0,0,0,4851,4851,0,0,0,0,0
1353,a1407,20130124,4851,4851,4806,4863,4806,4863,4834,12,-17,12,580140,0
1354,a1407,20130125,4863,4834,0,0,0,4834,4834,0,0,0,0,0
1355,a1407,20130128,4834,4834,0,0,0,4834,4834,0,0,0,0,0
1356,a1407,20130129,4834,4834,0,0,0,4834,4834,0,0,0,0,0
1357,a1407,20130130,4834,4834,0,0,0,4834,4834,0,0,0,0,0
1358,a1407,20130131,4834,4834,0,0,0,4834,4834,0,0,0,0,0
1359,a1407,20130201,4834,4834,0,0,0,4834,4834,0,0,0,0,0
1360,a1407,20130204,4834,4834,0,0,0,4834,4834,0,0,0,0,0
1361,a1407,20130205,4834,4834,0,0,0,4834,4834,0,0,0,0,0
1362,a1407,20130206,4834,4834,0,0,0,4834,4834,0,0,0,0,0
1363,a1407,20130207,4834,4834,0,0,0,4834,4834,0,0,0,0,0
1364,a1407,20130208,4834,4834,4755,4955,4755,4846,4849,12,15,10,484960,6
1365,a1407,20130218,4846,4849,0,0,0,4849,4849,0,0,0,0,6
1366,a1407,20130219,4849,4849,0,0,0,4849,4849,0,0,0,0,6
1367,a1407,20130220,4849,4849,0,0,0,4849,4849,0,0,0,0,6
1368,a1407,20130221,4849,4849,0,0,0,4849,4849,0,0,0,0,6
1369,a1407,20130222,4849,4849,0,0,0,4849,4849,0,0,0,0,6
1370,a1407,20130225,4849,4849,0,0,0,4849,4849,0,0,0,0,6
1371,a1407,20130226,4849,4849,0,0,0,4849,4849,0,0,0,0,6
1372,a1407,20130227,4849,4849,0,0,0,4849,4849,0,0,0,0,6
1373,a1407,20130228,4849,4849,0,0,0,4849,4849,0,0,0,0,6
1374,a1407,20130301,4849,4849,0,0,0,4849,4849,0,0,0,0,6
1375,a1407,20130304,4849,4849,0,0,0,4849,4849,0,0,0,0,6
1376,a1407,20130305,4849,4849,0,0,0,4849,4849,0,0,0,0,6
1377,a1407,20130306,4849,4849,0,0,0,4849,4849,0,0,0,0,6
1378,a1407,20130307,4849,4849,4800,4800,4760,4760,4780,-89,-69,4,191200,10
1379,a1407,20130308,4760,4780,4806,4809,4800,4809,4805,29,25,6,288300,6
1380,a1407,20130311,4809,4805,0,0,0,4805,4805,0,0,0,0,6
1381,a1407,20130312,4805,4805,0,0,0,4805,4805,0,0,0,0,6
1382,a1407,20130313,4805,4805,0,0,0,4805,4805,0,0,0,0,6
1383,a1407,20130314,4805,4805,0,0,0,4805,4805,0,0,0,0,6
1384,a1407,20130315,4805,4805,0,0,0,4805,4805,0,0,0,0,6
1385,a1407,20130318,4805,4805,0,0,0,4805,4805,0,0,0,0,6
1386,a1407,20130319,4805,4805,0,0,0,4805,4805,0,0,0,0,6
1387,a1407,20130320,4805,4805,0,0,0,4805,4805,0,0,0,0,6
1388,a1407,20130321,4805,4805,4835,4835,4822,4822,4829,17,24,10,482960,10
1389,a1407,20130322,4822,4829,4830,4847,4829,4840,4836,11,7,14,677140,14
1390,a1407,20130325,4840,4836,0,0,0,4836,4836,0,0,0,0,14
1391,a1407,20130326,4836,4836,4845,4845,4830,4830,4837,-6,1,4,193500,14
1392,a1407,20130327,4830,4837,4828,4828,4828,4828,4828,-9,-9,6,289680,8
1393,a1407,20130328,4828,4828,0,0,0,4828,4828,0,0,0,0,8
1394,a1407,20130329,4828,4828,4807,4808,4807,4808,4807,-20,-21,6,288460,4
1395,a1407,20130401,4808,4807,0,0,0,4807,4807,0,0,0,0,4
1396,a1407,20130402,4807,4807,0,0,0,4807,4807,0,0,0,0,4
1397,a1407,20130403,4807,4807,0,0,0,4807,4807,0,0,0,0,4
1398,a1407,20130408,4807,4807,0,0,0,4807,4807,0,0,0,0,4
1399,a1407,20130409,4807,4807,0,0,0,4807,4807,0,0,0,0,4
1400,a1407,20130410,4807,4807,0,0,0,4807,4807,0,0,0,0,4
1401,a1407,20130411,4807,4807,0,0,0,4807,4807,0,0,0,0,4
1402,a1407,20130412,4807,4807,0,0,0,4807,4807,0,0,0,0,4
1403,a1407,20130415,4807,4807,0,0,0,4793,4793,-14,-14,0,0,4
1404,a1407,20130416,4793,4793,4805,4805,4774,4774,4789,-19,-4,20,957980,6
1405,a1407,20130417,4774,4789,0,0,0,4789,4789,0,0,0,0,6
1406,a1407,20130418,4789,4789,4795,4795,4795,4795,4795,6,6,2,95900,4
1407,a1407,20130419,4795,4795,0,0,0,4798,4798,3,3,0,0,4
1408,a1407,20130422,4798,4798,0,0,0,4798,4798,0,0,0,0,4
1409,a1407,20130423,4798,4798,0,0,0,4793,4793,-5,-5,0,0,4
1410,a1407,20130424,4793,4793,4735,4735,4735,4735,4735,-58,-58,2,94700,4
1411,a1407,20130425,4735,4735,4722,4722,4722,4722,4722,-13,-13,2,94440,4
1412,a1407,20130426,4722,4722,4698,4698,4697,4697,4697,-25,-25,4,187900,4
1413,a1407,20130502,4697,4697,4681,4686,4681,4685,4684,-12,-13,6,281040,4
1414,a1407,20130503,4685,4684,4710,4710,4710,4710,4710,26,26,2,94200,2
1415,a1407,20130506,4710,4710,0,0,0,4720,4720,10,10,0,0,2
1416,a1407,20130507,4720,4720,0,0,0,4723,4723,3,3,0,0,2
1417,a1407,20130508,4723,4723,0,0,0,4730,4730,7,7,0,0,2
1418,a1407,20130509,4730,4730,0,0,0,4729,4729,-1,-1,0,0,2
1419,a1407,20130510,4729,4729,4685,4685,4675,4680,4679,-49,-50,58,2713980,58
1420,a1407,20130513,4680,4679,4665,4665,4645,4661,4653,-18,-26,52,2419720,16
1421,a1407,20130514,4661,4653,4658,4658,4630,4630,4649,-23,-4,24,1115900,14
1422,a1407,20130515,4630,4649,4628,4631,4625,4631,4627,-18,-22,14,647840,4
1423,a1407,20130516,4631,4627,0,0,0,4641,4641,14,14,0,0,4
1424,a1407,20130517,4641,4641,4687,4687,4687,4687,4687,46,46,4,187480,6
1425,a1407,20130520,4687,4687,4736,4736,4736,4736,4736,49,49,2,94720,6
1426,a1407,20130521,4736,4736,4691,4691,4691,4691,4691,-45,-45,2,93820,6
1427,a1407,20130522,4691,4691,0,0,0,4691,4691,0,0,0,0,6
1428,a1407,20130523,4691,4691,0,0,0,4691,4691,0,0,0,0,6
1429,a1407,20130524,4691,4691,0,0,0,4654,4654,-37,-37,0,0,6
1430,a1407,20130527,4654,4654,4650,4661,4640,4640,4650,-14,-4,6,279020,6
1431,a1407,20130528,4640,4650,4648,4648,4648,4648,4648,-2,-2,2,92960,4
1432,a1407,20130529,4648,4648,4658,4658,4657,4657,4657,9,9,6,279460,6
1433,a1407,20130530,4657,4657,0,0,0,4641,4641,-16,-16,0,0,6
1434,a1407,20130531,4641,4641,0,0,0,4641,4641,0,0,0,0,6
1435,a1407,20130603,4641,4641,0,0,0,4674,4674,33,33,0,0,6
1436,a1407,20130604,4674,4674,4695,4695,4669,4669,4682,-5,8,4,187280,6
1437,a1407,20130605,4669,4682,0,0,0,4682,4682,0,0,0,0,6
1438,a1407,20130606,4682,4682,0,0,0,4682,4682,0,0,0,0,6
1439,a1407,20130607,4682,4682,0,0,0,4678,4678,-4,-4,0,0,6
1440,a1407,20130613,4678,4678,0,0,0,4678,4678,0,0,0,0,6
1441,a1407,20130614,4678,4678,0,0,0,4678,4678,0,0,0,0,6
1442,a1407,20130617,4678,4678,4738,4738,4665,4665,4701,-13,23,4,188060,6
1443,a1407,20130618,4665,4701,0,0,0,4701,4701,0,0,0,0,6
1444,a1407,20130619,4701,4701,0,0,0,4671,4671,-30,-30,0,0,6
1445,a1407,20130620,4671,4671,0,0,0,4649,4649,-22,-22,0,0,6
1446,a1407,20130621,4649,4649,0,0,0,4634,4634,-15,-15,0,0,6
1447,a1407,20130624,4634,4634,0,0,0,4603,4603,-31,-31,0,0,6
1448,a1407,20130625,4603,4603,0,0,0,4603,4603,0,0,0,0,6
1449,a1407,20130626,4603,4603,0,0,0,4603,4603,0,0,0,0,6
1450,a1407,20130627,4603,4603,0,0,0,4594,4594,-9,-9,0,0,6
1451,a1407,20130628,4594,4594,0,0,0,4594,4594,0,0,0,0,6
1452,a1407,20130701,4594,4594,0,0,0,4581,4581,-13,-13,0,0,6
1453,a1407,20130702,4581,4581,0,0,0,4581,4581,0,0,0,0,6
1454,a1407,20130703,4581,4581,0,0,0,4581,4581,0,0,0,0,6
1455,a1407,20130704,4581,4581,0,0,0,4585,4585,4,4,0,0,6
1456,a1407,20130705,4585,4585,4624,4624,4624,4624,4624,39,39,2,92480,8
1457,a1407,20130708,4624,4624,0,0,0,4617,4617,-7,-7,0,0,8
1458,a1407,20130709,4617,4617,0,0,0,4617,4617,0,0,0,0,8
1459,a1407,20130710,4617,4617,0,0,0,4624,4624,7,7,0,0,8
1460,a1407,20130711,4624,4624,0,0,0,4624,4624,0,0,0,0,8
1461,a1407,20130712,4624,4624,0,0,0,4624,4624,0,0,0,0,8
1462,a1407,20130715,4624,4624,0,0,0,4624,4624,0,0,0,0,8
1463,a1407,20130716,4624,4624,4604,4604,4604,4604,4604,-20,-20,10,460400,16
1464,a1407,20130717,4604,4604,4625,4625,4625,4625,4625,21,21,6,277500,10
1465,a1407,20130718,4625,4625,4622,4622,4600,4600,4611,-25,-14,4,184440,10
1466,a1407,20130719,4600,4611,4581,4581,4581,4581,4581,-30,-30,2,91620,10
1467,a1407,20130722,4581,4581,4588,4588,4588,4588,4588,7,7,2,91760,10
1468,a1407,20130723,4588,4588,0,0,0,4588,4588,0,0,0,0,10
1469,a1407,20130724,4588,4588,0,0,0,4588,4588,0,0,0,0,10
1470,a1407,20130725,4588,4588,4531,4531,4531,4531,4531,-57,-57,2,90620,10
1471,a1407,20130726,4531,4531,0,0,0,4413,4413,-118,-118,0,0,10
1472,a1407,20130729,4413,4413,0,0,0,4413,4413,0,0,0,0,10
1473,a1407,20130730,4413,4413,0,0,0,4291,4291,-122,-122,0,0,10
1474,a1407,20130731,4291,4291,4262,4262,4262,4262,4262,-29,-29,2,85240,8
1475,a1407,20130801,4262,4262,4303,4303,4303,4303,4303,41,41,4,172120,8
1476,a1407,20130802,4303,4303,4313,4313,4313,4313,4313,10,10,2,86260,8
1477,a1407,20130805,4313,4313,0,0,0,4313,4313,0,0,0,0,8
1478,a1407,20130806,4313,4313,0,0,0,4313,4313,0,0,0,0,8
1479,a1407,20130807,4313,4313,0,0,0,4299,4299,-14,-14,0,0,8
1480,a1407,20130808,4299,4299,4269,4269,4269,4269,4269,-30,-30,2,85380,8
1481,a1407,20130809,4269,4269,0,0,0,4269,4269,0,0,0,0,8
1482,a1407,20130812,4269,4269,0,0,0,4282,4282,13,13,0,0,8
1483,a1407,20130813,4282,4282,0,0,0,4341,4341,59,59,0,0,8
1484,a1407,20130814,4341,4341,0,0,0,4341,4341,0,0,0,0,8
1485,a1407,20130815,4341,4341,0,0,0,4341,4341,0,0,0,0,8
1486,a1407,20130816,4341,4341,4359,4359,4332,4332,4345,-9,4,8,347640,12
1487,a1407,20130819,4332,4345,0,0,0,4345,4345,0,0,0,0,12
1488,a1407,20130820,4345,4345,4352,4356,4341,4342,4347,-3,2,8,347820,10
1489,a1407,20130821,4342,4347,0,0,0,4347,4347,0,0,0,0,10
1490,a1407,20130822,4347,4347,4361,4367,4361,4367,4362,20,15,8,349000,16
1491,a1407,20130823,4367,4362,4367,4367,4367,4367,4367,5,5,2,87340,16
1492,a1407,20130826,4367,4367,4521,4528,4521,4528,4524,161,157,4,180980,18
1493,a1407,20130827,4528,4524,4455,4455,4450,4450,4452,-74,-72,4,178100,16
1494,a1407,20130828,4450,4452,0,0,0,4452,4452,0,0,0,0,16
1495,a1407,20130829,4452,4452,4400,4400,4400,4400,4400,-52,-52,2,88000,16
1496,a1407,20130830,4400,4400,0,0,0,4400,4400,0,0,0,0,16
1497,a1407,20130902,4400,4400,4433,4433,4433,4433,4433,33,33,2,88660,18
1498,a1407,20130903,4433,4433,0,0,0,4437,4437,4,4,0,0,18
1499,a1407,20130904,4437,4437,0,0,0,4429,4429,-8,-8,0,0,18
1500,a1407,20130905,4429,4429,0,0,0,4429,4429,0,0,0,0,18
1501,a1407,20130906,4429,4429,0,0,0,4429,4429,0,0,0,0,18
1502,a1407,20130909,4429,4429,0,0,0,4429,4429,0,0,0,0,18
1503,a1407,20130910,4429,4429,4411,4420,4411,4420,4415,-9,-14,4,176620,18
1504,a1407,20130911,4420,4415,4455,4455,4425,4451,4442,36,27,10,444220,22
1505,a1407,20130912,4451,4442,4448,4448,4433,4433,4445,-9,3,12,533460,32
1506,a1407,20130913,4433,4445,4461,4461,4461,4461,4461,16,16,4,178440,28
1507,a1407,20130916,4461,4461,0,0,0,4420,4420,-41,-41,0,0,28
1508,a1407,20130917,4420,4420,0,0,0,4420,4420,0,0,0,0,28
1509,a1407,20130918,4420,4420,0,0,0,4429,4429,9,9,0,0,28
1510,a1407,20130923,4429,4429,0,0,0,4425,4425,-4,-4,0,0,28
1511,a1407,20130924,4425,4425,4457,4457,4457,4457,4457,32,32,10,445700,28
1512,a1407,20130925,4457,4457,4461,4472,4460,4472,4464,15,7,6,267860,28
1513,a1407,20130926,4472,4464,0,0,0,4464,4464,0,0,0,0,28
1514,a1407,20130927,4464,4464,0,0,0,4464,4464,0,0,0,0,28
1515,a1407,20130930,4464,4464,0,0,0,4493,4493,29,29,0,0,28
1516,a1407,20131008,4493,4493,0,0,0,4512,4512,19,19,0,0,28
1517,a1407,20131009,4512,4512,0,0,0,4512,4512,0,0,0,0,28
1518,a1407,20131010,4512,4512,4516,4546,4516,4546,4531,34,19,4,181240,28
1519,a1407,20131011,4546,4531,0,0,0,4530,4530,-1,-1,0,0,28
1520,a1407,20131014,4530,4530,0,0,0,4519,4519,-11,-11,0,0,28
1521,a1407,20131015,4519,4519,0,0,0,4519,4519,0,0,0,0,28
1522,a1407,20131016,4519,4519,0,0,0,4536,4536,17,17,0,0,28
1523,a1407,20131017,4536,4536,0,0,0,4536,4536,0,0,0,0,28
1524,a1407,20131018,4536,4536,0,0,0,4536,4536,0,0,0,0,28
1525,a1407,20131021,4536,4536,0,0,0,4542,4542,6,6,0,0,28
1526,a1407,20131022,4542,4542,4543,4543,4543,4543,4543,1,1,2,90860,28
1527,a1407,20131023,4543,4543,4542,4542,4542,4542,4542,-1,-1,2,90840,26
1528,a1407,20131024,4542,4542,4523,4523,4511,4511,4517,-31,-25,4,180680,24
1529,a1407,20131025,4511,4517,4506,4506,4506,4506,4506,-11,-11,4,180240,24
1530,a1407,20131028,4506,4506,0,0,0,4506,4506,0,0,0,0,24
1531,a1407,20131029,4506,4506,4447,4447,4447,4447,4447,-59,-59,2,88940,24
1532,a1407,20131030,4447,4447,0,0,0,4447,4447,0,0,0,0,24
1533,a1407,20131031,4447,4447,4473,4473,4473,4473,4473,26,26,2,89460,24
1534,a1407,20131101,4473,4473,4499,4504,4493,4500,4501,27,28,50,2250680,66
1535,a1407,20131104,4500,4501,4493,4493,4493,4493,4493,-8,-8,2,89860,66
1536,a1407,20131105,4493,4493,0,0,0,4493,4493,0,0,0,0,66
1537,a1407,20131106,4493,4493,0,0,0,4492,4492,-1,-1,0,0,66
1538,a1407,20131107,4492,4492,4483,4489,4481,4489,4484,-3,-8,6,269060,68
1539,a1407,20131108,4489,4484,4495,4547,4493,4508,4511,24,27,18,812080,68
1540,a1407,20131111,4508,4511,4505,4516,4505,4516,4507,5,-4,8,360620,66
1541,a1407,20131112,4516,4507,4534,4534,4514,4514,4524,7,17,4,180960,66
1542,a1407,20131113,4514,4524,0,0,0,4524,4524,0,0,0,0,66
1543,a1407,20131114,4524,4524,0,0,0,4524,4524,0,0,0,0,66
1544,a1407,20131115,4524,4524,4518,4518,4518,4518,4518,-6,-6,2,90360,64
1545,a1407,20131118,4518,4518,4494,4498,4494,4498,4496,-20,-22,4,179840,66
1546,a1407,20131119,4498,4496,4498,4499,4485,4485,4494,-11,-2,58,2606720,106
1547,a1407,20131120,4485,4494,4455,4455,4455,4455,4455,-39,-39,6,267300,106
1548,a1407,20131121,4455,4455,0,0,0,4441,4441,-14,-14,0,0,106
1549,a1407,20131122,4441,4441,4450,4450,4450,4450,4450,9,9,2,89000,106
1550,a1407,20131125,4450,4450,4451,4451,4451,4451,4451,1,1,4,178040,110
1551,a1407,20131126,4451,4451,4429,4429,4400,4400,4411,-51,-40,46,2029320,122
1552,a1407,20131127,4400,4411,4408,4408,4400,4400,4405,-11,-6,32,1409600,128
1553,a1407,20131128,4400,4405,4344,4345,4341,4345,4343,-60,-62,8,347480,128
1554,a1407,20131129,4345,4343,4342,4344,4340,4344,4342,1,-1,28,1215860,148
1555,a1407,20131202,4344,4342,4363,4423,4363,4390,4411,48,69,98,4322860,218
1556,a1407,20131203,4390,4411,4383,4394,4383,4394,4388,-17,-23,4,175540,214
1557,a1407,20131204,4394,4388,0,0,0,4388,4388,0,0,0,0,214
1558,a1407,20131205,4388,4388,4422,4423,4413,4418,4421,30,33,20,884280,212
1559,a1407,20131206,4418,4421,4403,4403,4403,4403,4403,-18,-18,10,440300,206
1560,a1407,20131209,4403,4403,4411,4419,4411,4415,4414,12,11,54,2383560,160
1561,a1407,20131210,4415,4414,4415,4415,4415,4415,4415,1,1,14,618100,146
1562,a1407,20131211,4415,4415,0,0,0,4415,4415,0,0,0,0,146
1563,a1407,20131212,4415,4415,0,0,0,4415,4415,0,0,0,0,146
1564,a1407,20131213,4415,4415,4409,4423,4409,4423,4416,8,1,20,883220,136
1565,a1407,20131216,4423,4416,4430,4453,4430,4450,4448,34,32,26,1156560,128
1566,a1407,20131217,4450,4448,4473,4474,4473,4474,4473,26,25,6,268400,126
1567,a1407,20131218,4474,4473,4475,4475,4434,4453,4457,-20,-16,12,534840,126
1568,a1407,20131219,4453,4457,4460,4460,4460,4460,4460,3,3,2,89200,126
1569,a1407,20131220,4460,4460,4462,4462,4455,4455,4458,-5,-2,4,178340,126
1570,a1407,20131223,4455,4458,0,0,0,4462,4462,4,4,0,0,126
1571,a1407,20131224,4462,4462,4456,4456,4454,4454,4455,-8,-7,4,178200,124
1572,a1407,20131225,4454,4455,4456,4460,4456,4460,4459,5,4,8,356720,122
1573,a1407,20131226,4460,4459,4451,4451,4451,4451,4451,-8,-8,2,89020,124
1574,a1407,20131227,4451,4451,4456,4458,4456,4458,4456,7,5,22,980440,116
1575,a1407,20131230,4458,4456,4400,4405,4332,4387,4365,-69,-91,42,1833400,124
1576,a1407,20131231,4387,4365,0,0,0,4375,4375,10,10,0,0,124
1577,a1409,20130318,4828,4824,4800,4849,4800,4808,4821,-16,-3,62,2989280,58
1578,a1409,20130319,4808,4821,4831,4831,4810,4818,4813,-3,-8,72,3465960,100
1579,a1409,20130320,4818,4813,0,0,0,4813,4813,0,0,0,0,100
1580,a1409,20130321,4813,4813,4836,4841,4830,4841,4834,28,21,48,2320700,116
1581,a1409,20130322,4841,4834,4841,4854,4837,4854,4843,20,9,68,3293680,162
1582,a1409,20130325,4854,4843,4874,4880,4862,4862,4871,19,28,20,974240,164
1583,a1409,20130326,4862,4871,4876,4899,4863,4864,4872,-7,1,60,2923500,178
1584,a1409,20130327,4864,4872,4864,4869,4842,4854,4858,-18,-14,54,2623640,192
1585,a1409,20130328,4854,4858,4889,4889,4844,4851,4860,-7,2,48,2333260,182
1586,a1409,20130329,4851,4860,4816,4826,4799,4822,4813,-38,-47,62,2984660,184
1587,a1409,20130401,4822,4813,4818,4842,4801,4801,4820,-12,7,98,4723860,198
1588,a1409,20130402,4801,4820,4813,4822,4813,4813,4816,-7,-4,16,770660,200
1589,a1409,20130403,4813,4816,4800,4826,4797,4800,4802,-16,-14,32,1536820,206
1590,a1409,20130408,4800,4802,4800,4808,4793,4802,4802,0,0,28,1344760,218
1591,a1409,20130409,4802,4802,4820,4820,4800,4805,4809,3,7,60,2885640,238
1592,a1409,20130410,4805,4809,4816,4816,4803,4811,4809,2,0,14,673380,240
1593,a1409,20130411,4811,4809,4807,4812,4807,4812,4809,3,0,24,1154260,252
1594,a1409,20130412,4812,4809,4819,4819,4803,4807,4810,-2,1,14,673420,254
1595,a1409,20130415,4807,4810,4803,4803,4791,4798,4795,-12,-15,206,9878980,242
1596,a1409,20130416,4798,4795,4790,4797,4771,4783,4784,-12,-11,238,11386960,352
1597,a1409,20130417,4783,4784,4797,4815,4794,4794,4804,10,20,106,5092700,328
1598,a1409,20130418,4794,4804,4812,4813,4796,4805,4807,1,3,40,1922900,332
1599,a1409,20130419,4805,4807,4815,4825,4804,4804,4813,-3,6,100,4813780,350
1600,a1409,20130422,4804,4813,4800,4800,4778,4778,4787,-35,-26,86,4116880,356
1601,a1409,20130423,4778,4787,4778,4785,4772,4785,4779,-2,-8,44,2102940,362
1602,a1409,20130424,4785,4779,4770,4770,4731,4731,4742,-48,-37,100,4742700,380
1603,a1409,20130425,4731,4742,4730,4731,4700,4700,4713,-42,-29,154,7258660,384
1604,a1409,20130426,4700,4713,4720,4721,4690,4697,4708,-16,-5,194,9134540,406
1605,a1409,20130502,4697,4708,4700,4715,4690,4699,4699,-9,-9,116,5451160,440
1606,a1409,20130503,4699,4699,4711,4724,4708,4720,4716,21,17,66,3112820,422
1607,a1409,20130506,4720,4716,4721,4750,4705,4750,4729,34,13,72,3405020,438
1608,a1409,20130507,4750,4729,4727,4738,4727,4738,4735,9,6,22,1041740,440
1609,a1409,20130508,4738,4735,4746,4756,4738,4751,4749,16,14,20,949940,438
1610,a1409,20130509,4751,4749,4750,4750,4726,4726,4733,-23,-16,78,3692040,428
1611,a1409,20130510,4726,4733,4735,4735,4699,4699,4705,-34,-28,444,20891060,712
1612,a1409,20130513,4699,4705,4690,4690,4640,4640,4661,-65,-44,324,15103280,878
1613,a1409,20130514,4640,4661,4648,4648,4608,4612,4626,-49,-35,672,31087920,1138
1614,a1409,20130515,4612,4626,4622,4645,4614,4644,4625,18,-1,340,15726160,1202
1615,a1409,20130516,4644,4625,4625,4670,4625,4668,4647,43,22,152,7063820,1178
1616,a1409,20130517,4668,4647,4680,4703,4676,4703,4690,56,43,354,16603960,1118
1617,a1409,20130520,4703,4690,4705,4747,4705,4715,4726,25,36,660,31193780,1168
1618,a1409,20130521,4715,4726,4719,4719,4690,4690,4707,-36,-19,74,3483640,1184
1619,a1409,20130522,4690,4707,4704,4704,4685,4696,4696,-11,-11,42,1972600,1170
1620,a1409,20130523,4696,4696,4709,4709,4688,4688,4701,-8,5,40,1880680,1182
1621,a1409,20130524,4688,4701,4680,4681,4659,4659,4665,-42,-36,188,8771680,1276
1622,a1409,20130527,4659,4665,4660,4667,4641,4656,4661,-9,-4,88,4101940,1302
1623,a1409,20130528,4656,4661,4662,4662,4652,4658,4657,-3,-4,76,3539620,1370
1624,a1409,20130529,4658,4657,4658,4692,4658,4669,4669,12,12,414,19332920,1448
1625,a1409,20130530,4669,4669,4665,4666,4651,4663,4659,-6,-10,74,3448360,1456
1626,a1409,20130531,4663,4659,4671,4671,4656,4663,4660,4,1,44,2050520,1464
1627,a1409,20130603,4663,4660,4685,4701,4682,4701,4695,41,35,192,9014860,1366
1628,a1409,20130604,4701,4695,4690,4701,4687,4688,4691,-7,-4,38,1782880,1372
1629,a1409,20130605,4688,4691,4697,4700,4690,4696,4695,5,4,46,2159940,1354
1630,a1409,20130606,4696,4695,4681,4696,4680,4690,4686,-5,-9,72,3374440,1304
1631,a1409,20130607,4690,4686,4699,4707,4681,4688,4692,2,6,30,1407700,1318
1632,a1409,20130613,4688,4692,4681,4681,4666,4668,4673,-24,-19,44,2056180,1320
1633,a1409,20130614,4668,4673,4665,4680,4665,4669,4672,-4,-1,44,2056100,1338
1634,a1409,20130617,4669,4672,4665,4675,4656,4674,4666,2,-6,44,2053200,1324
1635,a1409,20130618,4674,4666,4681,4685,4670,4679,4678,13,12,24,1122840,1326
1636,a1409,20130619,4679,4678,4679,4679,4667,4667,4674,-11,-4,78,3645780,1310
1637,a1409,20130620,4667,4674,4668,4672,4661,4661,4668,-13,-6,46,2147420,1308
1638,a1409,20130621,4661,4668,4650,4660,4629,4629,4638,-39,-30,68,3154440,1326
1639,a1409,20130624,4629,4638,4621,4632,4615,4618,4622,-20,-16,136,6286340,1358
1640,a1409,20130625,4618,4622,4630,4645,4628,4645,4633,23,11,14,648660,1356
1641,a1409,20130626,4645,4633,4645,4645,4630,4633,4633,0,0,108,5004640,1452
1642,a1409,20130627,4633,4633,4534,4628,4534,4621,4608,-12,-25,60,2765320,1458
1643,a1409,20130628,4621,4608,4622,4623,4613,4615,4617,7,9,46,2124260,1454
1644,a1409,20130701,4615,4617,4600,4672,4578,4584,4592,-33,-25,188,8634500,1494
1645,a1409,20130702,4584,4592,4589,4600,4589,4600,4594,8,2,124,5697140,1546
1646,a1409,20130703,4600,4594,4594,4612,4594,4608,4604,14,10,36,1657540,1544
1647,a1409,20130704,4608,4604,4612,4620,4612,4614,4616,10,12,26,1200240,1546
1648,a1409,20130705,4614,4616,4636,4636,4619,4623,4625,7,9,16,740060,1548
1649,a1409,20130708,4623,4625,4610,4611,4601,4601,4607,-24,-18,44,2027460,1548
1650,a1409,20130709,4601,4607,4617,4635,4617,4624,4628,17,21,98,4535580,1518
1651,a1409,20130710,4624,4628,4639,4639,4629,4635,4631,7,3,38,1760120,1532
1652,a1409,20130711,4635,4631,4632,4645,4632,4636,4635,5,4,56,2595600,1530
1653,a1409,20130712,4636,4635,4638,4641,4630,4630,4638,-5,3,82,3803960,1488
1654,a1409,20130715,4630,4638,4615,4619,4611,4611,4612,-27,-26,42,1937320,1500
1655,a1409,20130716,4611,4612,4613,4631,4613,4631,4619,19,7,72,3326300,1498
1656,a1409,20130717,4631,4619,4626,4640,4626,4630,4635,11,16,104,4820760,1514
1657,a1409,20130718,4630,4635,4630,4630,4600,4610,4606,-25,-29,320,14740220,1700
1658,a1409,20130719,4610,4606,4608,4608,4557,4557,4584,-49,-22,992,45477460,2004
1659,a1409,20130722,4557,4584,4550,4567,4537,4547,4549,-37,-35,268,12191780,2010
1660,a1409,20130723,4547,4549,4560,4577,4555,4576,4564,27,15,154,7029340,2002
1661,a1409,20130724,4576,4564,4555,4564,4547,4563,4557,-1,-7,142,6471180,1962
1662,a1409,20130725,4563,4557,4551,4553,4491,4498,4514,-59,-43,1238,55893900,2452
1663,a1409,20130726,4498,4514,4490,4490,4334,4334,4394,-180,-120,824,36210420,2660
1664,a1409,20130729,4334,4394,4320,4330,4271,4286,4291,-108,-103,1768,75874820,3116
1665,a1409,20130730,4286,4291,4301,4301,4223,4233,4245,-58,-46,2322,98574480,4106
1666,a1409,20130731,4233,4245,4210,4305,4193,4300,4268,55,23,2172,92715440,3460
1667,a1409,20130801,4300,4268,4280,4317,4277,4297,4295,29,27,830,35654160,3468
1668,a1409,20130802,4297,4295,4279,4302,4267,4302,4286,7,-9,560,24003920,3530
1669,a1409,20130805,4302,4286,4284,4299,4259,4284,4273,-2,-13,568,24275020,3834
1670,a1409,20130806,4284,4273,4284,4285,4257,4263,4265,-10,-8,1610,68678740,4090
1671,a1409,20130807,4263,4265,4250,4265,4195,4200,4212,-65,-53,1706,71863280,4966
1672,a1409,20130808,4200,4212,4215,4237,4212,4214,4219,2,7,970,40931800,5330
1673,a1409,20130809,4214,4219,4233,4235,4186,4192,4210,-27,-9,2612,109982200,6526
1674,a1409,20130812,4192,4210,4192,4227,4191,4225,4213,15,3,1682,70875120,6906
1675,a1409,20130813,4225,4213,4280,4285,4255,4272,4270,59,57,2168,92594920,6822
1676,a1409,20130814,4272,4270,4263,4270,4228,4228,4246,-42,-24,1834,77882020,7708
1677,a1409,20130815,4228,4246,4242,4262,4242,4249,4255,3,9,2264,96348040,8760
1678,a1409,20130816,4249,4255,4276,4298,4257,4264,4272,9,17,2782,118857360,8974
1679,a1409,20130819,4264,4272,4285,4296,4279,4282,4284,10,12,1478,63328640,8962
1680,a1409,20130820,4282,4284,4330,4330,4271,4281,4285,-3,1,2326,99678860,9634
1681,a1409,20130821,4281,4285,4279,4290,4276,4280,4282,-5,-3,866,37083660,9778
1682,a1409,20130822,4280,4282,4278,4294,4278,4292,4285,10,3,1442,61796600,9594
1683,a1409,20130823,4292,4285,4285,4296,4278,4285,4284,0,-1,1124,48153720,9826
1684,a1409,20130826,4285,4284,4321,4445,4321,4430,4397,146,113,4124,181364800,9366
1685,a1409,20130827,4430,4397,4424,4424,4375,4382,4387,-15,-10,1722,75554460,9564
1686,a1409,20130828,4382,4387,4375,4395,4361,4367,4384,-20,-3,1844,80858980,9634
1687,a1409,20130829,4367,4384,4379,4396,4336,4358,4365,-26,-19,1384,60417240,9876
1688,a1409,20130830,4358,4365,4346,4354,4323,4327,4336,-38,-29,1776,77015140,9450
1689,a1409,20130902,4327,4336,4331,4360,4331,4355,4348,19,12,1290,56101080,9400
1690,a1409,20130903,4355,4348,4370,4372,4344,4368,4358,20,10,1252,54567140,9516
1691,a1409,20130904,4368,4358,4351,4352,4332,4348,4347,-10,-11,446,19388280,9680
1692,a1409,20130905,4348,4347,4350,4354,4340,4344,4345,-3,-2,708,30766380,9736
1693,a1409,20130906,4344,4345,4344,4361,4336,4361,4352,16,7,844,36734640,10042
1694,a1409,20130909,4361,4352,4362,4369,4356,4368,4364,16,12,976,42600500,10198
1695,a1409,20130910,4368,4364,4344,4358,4341,4353,4350,-11,-14,876,38114120,9958
1696,a1409,20130911,4353,4350,4357,4389,4353,4387,4369,37,19,1614,70524400,9966
1697,a1409,20130912,4387,4369,4376,4406,4374,4395,4392,26,23,1008,44277420,10004
1698,a1409,20130913,4395,4392,4425,4438,4406,4410,4412,18,20,1692,74665240,10174
1699,a1409,20130916,4410,4412,4380,4390,4368,4368,4379,-44,-33,1520,66561400,10592
1700,a1409,20130917,4368,4379,4360,4384,4355,4367,4365,-12,-14,2166,94565320,11754
1701,a1409,20130918,4367,4365,4362,4389,4362,4385,4378,20,13,1094,47905760,11604
1702,a1409,20130923,4385,4378,4350,4383,4347,4379,4374,1,-4,2220,97123760,11706
1703,a1409,20130924,4379,4374,4384,4409,4378,4408,4391,34,17,2212,97140840,12520
1704,a1409,20130925,4408,4391,4410,4418,4397,4407,4403,16,12,1106,48701080,12630
1705,a1409,20130926,4407,4403,4410,4414,4396,4405,4402,2,-1,906,39890540,12838
1706,a1409,20130927,4405,4402,4403,4403,4383,4393,4391,-9,-11,2334,102507040,12898
1707,a1409,20130930,4393,4391,4390,4413,4377,4404,4403,13,12,1448,63756880,13218
1708,a1409,20131008,4404,4403,4405,4433,4405,4428,4419,25,16,1744,77080880,13238
1709,a1409,20131009,4428,4419,4419,4439,4415,4437,4426,18,7,1726,76408640,14058
1710,a1409,20131010,4437,4426,4444,4475,4437,4467,4461,41,35,10180,454192280,17026
1711,a1409,20131011,4467,4461,4466,4481,4448,4450,4464,-11,3,2518,112407080,17632
1712,a1409,20131014,4450,4464,4462,4473,4440,4459,4458,-5,-6,2578,114927420,17988
1713,a1409,20131015,4459,4458,4457,4470,4451,4457,4460,-1,2,1718,76639900,18294
1714,a1409,20131016,4457,4460,4458,4495,4458,4485,4482,25,22,8806,394751420,21872
1715,a1409,20131017,4485,4482,4492,4499,4461,4470,4478,-12,-4,4148,185763300,22288
1716,a1409,20131018,4470,4478,4482,4490,4473,4483,4481,5,3,2266,101551720,22444
1717,a1409,20131021,4483,4481,4486,4497,4480,4493,4491,12,10,6092,273596720,22394
1718,a1409,20131022,4493,4491,4494,4498,4466,4467,4482,-24,-9,3748,168005120,22070
1719,a1409,20131023,4467,4482,4465,4480,4450,4471,4467,-11,-15,4350,194334880,20868
1720,a1409,20131024,4471,4467,4471,4492,4440,4449,4456,-18,-11,5834,260008680,23082
1721,a1409,20131025,4449,4456,4440,4465,4433,4446,4453,-10,-3,11360,505921180,21116
1722,a1409,20131028,4446,4453,4444,4447,4424,4431,4441,-22,-12,2490,110584880,22058
1723,a1409,20131029,4431,4441,4423,4426,4392,4403,4407,-38,-34,3468,152850200,22034
1724,a1409,20131030,4403,4407,4407,4422,4400,4407,4410,0,3,1530,67477520,22202
1725,a1409,20131031,4407,4410,4412,4430,4396,4424,4421,14,11,2206,97545260,22360
1726,a1409,20131101,4424,4421,4418,4453,4416,4438,4438,17,17,2930,130042580,22816
1727,a1409,20131104,4438,4438,4422,4429,4418,4424,4422,-14,-16,3004,132864820,22202
1728,a1409,20131105,4424,4422,4426,4441,4414,4431,4431,9,9,2154,95447360,21956
1729,a1409,20131106,4431,4431,4421,4434,4413,4413,4422,-18,-9,2006,88705860,22078
1730,a1409,20131107,4413,4422,4414,4435,4408,4434,4425,12,3,2226,98502500,22068
1731,a1409,20131108,4434,4425,4436,4445,4425,4436,4436,11,11,2670,118447160,21920
1732,a1409,20131111,4436,4436,4462,4478,4441,4455,4457,19,21,4476,199529320,21870
1733,a1409,20131112,4455,4457,4459,4465,4440,4449,4450,-8,-7,2004,89184420,21730
1734,a1409,20131113,4449,4450,4458,4458,4449,4451,4455,1,5,1394,62103220,21844
1735,a1409,20131114,4451,4455,4452,4462,4448,4461,4457,6,2,1702,75861800,22000
1736,a1409,20131115,4461,4457,4457,4466,4450,4450,4458,-7,1,2348,104674940,21828
1737,a1409,20131118,4450,4458,4458,4458,4422,4424,4430,-34,-28,4862,215404140,21540
1738,a1409,20131119,4424,4430,4428,4438,4397,4398,4409,-32,-21,6068,267559820,21278
1739,a1409,20131120,4398,4409,4401,4401,4371,4383,4379,-26,-30,7370,322804520,22810
1740,a1409,20131121,4383,4379,4377,4383,4357,4362,4366,-17,-13,7570,330518940,24764
1741,a1409,20131122,4362,4366,4380,4380,4361,4368,4370,2,4,4504,196830400,25224
1742,a1409,20131125,4368,4370,4383,4388,4340,4340,4362,-30,-8,8488,370247960,26908
1743,a1409,20131126,4340,4362,4344,4352,4315,4318,4333,-44,-29,5886,255072400,28278
1744,a1409,20131127,4318,4333,4317,4338,4317,4323,4327,-10,-6,7438,321878940,30762
1745,a1409,20131128,4323,4327,4311,4314,4282,4285,4293,-42,-34,13034,559566520,34968
1746,a1409,20131129,4285,4293,4294,4304,4285,4290,4292,-3,-1,7352,315548620,37242
1747,a1409,20131202,4290,4292,4296,4320,4296,4313,4312,21,20,12268,529115600,39670
1748,a1409,20131203,4313,4312,4307,4326,4296,4321,4317,9,5,8628,372504440,38868
1749,a1409,20131204,4321,4317,4320,4331,4320,4326,4324,9,7,5994,259199280,39942
1750,a1409,20131205,4326,4324,4331,4340,4325,4328,4331,4,7,4992,216226420,39982
1751,a1409,20131206,4328,4331,4331,4334,4314,4319,4321,-12,-10,5278,228098480,39794
1752,a1409,20131209,4319,4321,4322,4355,4318,4351,4336,30,15,9056,392669240,40232
1753,a1409,20131210,4351,4336,4352,4359,4301,4342,4341,6,5,7864,341422040,41678
1754,a1409,20131211,4342,4341,4341,4346,4335,4346,4340,5,-1,2116,91842080,41758
1755,a1409,20131212,4346,4340,4346,4360,4332,4343,4341,3,1,9376,407046220,42238
1756,a1409,20131213,4343,4341,4334,4363,4331,4345,4349,4,8,12950,563310300,42422
1757,a1409,20131216,4345,4349,4350,4418,4349,4398,4393,49,44,24170,1061871160,49954
1758,a1409,20131217,4398,4393,4412,4435,4398,4407,4415,14,22,18388,811885520,51246
1759,a1409,20131218,4407,4415,4410,4419,4379,4388,4392,-27,-23,9432,414263940,52834
1760,a1409,20131219,4388,4392,4370,4407,4370,4399,4397,7,5,6482,285016320,53502
1761,a1409,20131220,4399,4397,4406,4406,4382,4396,4388,-1,-9,9364,410949980,55484
1762,a1409,20131223,4396,4388,4381,4414,4381,4406,4403,18,15,4204,185136720,55406
1763,a1409,20131224,4406,4403,4400,4411,4376,4389,4387,-14,-16,14732,646351000,57160
1764,a1409,20131225,4389,4387,4398,4398,4377,4388,4387,1,0,11228,492595540,57708
1765,a1409,20131226,4388,4387,4397,4397,4377,4377,4381,-10,-6,5170,226548060,57920
1766,a1409,20131227,4377,4381,4372,4392,4360,4383,4380,2,-1,7072,309765100,58316
1767,a1409,20131230,4383,4380,4360,4363,4226,4296,4282,-84,-98,201832,8644445620,84960
1768,a1409,20131231,4296,4282,4288,4325,4288,4321,4312,39,30,43956,1895813640,79940
1769,a1411,20130517,4611,4611,0,0,0,4660,4660,49,49,0,0,0
1770,a1411,20130520,4660,4660,4777,4777,4739,4739,4758,79,98,4,190320,2
1771,a1411,20130521,4739,4758,0,0,0,4739,4739,-19,-19,0,0,2
1772,a1411,20130522,4739,4739,0,0,0,4728,4728,-11,-11,0,0,2
1773,a1411,20130523,4728,4728,0,0,0,4733,4733,5,5,0,0,2
1774,a1411,20130524,4733,4733,0,0,0,4700,4700,-33,-33,0,0,2
1775,a1411,20130527,4700,4700,0,0,0,4696,4696,-4,-4,0,0,2
1776,a1411,20130528,4696,4696,0,0,0,4692,4692,-4,-4,0,0,2
1777,a1411,20130529,4692,4692,0,0,0,4704,4704,12,12,0,0,2
1778,a1411,20130530,4704,4704,4596,4596,4596,4596,4596,-108,-108,2,91920,4
1779,a1411,20130531,4596,4596,0,0,0,4596,4596,0,0,0,0,4
1780,a1411,20130603,4596,4596,0,0,0,4600,4600,4,4,0,0,4
1781,a1411,20130604,4600,4600,0,0,0,4626,4626,26,26,0,0,4
1782,a1411,20130605,4626,4626,0,0,0,4626,4626,0,0,0,0,4
1783,a1411,20130606,4626,4626,0,0,0,4626,4626,0,0,0,0,4
1784,a1411,20130607,4626,4626,0,0,0,4631,4631,5,5,0,0,4
1785,a1411,20130613,4631,4631,0,0,0,4631,4631,0,0,0,0,4
1786,a1411,20130614,4631,4631,0,0,0,4631,4631,0,0,0,0,4
1787,a1411,20130617,4631,4631,0,0,0,4631,4631,0,0,0,0,4
1788,a1411,20130618,4631,4631,4747,4747,4640,4640,4693,9,62,4,187740,4
1789,a1411,20130619,4640,4693,0,0,0,4690,4690,-3,-3,0,0,4
1790,a1411,20130620,4690,4690,0,0,0,4690,4690,0,0,0,0,4
1791,a1411,20130621,4690,4690,0,0,0,4690,4690,0,0,0,0,4
1792,a1411,20130624,4690,4690,0,0,0,4674,4674,-16,-16,0,0,4
1793,a1411,20130625,4674,4674,0,0,0,4674,4674,0,0,0,0,4
1794,a1411,20130626,4674,4674,0,0,0,4640,4640,-34,-34,0,0,4
1795,a1411,20130627,4640,4640,0,0,0,4615,4615,-25,-25,0,0,4
1796,a1411,20130628,4615,4615,4587,4689,4587,4689,4638,74,23,4,185520,2
1797,a1411,20130701,4689,4638,0,0,0,4620,4620,-18,-18,0,0,2
1798,a1411,20130702,4620,4620,0,0,0,4620,4620,0,0,0,0,2
1799,a1411,20130703,4620,4620,0,0,0,4630,4630,10,10,0,0,2
1800,a1411,20130704,4630,4630,0,0,0,4642,4642,12,12,0,0,2
1801,a1411,20130705,4642,4642,0,0,0,4651,4651,9,9,0,0,2
1802,a1411,20130708,4651,4651,4592,4592,4592,4592,4592,-59,-59,2,91840,2
1803,a1411,20130709,4592,4592,0,0,0,4592,4592,0,0,0,0,2
1804,a1411,20130710,4592,4592,0,0,0,4594,4594,2,2,0,0,2
1805,a1411,20130711,4594,4594,0,0,0,4597,4597,3,3,0,0,2
1806,a1411,20130712,4597,4597,0,0,0,4619,4619,22,22,0,0,2
1807,a1411,20130715,4619,4619,0,0,0,4594,4594,-25,-25,0,0,2
1808,a1411,20130716,4594,4594,0,0,0,4600,4600,6,6,0,0,2
1809,a1411,20130717,4600,4600,0,0,0,4615,4615,15,15,0,0,2
1810,a1411,20130718,4615,4615,0,0,0,4615,4615,0,0,0,0,2
1811,a1411,20130719,4615,4615,4573,4573,4572,4572,4572,-43,-43,4,182900,4
1812,a1411,20130722,4572,4572,0,0,0,4538,4538,-34,-34,0,0,4
1813,a1411,20130723,4538,4538,0,0,0,4552,4552,14,14,0,0,4
1814,a1411,20130724,4552,4552,0,0,0,4552,4552,0,0,0,0,4
1815,a1411,20130725,4552,4552,4552,4552,4552,4552,4552,0,0,2,91040,6
1816,a1411,20130726,4552,4552,0,0,0,4431,4431,-121,-121,0,0,6
1817,a1411,20130729,4431,4431,0,0,0,4328,4328,-103,-103,0,0,6
1818,a1411,20130730,4328,4328,0,0,0,4270,4270,-58,-58,0,0,6
1819,a1411,20130731,4270,4270,0,0,0,4295,4295,25,25,0,0,6
1820,a1411,20130801,4295,4295,0,0,0,4295,4295,0,0,0,0,6
1821,a1411,20130802,4295,4295,0,0,0,4295,4295,0,0,0,0,6
1822,a1411,20130805,4295,4295,0,0,0,4295,4295,0,0,0,0,6
1823,a1411,20130806,4295,4295,0,0,0,4295,4295,0,0,0,0,6
1824,a1411,20130807,4295,4295,4261,4261,4210,4218,4227,-77,-68,8,338200,8
1825,a1411,20130808,4218,4227,4264,4264,4221,4221,4239,-6,12,8,339120,8
1826,a1411,20130809,4221,4239,4208,4240,4208,4217,4217,-22,-22,26,1096620,28
1827,a1411,20130812,4217,4217,0,0,0,4217,4217,0,0,0,0,28
1828,a1411,20130813,4217,4217,4280,4280,4280,4280,4280,63,63,4,171200,24
1829,a1411,20130814,4280,4280,4206,4300,4206,4260,4258,-20,-22,24,1022120,6
1830,a1411,20130815,4260,4258,0,0,0,4258,4258,0,0,0,0,6
1831,a1411,20130816,4258,4258,0,0,0,4275,4275,17,17,0,0,6
1832,a1411,20130819,4275,4275,0,0,0,4275,4275,0,0,0,0,6
1833,a1411,20130820,4275,4275,0,0,0,4275,4275,0,0,0,0,6
1834,a1411,20130821,4275,4275,0,0,0,4275,4275,0,0,0,0,6
1835,a1411,20130822,4275,4275,4297,4298,4297,4298,4297,23,22,4,171900,10
1836,a1411,20130823,4298,4297,4297,4297,4276,4283,4285,-14,-12,20,857040,12
1837,a1411,20130826,4283,4285,4412,4443,4400,4443,4424,158,139,8,353960,20
1838,a1411,20130827,4443,4424,0,0,0,4424,4424,0,0,0,0,20
1839,a1411,20130828,4424,4424,4384,4384,4384,4384,4384,-40,-40,2,87680,18
1840,a1411,20130829,4384,4384,4360,4363,4360,4363,4361,-21,-23,4,174460,18
1841,a1411,20130830,4363,4361,0,0,0,4350,4350,-11,-11,0,0,18
1842,a1411,20130902,4350,4350,4334,4334,4334,4334,4334,-16,-16,2,86680,18
1843,a1411,20130903,4334,4334,0,0,0,4343,4343,9,9,0,0,18
1844,a1411,20130904,4343,4343,0,0,0,4343,4343,0,0,0,0,18
1845,a1411,20130905,4343,4343,0,0,0,4343,4343,0,0,0,0,18
1846,a1411,20130906,4343,4343,0,0,0,4349,4349,6,6,0,0,18
1847,a1411,20130909,4349,4349,0,0,0,4360,4360,11,11,0,0,18
1848,a1411,20130910,4360,4360,0,0,0,4355,4355,-5,-5,0,0,18
1849,a1411,20130911,4355,4355,0,0,0,4363,4363,8,8,0,0,18
1850,a1411,20130912,4363,4363,0,0,0,4363,4363,0,0,0,0,18
1851,a1411,20130913,4363,4363,0,0,0,4377,4377,14,14,0,0,18
1852,a1411,20130916,4377,4377,0,0,0,4377,4377,0,0,0,0,18
1853,a1411,20130917,4377,4377,0,0,0,4370,4370,-7,-7,0,0,18
1854,a1411,20130918,4370,4370,0,0,0,4370,4370,0,0,0,0,18
1855,a1411,20130923,4370,4370,0,0,0,4370,4370,0,0,0,0,18
1856,a1411,20130924,4370,4370,4385,4392,4385,4392,4388,22,18,10,438820,20
1857,a1411,20130925,4392,4388,0,0,0,4388,4388,0,0,0,0,20
1858,a1411,20130926,4388,4388,4370,4370,4370,4370,4370,-18,-18,2,87400,20
1859,a1411,20130927,4370,4370,0,0,0,4370,4370,0,0,0,0,20
1860,a1411,20130930,4370,4370,0,0,0,4381,4381,11,11,0,0,20
1861,a1411,20131008,4381,4381,0,0,0,4385,4385,4,4,0,0,20
1862,a1411,20131009,4385,4385,4402,4402,4402,4402,4402,17,17,2,88040,20
1863,a1411,20131010,4402,4402,4418,4418,4418,4418,4418,16,16,2,88360,20
1864,a1411,20131011,4418,4418,0,0,0,4418,4418,0,0,0,0,20
1865,a1411,20131014,4418,4418,0,0,0,4418,4418,0,0,0,0,20
1866,a1411,20131015,4418,4418,0,0,0,4418,4418,0,0,0,0,20
1867,a1411,20131016,4418,4418,0,0,0,4418,4418,0,0,0,0,20
1868,a1411,20131017,4418,4418,0,0,0,4422,4422,4,4,0,0,20
1869,a1411,20131018,4422,4422,0,0,0,4422,4422,0,0,0,0,20
1870,a1411,20131021,4422,4422,0,0,0,4432,4432,10,10,0,0,20
1871,a1411,20131022,4432,4432,0,0,0,4432,4432,0,0,0,0,20
1872,a1411,20131023,4432,4432,0,0,0,4432,4432,0,0,0,0,20
1873,a1411,20131024,4432,4432,0,0,0,4422,4422,-10,-10,0,0,20
1874,a1411,20131025,4422,4422,4420,4420,4420,4420,4420,-2,-2,2,88400,18
1875,a1411,20131028,4420,4420,0,0,0,4420,4420,0,0,0,0,18
1876,a1411,20131029,4420,4420,0,0,0,4387,4387,-33,-33,0,0,18
1877,a1411,20131030,4387,4387,0,0,0,4387,4387,0,0,0,0,18
1878,a1411,20131031,4387,4387,0,0,0,4390,4390,3,3,0,0,18
1879,a1411,20131101,4390,4390,4410,4410,4410,4410,4410,20,20,2,88200,16
1880,a1411,20131104,4410,4410,0,0,0,4404,4404,-6,-6,0,0,16
1881,a1411,20131105,4404,4404,0,0,0,4404,4404,0,0,0,0,16
1882,a1411,20131106,4404,4404,0,0,0,4403,4403,-1,-1,0,0,16
1883,a1411,20131107,4403,4403,0,0,0,4403,4403,0,0,0,0,16
1884,a1411,20131108,4403,4403,0,0,0,4403,4403,0,0,0,0,16
1885,a1411,20131111,4403,4403,0,0,0,4420,4420,17,17,0,0,16
1886,a1411,20131112,4420,4420,0,0,0,4414,4414,-6,-6,0,0,16
1887,a1411,20131113,4414,4414,0,0,0,4418,4418,4,4,0,0,16
1888,a1411,20131114,4418,4418,4465,4584,4441,4441,4532,23,114,100,4532340,100
1889,a1411,20131115,4441,4532,4467,4468,4456,4458,4462,-74,-70,32,1427920,124
1890,a1411,20131118,4458,4462,4461,4461,4448,4448,4455,-14,-7,34,1514920,132
1891,a1411,20131119,4448,4455,4442,4442,4383,4408,4401,-47,-54,16,704220,128
1892,a1411,20131120,4408,4401,4390,4390,4390,4390,4390,-11,-11,2,87800,128
1893,a1411,20131121,4390,4390,0,0,0,4377,4377,-13,-13,0,0,128
1894,a1411,20131122,4377,4377,4343,4420,4343,4385,4385,8,8,18,789360,126
1895,a1411,20131125,4385,4385,4381,4383,4380,4380,4381,-5,-4,10,438100,124
1896,a1411,20131126,4380,4381,4356,4359,4351,4355,4354,-26,-27,30,1306200,124
1897,a1411,20131127,4355,4354,4361,4361,4361,4361,4361,7,7,2,87220,124
1898,a1411,20131128,4361,4361,4351,4351,4320,4320,4326,-41,-35,12,519220,128
1899,a1411,20131129,4320,4326,4309,4318,4309,4316,4315,-10,-11,10,431540,132
1900,a1411,20131202,4316,4315,4333,4333,4333,4333,4333,18,18,2,86660,130
1901,a1411,20131203,4333,4333,0,0,0,4333,4333,0,0,0,0,130
1902,a1411,20131204,4333,4333,0,0,0,4333,4333,0,0,0,0,130
1903,a1411,20131205,4333,4333,0,0,0,4333,4333,0,0,0,0,130
1904,a1411,20131206,4333,4333,0,0,0,4333,4333,0,0,0,0,130
1905,a1411,20131209,4333,4333,0,0,0,4333,4333,0,0,0,0,130
1906,a1411,20131210,4333,4333,0,0,0,4333,4333,0,0,0,0,130
1907,a1411,20131211,4333,4333,0,0,0,4333,4333,0,0,0,0,130
1908,a1411,20131212,4333,4333,0,0,0,4333,4333,0,0,0,0,130
1909,a1411,20131213,4333,4333,0,0,0,4333,4333,0,0,0,0,130
1910,a1411,20131216,4333,4333,4384,4386,4384,4386,4385,53,52,4,175400,128
1911,a1411,20131217,4386,4385,4439,4439,4439,4439,4439,54,54,2,88780,126
1912,a1411,20131218,4439,4439,0,0,0,4414,4414,-25,-25,0,0,126
1913,a1411,20131219,4414,4414,4416,4416,4393,4393,4404,-21,-10,4,176180,126
1914,a1411,20131220,4393,4404,0,0,0,4404,4404,0,0,0,0,126
1915,a1411,20131223,4404,4404,0,0,0,4404,4404,0,0,0,0,126
1916,a1411,20131224,4404,4404,4349,4431,4349,4405,4397,1,-7,8,351780,128
1917,a1411,20131225,4405,4397,4386,4386,4386,4386,4386,-11,-11,2,87720,126
1918,a1411,20131226,4386,4386,0,0,0,4386,4386,0,0,0,0,126
1919,a1411,20131227,4386,4386,0,0,0,4386,4386,0,0,0,0,126
1920,a1411,20131230,4386,4386,4327,4338,4234,4322,4298,-64,-88,44,1891160,128
1921,a1411,20131231,4322,4298,4301,4319,4300,4319,4306,21,8,16,689000,134
1922,a1501,20130716,4635,4635,4682,4682,4682,4682,4682,47,47,2,93640,2
1923,a1501,20130717,4682,4682,0,0,0,4682,4682,0,0,0,0,2
1924,a1501,20130718,4682,4682,4607,4619,4599,4601,4602,-81,-80,36,1657020,26
1925,a1501,20130719,4601,4602,4601,4601,4550,4564,4581,-38,-21,224,10262760,204
1926,a1501,20130722,4564,4581,4544,4550,4536,4549,4544,-32,-37,178,8089920,272
1927,a1501,20130723,4549,4544,4557,4563,4550,4563,4553,19,9,44,2003580,282
1928,a1501,20130724,4563,4553,4550,4554,4545,4547,4550,-6,-3,38,1729060,282
1929,a1501,20130725,4547,4550,4519,4525,4491,4501,4502,-49,-48,56,2521240,312
1930,a1501,20130726,4501,4502,4490,4490,4322,4358,4389,-144,-113,226,9919580,390
1931,a1501,20130729,4358,4389,4350,4355,4300,4300,4327,-89,-62,240,10385980,440
1932,a1501,20130730,4300,4327,4297,4297,4231,4246,4255,-81,-72,150,6382700,510
1933,a1501,20130731,4246,4255,4220,4308,4202,4303,4276,48,21,394,16848740,524
1934,a1501,20130801,4303,4276,4310,4317,4280,4301,4297,25,21,250,10744700,532
1935,a1501,20130802,4301,4297,4295,4302,4281,4298,4293,1,-4,50,2146720,532
1936,a1501,20130805,4298,4293,4295,4304,4273,4294,4292,1,-1,126,5409080,586
1937,a1501,20130806,4294,4292,4281,4298,4268,4273,4275,-19,-17,346,14794820,736
1938,a1501,20130807,4273,4275,4260,4260,4216,4216,4232,-59,-43,280,11850060,776
1939,a1501,20130808,4216,4232,4232,4250,4225,4235,4237,3,5,160,6780180,784
1940,a1501,20130809,4235,4237,4239,4243,4205,4211,4218,-26,-19,118,4977600,856
1941,a1501,20130812,4211,4218,4213,4238,4213,4238,4227,20,9,284,12004860,1002
1942,a1501,20130813,4238,4227,4252,4295,4252,4289,4285,62,58,142,6085080,1008
1943,a1501,20130814,4289,4285,4277,4289,4241,4241,4262,-44,-23,306,13044540,1072
1944,a1501,20130815,4241,4262,4265,4273,4257,4259,4265,-3,3,310,13224200,1106
1945,a1501,20130816,4259,4265,4289,4296,4266,4266,4281,1,16,392,16784240,1238
1946,a1501,20130819,4266,4281,4292,4292,4277,4285,4284,4,3,78,3341940,1250
1947,a1501,20130820,4285,4284,4300,4304,4274,4277,4290,-7,6,204,8751740,1172
1948,a1501,20130821,4277,4290,4289,4291,4280,4288,4285,-2,-5,38,1628380,1186
1949,a1501,20130822,4288,4285,4286,4296,4285,4296,4289,11,4,210,9008220,1190
1950,a1501,20130823,4296,4289,4284,4284,4284,4284,4284,-5,-5,2,85680,1192
1951,a1501,20130826,4284,4284,4310,4443,4310,4434,4395,150,111,178,7823460,1210
1952,a1501,20130827,4434,4395,4410,4414,4372,4388,4387,-7,-8,194,8512000,1284
1953,a1501,20130828,4388,4387,4371,4392,4368,4368,4384,-19,-3,252,11048460,1280
1954,a1501,20130829,4368,4384,4388,4399,4340,4350,4377,-34,-7,154,6741440,1370
1955,a1501,20130830,4350,4377,4330,4349,4323,4330,4336,-47,-41,56,2428640,1414
1956,a1501,20130902,4330,4336,4353,4370,4347,4348,4352,12,16,122,5309680,1424
1957,a1501,20130903,4348,4352,4348,4361,4348,4361,4353,9,1,58,2524740,1402
1958,a1501,20130904,4361,4353,4347,4353,4347,4350,4350,-3,-3,20,870100,1418
1959,a1501,20130905,4350,4350,4356,4356,4340,4340,4346,-10,-4,38,1651560,1426
1960,a1501,20130906,4340,4346,4350,4357,4347,4357,4351,11,5,36,1566540,1424
1961,a1501,20130909,4357,4351,4357,4362,4357,4361,4359,10,8,16,697580,1414
1962,a1501,20130910,4361,4359,4351,4354,4343,4352,4348,-7,-11,36,1565460,1406
1963,a1501,20130911,4352,4348,4343,4380,4343,4380,4366,32,18,46,2008480,1408
1964,a1501,20130912,4380,4366,4380,4402,4375,4391,4391,25,25,126,5533440,1384
1965,a1501,20130913,4391,4391,4410,4439,4404,4408,4410,17,19,320,14115140,1378
1966,a1501,20130916,4408,4410,4390,4395,4380,4380,4388,-30,-22,196,8600980,1428
1967,a1501,20130917,4380,4388,4380,4387,4365,4373,4378,-15,-10,214,9370320,1444
1968,a1501,20130918,4373,4378,4376,4390,4366,4386,4379,8,1,100,4379200,1418
1969,a1501,20130923,4386,4379,4360,4383,4360,4382,4376,3,-3,12,525140,1420
1970,a1501,20130924,4382,4376,4390,4410,4387,4410,4396,34,20,48,2110320,1404
1971,a1501,20130925,4410,4396,4405,4416,4400,4410,4409,14,13,240,10583440,1440
1972,a1501,20130926,4410,4409,4411,4412,4400,4409,4404,0,-5,42,1849800,1448
1973,a1501,20130927,4409,4404,4409,4411,4393,4400,4400,-4,-4,652,28689100,1940
1974,a1501,20130930,4400,4400,4390,4410,4390,4409,4406,9,6,88,3877780,1920
1975,a1501,20131008,4409,4406,4413,4430,4413,4427,4418,21,12,166,7335220,1894
1976,a1501,20131009,4427,4418,4432,4432,4415,4420,4417,2,-1,550,24294140,2300
1977,a1501,20131010,4420,4417,4424,4434,4422,4424,4429,7,12,890,39421600,2890
1978,a1501,20131011,4424,4429,4426,4430,4412,4412,4423,-17,-6,286,12652220,3034
1979,a1501,20131014,4412,4423,4422,4441,4415,4431,4433,8,10,144,6384680,2994
1980,a1501,20131015,4431,4433,4436,4437,4408,4410,4419,-23,-14,332,14672200,3070
1981,a1501,20131016,4410,4419,4419,4428,4410,4418,4418,-1,-1,554,24476520,3282
1982,a1501,20131017,4418,4418,4428,4437,4413,4415,4420,-3,2,1204,53224540,3560
1983,a1501,20131018,4415,4420,4421,4424,4418,4424,4420,4,0,54,2387020,3566
1984,a1501,20131021,4424,4420,4420,4435,4411,4435,4425,15,5,238,10532860,3594
1985,a1501,20131022,4435,4425,4438,4443,4415,4418,4428,-7,3,154,6819540,3660
1986,a1501,20131023,4418,4428,4419,4428,4411,4418,4418,-10,-10,166,7334840,3698
1987,a1501,20131024,4418,4418,4421,4428,4409,4412,4413,-6,-5,292,12888480,3792
1988,a1501,20131025,4412,4413,4409,4414,4389,4393,4400,-20,-13,788,34672860,4118
1989,a1501,20131028,4393,4400,4388,4403,4380,4391,4393,-9,-7,80,3514720,4122
1990,a1501,20131029,4391,4393,4386,4390,4370,4374,4376,-19,-17,466,20394500,3988
1991,a1501,20131030,4374,4376,4379,4390,4379,4381,4382,5,6,860,37692420,4090
1992,a1501,20131031,4381,4382,4371,4402,4370,4399,4392,17,10,232,10191480,4026
1993,a1501,20131101,4399,4392,4407,4411,4401,4406,4406,14,14,386,17009140,4030
1994,a1501,20131104,4406,4406,4400,4401,4394,4401,4397,-5,-9,126,5540780,4106
1995,a1501,20131105,4401,4397,4408,4408,4396,4407,4404,10,7,110,4845140,4082
1996,a1501,20131106,4407,4404,4397,4401,4393,4393,4397,-11,-7,146,6419720,4114
1997,a1501,20131107,4393,4397,4389,4404,4383,4403,4395,6,-2,100,4395060,4116
1998,a1501,20131108,4403,4395,4406,4411,4400,4400,4406,5,11,98,4317900,4050
1999,a1501,20131111,4400,4406,4419,4430,4414,4420,4423,14,17,530,23446200,3996
2000,a1501,20131112,4420,4423,4420,4430,4400,4411,4408,-12,-15,382,16838620,4038
2001,a1501,20131113,4411,4408,4411,4420,4411,4413,4415,5,7,112,4945780,4024
2002,a1501,20131114,4413,4415,4421,4430,4417,4426,4424,11,9,234,10353540,4028
2003,a1501,20131115,4426,4424,4426,4430,4417,4419,4426,-5,2,178,7879740,4014
2004,a1501,20131118,4419,4426,4415,4415,4390,4390,4399,-36,-27,1228,54027740,4870
2005,a1501,20131119,4390,4399,4391,4392,4357,4360,4374,-39,-25,2988,130700460,5682
2006,a1501,20131120,4360,4374,4360,4360,4336,4341,4342,-33,-32,2830,122897680,6636
2007,a1501,20131121,4341,4342,4342,4342,4324,4327,4329,-15,-13,640,27706120,6942
2008,a1501,20131122,4327,4329,4341,4344,4327,4331,4331,2,2,488,21139740,7026
2009,a1501,20131125,4331,4331,4348,4348,4310,4310,4320,-21,-11,2158,93230360,7246
2010,a1501,20131126,4310,4320,4314,4319,4281,4290,4303,-30,-17,946,40712880,7394
2011,a1501,20131127,4290,4303,4294,4300,4288,4291,4293,-12,-10,1272,54608820,7576
2012,a1501,20131128,4291,4293,4276,4280,4251,4254,4264,-39,-29,1692,72153960,8576
2013,a1501,20131129,4254,4264,4259,4266,4254,4257,4256,-7,-8,816,34736340,8768
2014,a1501,20131202,4257,4256,4264,4273,4262,4272,4268,16,12,1142,48742580,9254
2015,a1501,20131203,4272,4268,4266,4279,4257,4276,4272,8,4,1992,85117800,9124
2016,a1501,20131204,4276,4272,4274,4282,4274,4282,4278,10,6,936,40042800,9202
2017,a1501,20131205,4282,4278,4287,4297,4277,4281,4285,3,7,986,42252020,9310
2018,a1501,20131206,4281,4285,4289,4289,4268,4274,4274,-11,-11,756,32311720,9370
2019,a1501,20131209,4274,4274,4275,4305,4273,4304,4291,30,17,1280,54925920,9734
2020,a1501,20131210,4304,4291,4304,4320,4293,4298,4296,7,5,1454,62476640,10582
2021,a1501,20131211,4298,4296,4293,4306,4290,4302,4298,6,2,906,38945340,10628
2022,a1501,20131212,4302,4298,4303,4309,4286,4296,4294,-2,-4,1670,71722220,10052
2023,a1501,20131213,4296,4294,4297,4314,4291,4304,4300,10,6,1956,84111360,9550
2024,a1501,20131216,4304,4300,4308,4360,4306,4344,4336,44,36,1842,79885440,8820
2025,a1501,20131217,4344,4336,4340,4395,4340,4372,4380,36,44,5556,243355980,8708
2026,a1501,20131218,4372,4380,4376,4389,4360,4369,4369,-11,-11,902,39416680,8656
2027,a1501,20131219,4369,4369,4360,4388,4359,4378,4375,9,6,2222,97227980,9796
2028,a1501,20131220,4378,4375,4383,4383,4368,4377,4372,2,-3,574,25096880,9596
2029,a1501,20131223,4377,4372,4386,4395,4380,4387,4385,15,13,440,19294880,9604
2030,a1501,20131224,4387,4385,4381,4387,4364,4373,4374,-12,-11,700,30618440,9662
2031,a1501,20131225,4373,4374,4375,4379,4349,4358,4356,-16,-18,2568,111873700,10054
2032,a1501,20131226,4358,4356,4363,4366,4350,4355,4351,-1,-5,888,38643820,10114
2033,a1501,20131227,4355,4351,4340,4360,4340,4356,4356,5,5,688,29970420,10574
2034,a1501,20131230,4356,4356,4290,4334,4182,4194,4205,-162,-151,91128,3832451780,50622
2035,a1501,20131231,4194,4205,4190,4210,4171,4196,4187,-9,-18,34554,1446989140,56212
2036,a1503,20130917,4366,4366,0,0,0,4357,4357,-9,-9,0,0,0
2037,a1503,20130918,4357,4357,4423,4423,4388,4388,4405,31,48,4,176220,2
2038,a1503,20130923,4388,4405,4331,4331,4331,4331,4331,-74,-74,2,86620,2
2039,a1503,20130924,4331,4331,4383,4383,4383,4383,4383,52,52,2,87660,4
2040,a1503,20130925,4383,4383,0,0,0,4395,4395,12,12,0,0,4
2041,a1503,20130926,4395,4395,0,0,0,4395,4395,0,0,0,0,4
2042,a1503,20130927,4395,4395,0,0,0,4395,4395,0,0,0,0,4
2043,a1503,20130930,4395,4395,4398,4398,4398,4398,4398,3,3,2,87960,4
2044,a1503,20131008,4398,4398,0,0,0,4398,4398,0,0,0,0,4
2045,a1503,20131009,4398,4398,0,0,0,4398,4398,0,0,0,0,4
2046,a1503,20131010,4398,4398,0,0,0,4409,4409,11,11,0,0,4
2047,a1503,20131011,4409,4409,0,0,0,4409,4409,0,0,0,0,4
2048,a1503,20131014,4409,4409,4439,4457,4429,4430,4437,21,28,10,443700,6
2049,a1503,20131015,4430,4437,4401,4422,4401,4404,4410,-33,-27,22,970280,8
2050,a1503,20131016,4404,4410,0,0,0,4410,4410,0,0,0,0,8
2051,a1503,20131017,4410,4410,4437,4438,4401,4418,4424,8,14,36,1592820,30
2052,a1503,20131018,4418,4424,4421,4421,4421,4421,4421,-3,-3,4,176840,34
2053,a1503,20131021,4421,4421,4434,4435,4434,4435,4434,14,13,8,354760,38
2054,a1503,20131022,4435,4434,4419,4419,4419,4419,4419,-15,-15,4,176760,42
2055,a1503,20131023,4419,4419,4430,4430,4416,4421,4421,2,2,16,707460,48
2056,a1503,20131024,4421,4421,4407,4413,4407,4413,4411,-8,-10,6,264660,44
2057,a1503,20131025,4413,4411,4391,4391,4391,4391,4391,-20,-20,14,614740,58
2058,a1503,20131028,4391,4391,4401,4401,4401,4401,4401,10,10,2,88020,58
2059,a1503,20131029,4401,4401,4367,4367,4367,4367,4367,-34,-34,2,87340,60
2060,a1503,20131030,4367,4367,4385,4385,4379,4379,4382,12,15,4,175280,60
2061,a1503,20131031,4379,4382,0,0,0,4391,4391,9,9,0,0,60
2062,a1503,20131101,4391,4391,4409,4410,4409,4410,4409,19,18,6,264580,62
2063,a1503,20131104,4410,4409,0,0,0,4400,4400,-9,-9,0,0,62
2064,a1503,20131105,4400,4400,4400,4400,4400,4400,4400,0,0,8,352000,70
2065,a1503,20131106,4400,4400,0,0,0,4400,4400,0,0,0,0,70
2066,a1503,20131107,4400,4400,4385,4385,4385,4385,4385,-15,-15,4,175400,70
2067,a1503,20131108,4385,4385,0,0,0,4385,4385,0,0,0,0,70
2068,a1503,20131111,4385,4385,4393,4393,4393,4393,4393,8,8,2,87860,70
2069,a1503,20131112,4393,4393,0,0,0,4393,4393,0,0,0,0,70
2070,a1503,20131113,4393,4393,4409,4410,4409,4410,4409,17,16,6,264580,74
2071,a1503,20131114,4410,4409,0,0,0,4417,4417,8,8,0,0,74
2072,a1503,20131115,4417,4417,0,0,0,4418,4418,1,1,0,0,74
2073,a1503,20131118,4418,4418,4412,4412,4408,4408,4409,-10,-9,16,705500,72
2074,a1503,20131119,4408,4409,4374,4374,4365,4365,4371,-44,-38,6,262260,66
2075,a1503,20131120,4365,4371,4349,4350,4349,4350,4349,-21,-22,14,608960,66
2076,a1503,20131121,4350,4349,4340,4340,4340,4340,4340,-9,-9,2,86800,66
2077,a1503,20131122,4340,4340,4392,4392,4359,4359,4370,19,30,6,262220,68
2078,a1503,20131125,4359,4370,4345,4345,4345,4345,4345,-25,-25,4,173800,68
2079,a1503,20131126,4345,4345,0,0,0,4340,4340,-5,-5,0,0,68
2080,a1503,20131127,4340,4340,0,0,0,4330,4330,-10,-10,0,0,68
2081,a1503,20131128,4330,4330,4268,4268,4268,4268,4268,-62,-62,4,170720,68
2082,a1503,20131129,4268,4268,4293,4294,4293,4294,4293,26,25,4,171740,66
2083,a1503,20131202,4294,4293,0,0,0,4293,4293,0,0,0,0,66
2084,a1503,20131203,4293,4293,4304,4304,4304,4304,4304,11,11,2,86080,64
2085,a1503,20131204,4304,4304,4313,4313,4306,4306,4310,2,6,6,258620,66
2086,a1503,20131205,4306,4310,4336,4336,4312,4312,4324,2,14,4,172960,66
2087,a1503,20131206,4312,4324,0,0,0,4313,4313,-11,-11,0,0,66
2088,a1503,20131209,4313,4313,0,0,0,4321,4321,8,8,0,0,66
2089,a1503,20131210,4321,4321,4324,4327,4324,4325,4325,4,4,32,1384300,78
2090,a1503,20131211,4325,4325,0,0,0,4325,4325,0,0,0,0,78
2091,a1503,20131212,4325,4325,4332,4332,4322,4322,4327,-3,2,4,173080,78
2092,a1503,20131213,4322,4327,0,0,0,4327,4327,0,0,0,0,78
2093,a1503,20131216,4327,4327,4355,4360,4355,4360,4356,33,29,22,958500,70
2094,a1503,20131217,4360,4356,0,0,0,4379,4379,23,23,0,0,70
2095,a1503,20131218,4379,4379,0,0,0,4379,4379,0,0,0,0,70
2096,a1503,20131219,4379,4379,0,0,0,4379,4379,0,0,0,0,70
2097,a1503,20131220,4379,4379,0,0,0,4376,4376,-3,-3,0,0,70
2098,a1503,20131223,4376,4376,0,0,0,4389,4389,13,13,0,0,70
2099,a1503,20131224,4389,4389,4374,4400,4374,4400,4387,11,-2,4,175480,70
2100,a1503,20131225,4400,4387,4370,4372,4370,4371,4371,-16,-16,12,524560,64
2101,a1503,20131226,4371,4371,0,0,0,4371,4371,0,0,0,0,64
2102,a1503,20131227,4371,4371,0,0,0,4371,4371,0,0,0,0,64
2103,a1503,20131230,4371,4371,4268,4268,4231,4268,4245,-103,-126,26,1103720,66
2104,a1503,20131231,4268,4245,4243,4243,4243,4243,4243,-2,-2,10,424300,66
2105,a1505,20131118,4410,4405,4410,4412,4400,4401,4409,-4,4,50,2204780,50
2106,a1505,20131119,4401,4409,4401,4401,4367,4367,4378,-42,-31,18,788060,60
2107,a1505,20131120,4367,4378,4356,4356,4350,4350,4351,-28,-27,26,1131340,86
2108,a1505,20131121,4350,4351,4367,4370,4350,4352,4356,1,5,76,3311200,150
2109,a1505,20131122,4352,4356,4355,4369,4353,4357,4358,1,2,22,958760,150
2110,a1505,20131125,4357,4358,4350,4350,4330,4330,4340,-28,-18,18,781200,144
2111,a1505,20131126,4330,4340,4336,4336,4321,4321,4329,-19,-11,8,346380,146
2112,a1505,20131127,4321,4329,4349,4349,4321,4328,4329,-1,0,44,1904980,180
2113,a1505,20131128,4328,4329,4301,4328,4285,4285,4306,-44,-23,276,11886560,322
2114,a1505,20131129,4285,4306,4294,4300,4287,4290,4293,-16,-13,56,2404440,348
2115,a1505,20131202,4290,4293,4294,4297,4288,4290,4292,-3,-1,10,429260,350
2116,a1505,20131203,4290,4292,4300,4306,4295,4295,4300,3,8,14,602040,346
2117,a1505,20131204,4295,4300,4304,4304,4303,4303,4303,3,3,10,430380,342
2118,a1505,20131205,4303,4303,4314,4339,4306,4310,4309,7,6,34,1465380,340
2119,a1505,20131206,4310,4309,4322,4322,4302,4309,4311,0,2,30,1293380,350
2120,a1505,20131209,4309,4311,4310,4331,4306,4331,4313,20,2,22,948900,344
2121,a1505,20131210,4331,4313,4328,4330,4328,4330,4329,17,16,4,173160,346
2122,a1505,20131211,4330,4329,4324,4329,4324,4329,4326,0,-3,4,173060,348
2123,a1505,20131212,4329,4326,4333,4333,4310,4310,4327,-16,1,16,692360,354
2124,a1505,20131213,4310,4327,4301,4320,4301,4305,4311,-22,-16,8,344900,356
2125,a1505,20131216,4305,4311,4355,4368,4328,4346,4351,35,40,58,2524040,374
2126,a1505,20131217,4346,4351,4349,4399,4349,4383,4376,32,25,40,1750440,384
2127,a1505,20131218,4383,4376,4380,4386,4365,4374,4376,-2,0,42,1838260,422
2128,a1505,20131219,4374,4376,4381,4390,4381,4383,4384,7,8,26,1140080,434
2129,a1505,20131220,4383,4384,4382,4382,4382,4382,4382,-2,-2,2,87640,432
2130,a1505,20131223,4382,4382,4393,4393,4393,4393,4393,11,11,2,87860,432
2131,a1505,20131224,4393,4393,4389,4389,4385,4385,4386,-8,-7,8,350940,434
2132,a1505,20131225,4385,4386,4385,4385,4363,4366,4372,-20,-14,46,2011320,444
2133,a1505,20131226,4366,4372,4363,4368,4362,4362,4362,-10,-10,54,2356000,440
2134,a1505,20131227,4362,4362,4359,4379,4359,4370,4362,8,0,24,1046940,428
2135,a1505,20131230,4370,4362,4340,4340,4209,4230,4236,-132,-126,820,34735740,724
2136,a1505,20131231,4230,4236,4222,4240,4216,4236,4232,0,-4,200,8465480,738
1,a1401,20140102,4370,4420,4400,4440,4321,4426,4425,6,5,1118,49476540,26
2,a1401,20140103,4426,4425,0,0,0,4425,4425,0,0,0,0,22
3,a1401,20140106,4425,4425,0,0,0,4425,4425,0,0,0,0,22
4,a1401,20140107,4425,4425,0,0,0,4425,4425,0,0,0,0,22
5,a1401,20140108,4425,4425,0,0,0,4425,4425,0,0,0,0,22
6,a1401,20140109,4425,4425,0,0,0,4425,4425,0,0,0,0,22
7,a1401,20140110,4425,4425,0,0,0,4425,4425,0,0,0,0,22
8,a1401,20140113,4425,4425,0,0,0,4425,4425,0,0,0,0,22
9,a1401,20140114,4425,4425,0,0,0,4425,4425,0,0,0,0,22
10,a1401,20140115,4425,4425,0,0,0,4425,4425,0,0,0,0,0
11,a1403,20140102,4414,4414,0,0,0,4414,4414,0,0,0,0,32
12,a1403,20140103,4414,4414,4438,4464,4400,4412,4428,-2,14,70,3100000,44
13,a1403,20140106,4412,4428,4437,4438,4351,4435,4425,7,-3,16,708060,44
14,a1403,20140107,4435,4425,4421,4431,4383,4383,4420,-42,-5,12,530440,36
15,a1403,20140108,4383,4420,4411,4433,4403,4432,4419,12,-1,18,795560,32
16,a1403,20140109,4432,4419,0,0,0,4419,4419,0,0,0,0,32
17,a1403,20140110,4419,4419,4437,4437,4429,4429,4434,10,15,6,266040,30
18,a1403,20140113,4429,4434,4385,4458,4385,4458,4421,24,-13,4,176860,28
19,a1403,20140114,4458,4421,4468,4468,4468,4468,4468,47,47,12,536160,38
20,a1403,20140115,4468,4468,4496,4496,4496,4496,4496,28,28,174,7823040,206
21,a1403,20140116,4496,4496,4546,4620,4523,4619,4595,123,99,292,13418980,162
22,a1403,20140117,4619,4595,4606,4631,4606,4631,4618,36,23,4,184740,162
23,a1403,20140120,4631,4618,4502,4683,4502,4632,4562,14,-56,20,912560,160
24,a1403,20140121,4632,4562,4678,4680,4613,4651,4658,89,96,54,2515680,150
25,a1403,20140122,4651,4658,4580,4624,4580,4624,4614,-34,-44,12,553720,152
26,a1403,20140123,4624,4614,4650,4650,4650,4650,4650,36,36,2,93000,150
27,a1403,20140124,4650,4650,4650,4650,4650,4650,4650,0,0,8,372000,142
28,a1403,20140127,4650,4650,4633,4633,4630,4630,4630,-20,-20,116,5371020,28
29,a1403,20140128,4630,4630,0,0,0,4630,4630,0,0,0,0,28
30,a1403,20140129,4630,4630,4635,4640,4635,4640,4639,10,9,26,1206300,2
31,a1403,20140130,4640,4639,0,0,0,4639,4639,0,0,0,0,2
32,a1403,20140207,4639,4639,4545,4829,4545,4730,4686,91,47,50,2343040,14
33,a1403,20140210,4730,4686,4729,4729,4722,4722,4725,36,39,4,189020,12
34,a1403,20140211,4722,4725,0,0,0,4725,4725,0,0,0,0,12
35,a1403,20140212,4725,4725,0,0,0,4725,4725,0,0,0,0,12
36,a1403,20140213,4725,4725,0,0,0,4725,4725,0,0,0,0,12
37,a1403,20140214,4725,4725,4725,4725,4725,4725,4725,0,0,2,94500,10
38,a1403,20140217,4725,4725,4876,4876,4653,4767,4763,42,38,12,571660,10
39,a1403,20140218,4767,4763,4577,4814,4577,4814,4695,51,-68,4,187820,10
40,a1403,20140219,4814,4695,4697,4697,4643,4643,4670,-52,-25,4,186800,8
41,a1403,20140220,4643,4670,4619,4856,4619,4701,4756,31,86,8,380520,6
42,a1403,20140221,4701,4756,0,0,0,4756,4756,0,0,0,0,6
43,a1403,20140224,4756,4756,4921,4921,4624,4849,4771,93,15,96,4580780,4
44,a1403,20140225,4849,4771,4961,4961,4669,4860,4791,89,20,8,383300,4
45,a1403,20140226,4860,4791,4750,4850,4750,4850,4800,59,9,4,192000,4
46,a1403,20140227,4850,4800,4790,4945,4790,4938,4891,138,91,6,293460,2
47,a1403,20140228,4938,4891,0,0,0,4891,4891,0,0,0,0,2
48,a1403,20140303,4891,4891,0,0,0,4891,4891,0,0,0,0,2
49,a1403,20140304,4891,4891,0,0,0,4891,4891,0,0,0,0,2
50,a1403,20140305,4891,4891,0,0,0,4891,4891,0,0,0,0,2
51,a1403,20140306,4891,4891,0,0,0,4891,4891,0,0,0,0,2
52,a1403,20140307,4891,4891,0,0,0,4891,4891,0,0,0,0,2
53,a1403,20140310,4891,4891,0,0,0,4891,4891,0,0,0,0,2
54,a1403,20140311,4891,4891,0,0,0,4891,4891,0,0,0,0,2
55,a1403,20140312,4891,4891,0,0,0,4891,4891,0,0,0,0,2
56,a1403,20140313,4891,4891,0,0,0,4891,4891,0,0,0,0,2
57,a1403,20140314,4891,4891,0,0,0,4891,4891,0,0,0,0,0
58,a1405,20140102,4441,4434,4411,4451,4411,4449,4436,15,2,35988,1596541120,64992
59,a1405,20140103,4449,4436,4436,4468,4423,4466,4451,30,15,46246,2058686900,65966
60,a1405,20140106,4466,4451,4470,4510,4455,4500,4489,49,38,60590,2719930800,75614
61,a1405,20140107,4500,4489,4505,4561,4500,4557,4531,68,42,72068,3265948180,75546
62,a1405,20140108,4557,4531,4560,4589,4518,4563,4555,32,24,101974,4645895420,78432
63,a1405,20140109,4563,4555,4555,4586,4547,4578,4565,23,10,48910,2233223960,81594
64,a1405,20140110,4578,4565,4588,4640,4573,4627,4605,62,40,134708,6203909760,94694
65,a1405,20140113,4627,4605,4628,4629,4593,4599,4605,-6,0,61132,2815394640,85452
66,a1405,20140114,4599,4605,4610,4620,4601,4617,4611,12,6,30578,1410059200,83712
67,a1405,20140115,4617,4611,4620,4661,4614,4659,4644,48,33,76460,3551460760,90568
68,a1405,20140116,4659,4644,4665,4685,4646,4683,4667,39,23,49890,2328717220,89446
69,a1405,20140117,4683,4667,4675,4703,4652,4690,4681,23,14,65296,3056675900,94304
70,a1405,20140120,4690,4681,4700,4746,4681,4733,4722,52,41,88478,4178242940,100942
71,a1405,20140121,4733,4722,4730,4738,4695,4713,4713,-9,-9,83232,3922889220,93470
72,a1405,20140122,4713,4713,4690,4699,4666,4685,4683,-28,-30,70446,3299416260,98990
73,a1405,20140123,4685,4683,4700,4725,4689,4701,4709,18,26,81532,3840043980,102484
74,a1405,20140124,4701,4709,4693,4705,4681,4699,4692,-10,-17,64392,3021517800,105970
75,a1405,20140127,4699,4692,4702,4717,4700,4712,4709,20,17,32136,1513520740,104026
76,a1405,20140128,4712,4709,4713,4717,4687,4696,4694,-13,-15,28968,1359929840,101792
77,a1405,20140129,4696,4694,4694,4711,4688,4693,4697,-1,3,28472,1337580780,96380
78,a1405,20140130,4693,4697,4684,4696,4672,4691,4685,-6,-12,28188,1320885060,88860
79,a1405,20140207,4691,4685,4730,4766,4709,4712,4722,27,37,34650,1636282000,81838
80,a1405,20140210,4712,4722,4724,4725,4709,4721,4717,-1,-5,34686,1636270820,87074
81,a1405,20140211,4721,4717,4713,4731,4702,4721,4720,4,3,43572,2056770860,90598
82,a1405,20140212,4721,4720,4727,4735,4720,4726,4727,6,7,21490,1015960760,88114
83,a1405,20140213,4726,4727,4719,4728,4713,4727,4721,0,-6,11270,532101780,86526
84,a1405,20140214,4727,4721,4730,4733,4715,4719,4722,-2,1,15052,710863120,82316
85,a1405,20140217,4719,4722,4714,4724,4712,4719,4716,-3,-6,11090,523084020,79004
86,a1405,20140218,4719,4716,4717,4732,4698,4700,4713,-16,-3,20990,989287120,74192
87,a1405,20140219,4700,4713,4720,4727,4658,4689,4687,-24,-26,39916,1871082640,70214
88,a1405,20140220,4689,4687,4690,4717,4670,4716,4705,29,18,30452,1433067300,74946
89,a1405,20140221,4716,4705,4719,4724,4700,4716,4712,11,7,18648,878761160,73078
90,a1405,20140224,4716,4712,4726,4740,4711,4740,4728,28,16,21860,1033695500,73652
91,a1405,20140225,4740,4728,4740,4744,4723,4726,4729,-2,1,10904,515711340,71352
92,a1405,20140226,4726,4729,4729,4736,4723,4724,4726,-5,-3,11832,559294740,70694
93,a1405,20140227,4724,4726,4730,4733,4717,4720,4725,-6,-1,11542,545400520,69076
94,a1405,20140228,4720,4725,4715,4720,4704,4711,4711,-14,-14,21094,993751740,73148
95,a1405,20140303,4711,4711,4714,4738,4714,4737,4730,26,19,14774,698855700,74908
96,a1405,20140304,4737,4730,4737,4740,4726,4735,4733,5,3,11378,538561520,73882
97,a1405,20140305,4735,4733,4740,4746,4730,4745,4741,12,8,8624,408885020,71494
98,a1405,20140306,4745,4741,4740,4749,4738,4749,4743,8,2,5524,262047640,70378
99,a1405,20140307,4749,4743,4757,4765,4748,4754,4759,11,16,9690,461177680,68316
100,a1405,20140310,4754,4759,4754,4757,4698,4700,4721,-59,-38,25554,1206638160,60362
101,a1405,20140311,4700,4721,4680,4756,4674,4745,4720,24,-1,15446,729155560,59310
102,a1405,20140312,4745,4720,4738,4740,4726,4732,4733,12,13,4334,205131500,58816
103,a1405,20140313,4732,4733,4715,4734,4713,4730,4726,-3,-7,6938,327952360,59330
104,a1405,20140314,4730,4726,4730,4749,4728,4743,4739,17,13,10192,483034100,54550
105,a1405,20140317,4743,4739,4742,4745,4726,4740,4735,1,-4,6396,302877660,54556
106,a1405,20140318,4740,4735,4743,4747,4728,4740,4737,5,2,7942,376217920,53256
107,a1405,20140319,4740,4737,4748,4758,4739,4741,4744,4,7,4068,193001080,52294
108,a1405,20140320,4741,4744,4739,4743,4725,4733,4731,-11,-13,6270,296674700,52090
109,a1405,20140321,4733,4731,4731,4743,4725,4740,4737,9,6,3216,152345720,51754
110,a1405,20140324,4740,4737,4725,4742,4721,4736,4735,-1,-2,2432,115175080,51442
111,a1405,20140325,4736,4735,4736,4754,4736,4739,4742,4,7,4154,197022260,49632
112,a1405,20140326,4739,4742,4739,4747,4728,4735,4734,-7,-8,4278,202523100,48050
113,a1405,20140327,4735,4734,4731,4739,4725,4735,4733,1,-1,6260,296296000,47110
114,a1405,20140328,4735,4733,4733,4743,4731,4740,4738,7,5,4018,190407540,46480
115,a1405,20140331,4740,4738,4740,4743,4727,4736,4738,-2,0,4244,201092300,45634
116,a1405,20140401,4736,4738,4745,4755,4741,4753,4749,15,11,5962,283158280,42172
117,a1405,20140402,4753,4749,4750,4758,4739,4741,4746,-8,-3,6506,308829580,39496
118,a1405,20140403,4741,4746,4738,4744,4732,4744,4739,-2,-7,3382,160274520,38268
119,a1405,20140404,4744,4739,4744,4755,4738,4745,4744,6,5,2338,110932400,37160
120,a1405,20140408,4745,4744,4738,4750,4734,4749,4747,5,3,1250,59338260,36694
121,a1405,20140409,4749,4747,4752,4755,4734,4737,4747,-10,0,3552,168639040,35380
122,a1405,20140410,4737,4747,4737,4750,4733,4743,4740,-4,-7,2284,108275100,34894
123,a1405,20140411,4743,4740,4740,4749,4737,4747,4744,7,4,2426,115092340,33654
124,a1405,20140414,4747,4744,4750,4752,4742,4747,4746,3,2,4650,220729300,30156
125,a1405,20140415,4747,4746,4746,4758,4746,4755,4753,9,7,5280,250964540,25930
126,a1405,20140416,4755,4753,4755,4758,4752,4758,4756,5,3,3224,153334100,23324
127,a1405,20140417,4758,4756,4761,4772,4754,4762,4763,6,7,4496,214176420,19530
128,a1405,20140418,4762,4763,4759,4767,4759,4766,4765,3,2,1868,89010360,17860
129,a1405,20140421,4766,4765,4764,4766,4753,4757,4760,-8,-5,2708,128908100,15674
130,a1405,20140422,4757,4760,4750,4760,4749,4757,4756,-3,-4,4260,202611300,14598
131,a1405,20140423,4757,4756,4754,4764,4750,4758,4757,2,1,1642,78115000,13766
132,a1405,20140424,4758,4757,4757,4765,4755,4757,4758,0,1,1354,64424100,12578
133,a1405,20140425,4757,4758,4759,4780,4757,4777,4769,19,11,3006,143371420,10024
134,a1405,20140428,4777,4769,4780,4835,4780,4820,4816,51,47,2734,131676340,8154
135,a1405,20140429,4820,4816,4828,4850,4828,4835,4839,19,23,1948,94282220,6412
136,a1405,20140430,4835,4839,4841,4858,4800,4800,4845,-39,6,3498,169493220,3430
137,a1405,20140505,4800,4845,4840,4840,4783,4795,4797,-50,-48,848,40681200,2932
138,a1405,20140506,4795,4797,4770,4770,4512,4760,4751,-37,-46,530,25184020,2526
139,a1405,20140507,4760,4751,4710,4794,4710,4790,4754,39,3,106,5039400,2526
140,a1405,20140508,4790,4754,4795,4796,4795,4796,4795,42,41,128,6137640,2526
141,a1405,20140509,4796,4795,4790,4795,4790,4795,4794,0,-1,86,4123600,2416
142,a1405,20140512,4795,4794,4790,4790,4521,4521,4787,-273,-7,206,9862020,1552
143,a1405,20140513,4521,4787,4760,4760,4760,4760,4760,-27,-27,468,22276800,1084
144,a1405,20140514,4760,4760,0,0,0,4760,4760,0,0,0,0,1084
145,a1405,20140515,4760,4760,0,0,0,4760,4760,0,0,0,0,1084
146,a1405,20140516,4760,4760,0,0,0,4776,4776,16,16,0,0,0
147,a1407,20140102,4375,4375,0,0,0,4375,4375,0,0,0,0,124
148,a1407,20140103,4375,4375,0,0,0,4389,4389,14,14,0,0,124
149,a1407,20140106,4389,4389,4420,4421,4420,4421,4420,32,31,4,176820,120
150,a1407,20140107,4421,4420,4434,4435,4434,4435,4434,15,14,4,177380,118
151,a1407,20140108,4435,4434,0,0,0,4434,4434,0,0,0,0,118
152,a1407,20140109,4434,4434,0,0,0,4434,4434,0,0,0,0,118
153,a1407,20140110,4434,4434,0,0,0,4457,4457,23,23,0,0,118
154,a1407,20140113,4457,4457,4457,4457,4457,4457,4457,0,0,2,89140,118
155,a1407,20140114,4457,4457,4457,4501,4457,4496,4493,39,36,36,1617600,120
156,a1407,20140115,4496,4493,4496,4497,4496,4496,4496,3,3,54,2428140,110
157,a1407,20140116,4496,4496,4540,4541,4540,4541,4540,45,44,4,181620,106
158,a1407,20140117,4541,4540,4539,4575,4539,4575,4559,35,19,32,1459140,86
159,a1407,20140120,4575,4559,4640,4659,4572,4589,4618,30,59,26,1200680,86
160,a1407,20140121,4589,4618,4617,4673,4617,4655,4660,37,42,50,2330320,76
161,a1407,20140122,4655,4660,4618,4638,4608,4636,4630,-24,-30,16,740920,68
162,a1407,20140123,4636,4630,4656,4656,4640,4640,4648,10,18,4,185920,66
163,a1407,20140124,4640,4648,4570,4570,4570,4570,4570,-78,-78,2,91400,68
164,a1407,20140127,4570,4570,4642,4642,4614,4614,4633,44,63,12,555960,66
165,a1407,20140128,4614,4633,4624,4624,4622,4622,4623,-11,-10,4,184920,68
166,a1407,20140129,4622,4623,4630,4630,4620,4620,4620,-3,-3,22,1016600,68
167,a1407,20140130,4620,4620,4606,4606,4606,4606,4606,-14,-14,2,92120,68
168,a1407,20140207,4606,4606,4667,4667,4667,4667,4667,61,61,2,93340,66
169,a1407,20140210,4667,4667,4668,4668,4653,4655,4658,-12,-9,8,372660,68
170,a1407,20140211,4655,4658,4664,4725,4664,4677,4679,19,21,16,748740,68
171,a1407,20140212,4677,4679,4639,4678,4639,4678,4669,-1,-10,10,466980,64
172,a1407,20140213,4678,4669,4677,4688,4677,4680,4680,11,11,18,842480,64
173,a1407,20140214,4680,4680,4660,4660,4660,4660,4660,-20,-20,2,93200,64
174,a1407,20140217,4660,4660,4610,4640,4605,4640,4620,-20,-40,10,462000,64
175,a1407,20140218,4640,4620,4611,4644,4611,4627,4630,7,10,28,1296620,58
176,a1407,20140219,4627,4630,4590,4621,4590,4605,4614,-25,-16,24,1107500,54
177,a1407,20140220,4605,4614,4673,4673,4673,4673,4673,59,59,2,93460,52
178,a1407,20140221,4673,4673,0,0,0,4673,4673,0,0,0,0,52
179,a1407,20140224,4673,4673,4708,4708,4708,4708,4708,35,35,2,94160,52
180,a1407,20140225,4708,4708,4672,4706,4672,4706,4689,-2,-19,4,187560,48
181,a1407,20140226,4706,4689,0,0,0,4689,4689,0,0,0,0,48
182,a1407,20140227,4689,4689,0,0,0,4686,4686,-3,-3,0,0,48
183,a1407,20140228,4686,4686,4641,4641,4641,4641,4641,-45,-45,2,92820,46
184,a1407,20140303,4641,4641,0,0,0,4642,4642,1,1,0,0,46
185,a1407,20140304,4642,4642,4653,4653,4653,4653,4653,11,11,2,93060,44
186,a1407,20140305,4653,4653,4664,4664,4639,4643,4651,-10,-2,8,372100,44
187,a1407,20140306,4643,4651,4575,4673,4575,4673,4624,22,-27,4,184960,44
188,a1407,20140307,4673,4624,4698,4698,4677,4690,4688,66,64,20,937640,50
189,a1407,20140310,4690,4688,4665,4671,4638,4638,4657,-50,-31,14,651980,42
190,a1407,20140311,4638,4657,0,0,0,4657,4657,0,0,0,0,42
191,a1407,20140312,4657,4657,0,0,0,4615,4615,-42,-42,0,0,42
192,a1407,20140313,4615,4615,4576,4576,4576,4576,4576,-39,-39,2,91520,42
193,a1407,20140314,4576,4576,0,0,0,4576,4576,0,0,0,0,42
194,a1407,20140317,4576,4576,0,0,0,4578,4578,2,2,0,0,42
195,a1407,20140318,4578,4578,4588,4588,4545,4545,4577,-33,-1,10,457780,34
196,a1407,20140319,4545,4577,0,0,0,4577,4577,0,0,0,0,34
197,a1407,20140320,4577,4577,0,0,0,4577,4577,0,0,0,0,34
198,a1407,20140321,4577,4577,0,0,0,4577,4577,0,0,0,0,34
199,a1407,20140324,4577,4577,0,0,0,4577,4577,0,0,0,0,34
200,a1407,20140325,4577,4577,4581,4581,4476,4476,4528,-101,-49,4,181140,36
201,a1407,20140326,4476,4528,0,0,0,4528,4528,0,0,0,0,36
202,a1407,20140327,4528,4528,0,0,0,4528,4528,0,0,0,0,36
203,a1407,20140328,4528,4528,0,0,0,4527,4527,-1,-1,0,0,36
204,a1407,20140331,4527,4527,0,0,0,4527,4527,0,0,0,0,36
205,a1407,20140401,4527,4527,4527,4527,4527,4527,4527,0,0,10,452700,26
206,a1407,20140402,4527,4527,0,0,0,4500,4500,-27,-27,0,0,26
207,a1407,20140403,4500,4500,4478,4478,4478,4478,4478,-22,-22,2,89560,28
208,a1407,20140404,4478,4478,4501,4501,4501,4501,4501,23,23,2,90020,26
209,a1407,20140408,4501,4501,0,0,0,4501,4501,0,0,0,0,26
210,a1407,20140409,4501,4501,4522,4522,4522,4522,4522,21,21,2,90440,24
211,a1407,20140410,4522,4522,0,0,0,4522,4522,0,0,0,0,24
212,a1407,20140411,4522,4522,4511,4511,4511,4511,4511,-11,-11,4,180440,20
213,a1407,20140414,4511,4511,0,0,0,4511,4511,0,0,0,0,20
214,a1407,20140415,4511,4511,0,0,0,4534,4534,23,23,0,0,20
215,a1407,20140416,4534,4534,4663,4663,4528,4528,4595,-6,61,4,183820,20
216,a1407,20140417,4528,4595,4587,4587,4586,4586,4586,-9,-9,6,275180,18
217,a1407,20140418,4586,4586,4604,4608,4590,4608,4601,22,15,12,552140,14
218,a1407,20140421,4608,4601,4578,4578,4578,4578,4578,-23,-23,2,91560,14
219,a1407,20140422,4578,4578,4580,4580,4459,4550,4517,-28,-61,8,361360,14
220,a1407,20140423,4550,4517,4532,4532,4532,4532,4532,15,15,2,90640,14
221,a1407,20140424,4532,4532,4583,4583,4583,4583,4583,51,51,2,91660,12
222,a1407,20140425,4583,4583,0,0,0,4583,4583,0,0,0,0,12
223,a1407,20140428,4583,4583,0,0,0,4583,4583,0,0,0,0,12
224,a1407,20140429,4583,4583,4542,4599,4542,4599,4581,16,-2,20,916220,14
225,a1407,20140430,4599,4581,0,0,0,4581,4581,0,0,0,0,14
226,a1407,20140505,4581,4581,0,0,0,4581,4581,0,0,0,0,14
227,a1407,20140506,4581,4581,0,0,0,4538,4538,-43,-43,0,0,14
228,a1407,20140507,4538,4538,4508,4508,4508,4508,4508,-30,-30,2,90160,12
229,a1407,20140508,4508,4508,0,0,0,4515,4515,7,7,0,0,12
230,a1407,20140509,4515,4515,0,0,0,4515,4515,0,0,0,0,12
231,a1407,20140512,4515,4515,0,0,0,4515,4515,0,0,0,0,12
232,a1407,20140513,4515,4515,0,0,0,4515,4515,0,0,0,0,12
233,a1407,20140514,4515,4515,4694,4694,4561,4561,4627,46,112,4,185100,12
234,a1407,20140515,4561,4627,0,0,0,4627,4627,0,0,0,0,12
235,a1407,20140516,4627,4627,0,0,0,4627,4627,0,0,0,0,12
236,a1407,20140519,4627,4627,0,0,0,4629,4629,2,2,0,0,12
237,a1407,20140520,4629,4629,4766,4766,4649,4703,4699,74,70,16,751920,6
238,a1407,20140521,4703,4699,0,0,0,4699,4699,0,0,0,0,6
239,a1407,20140522,4699,4699,0,0,0,4699,4699,0,0,0,0,6
240,a1407,20140523,4699,4699,4603,4659,4560,4590,4622,-109,-77,48,2218660,8
241,a1407,20140526,4590,4622,4629,4629,4570,4599,4594,-23,-28,8,367580,8
242,a1407,20140527,4599,4594,4532,4532,4532,4532,4532,-62,-62,2,90640,8
243,a1407,20140528,4532,4532,4713,4713,4651,4658,4681,126,149,24,1123460,6
244,a1407,20140529,4658,4681,4640,4650,4640,4640,4643,-41,-38,8,371500,4
245,a1407,20140530,4640,4643,0,0,0,4643,4643,0,0,0,0,4
246,a1407,20140603,4643,4643,4546,4640,4546,4581,4590,-62,-53,16,734440,4
247,a1407,20140604,4581,4590,4580,4677,4431,4580,4581,-10,-9,124,5681660,4
248,a1407,20140605,4580,4581,0,0,0,4581,4581,0,0,0,0,4
249,a1407,20140606,4581,4581,0,0,0,4570,4570,-11,-11,0,0,4
250,a1407,20140609,4570,4570,0,0,0,4570,4570,0,0,0,0,4
251,a1407,20140610,4570,4570,0,0,0,4570,4570,0,0,0,0,4
252,a1407,20140611,4570,4570,0,0,0,4570,4570,0,0,0,0,4
253,a1407,20140612,4570,4570,0,0,0,4570,4570,0,0,0,0,4
254,a1407,20140613,4570,4570,0,0,0,4570,4570,0,0,0,0,4
255,a1407,20140616,4570,4570,0,0,0,4570,4570,0,0,0,0,4
256,a1407,20140617,4570,4570,4424,4738,4424,4572,4578,2,8,6,274680,4
257,a1407,20140618,4572,4578,0,0,0,4578,4578,0,0,0,0,4
258,a1407,20140619,4578,4578,4744,4744,4530,4606,4636,28,58,88,4079840,4
259,a1407,20140620,4606,4636,4660,4660,4560,4560,4610,-76,-26,4,184400,4
260,a1407,20140623,4560,4610,4794,4794,4505,4505,4649,-105,39,8,371980,6
261,a1407,20140624,4505,4649,4582,4640,4501,4591,4578,-58,-71,8,366280,6
262,a1407,20140625,4591,4578,4570,4570,4570,4570,4570,-8,-8,2,91400,4
263,a1407,20140626,4570,4570,4505,4660,4480,4660,4548,90,-22,6,272900,0
264,a1407,20140627,4660,4548,4630,4630,4480,4480,4600,-68,52,10,460000,8
265,a1407,20140630,4480,4600,4770,4770,4440,4480,4573,-120,-27,16,731800,0
266,a1407,20140701,4480,4573,0,0,0,4573,4573,0,0,0,0,0
267,a1407,20140702,4573,4573,0,0,0,4573,4573,0,0,0,0,0
268,a1407,20140703,4573,4573,0,0,0,4573,4573,0,0,0,0,0
269,a1407,20140704,4573,4573,0,0,0,4573,4573,0,0,0,0,0
270,a1407,20140707,4573,4573,0,0,0,4573,4573,0,0,0,0,0
271,a1407,20140708,4573,4573,0,0,0,4573,4573,0,0,0,0,0
272,a1407,20140709,4573,4573,0,0,0,4573,4573,0,0,0,0,0
273,a1407,20140710,4573,4573,0,0,0,4573,4573,0,0,0,0,0
274,a1407,20140711,4573,4573,0,0,0,4573,4573,0,0,0,0,0
275,a1407,20140714,4573,4573,0,0,0,4573,4573,0,0,0,0,0
276,a1409,20140102,4321,4312,4312,4328,4286,4322,4311,10,-1,27710,1194784060,79750
277,a1409,20140103,4322,4311,4292,4330,4292,4326,4316,15,5,18792,811175440,77098
278,a1409,20140106,4326,4316,4323,4341,4313,4334,4331,18,15,22442,972149060,75212
279,a1409,20140107,4334,4331,4337,4359,4324,4338,4336,7,5,23942,1038202360,68690
280,a1409,20140108,4338,4336,4348,4353,4301,4341,4326,5,-10,27576,1192945900,67564
281,a1409,20140109,4341,4326,4330,4396,4330,4369,4363,43,37,19520,851693160,69346
282,a1409,20140110,4369,4363,4368,4463,4364,4442,4426,79,63,78046,3454631260,84478
283,a1409,20140113,4442,4426,4440,4442,4383,4388,4399,-38,-27,42710,1878924240,70772
284,a1409,20140114,4388,4399,4401,4409,4383,4397,4393,-2,-6,14850,652430400,67394
285,a1409,20140115,4397,4393,4393,4428,4393,4420,4414,27,21,15006,662511100,67066
286,a1409,20140116,4420,4414,4425,4462,4407,4456,4438,42,24,25600,1136130940,70948
287,a1409,20140117,4456,4438,4447,4483,4440,4460,4457,22,19,31182,1389811660,77404
288,a1409,20140120,4460,4457,4455,4522,4443,4510,4491,53,34,47360,2127204340,86694
289,a1409,20140121,4510,4491,4510,4521,4485,4509,4506,18,15,39458,1778234960,90834
290,a1409,20140122,4509,4506,4484,4504,4459,4471,4480,-35,-26,38928,1744019040,90682
291,a1409,20140123,4471,4480,4472,4503,4468,4475,4487,-5,7,24560,1102053200,90564
292,a1409,20140124,4475,4487,4466,4477,4437,4454,4452,-33,-35,27706,1233554100,87602
293,a1409,20140127,4454,4452,4468,4470,4451,4458,4457,6,5,11542,514520180,85750
294,a1409,20140128,4458,4457,4469,4469,4436,4440,4441,-17,-16,12508,555580200,81424
295,a1409,20140129,4440,4441,4440,4456,4433,4439,4442,-2,1,7338,326025140,80110
296,a1409,20140130,4439,4442,4435,4435,4401,4410,4420,-32,-22,13814,610671620,76986
297,a1409,20140207,4410,4420,4448,4480,4437,4462,4463,42,43,16214,723669400,77612
298,a1409,20140210,4462,4463,4462,4525,4459,4519,4498,56,35,65302,2937502100,103744
299,a1409,20140211,4519,4498,4527,4555,4500,4519,4532,21,34,87674,3973818080,122190
300,a1409,20140212,4519,4532,4530,4560,4523,4547,4546,15,14,42450,1930074780,132898
301,a1409,20140213,4547,4546,4535,4565,4531,4564,4550,18,4,34664,1577411260,137238
302,a1409,20140214,4564,4550,4580,4584,4547,4558,4562,8,12,26202,1195372320,137314
303,a1409,20140217,4558,4562,4558,4562,4524,4540,4542,-22,-20,30726,1395847800,137362
304,a1409,20140218,4540,4542,4543,4553,4511,4512,4528,-30,-14,31340,1419291100,135608
305,a1409,20140219,4512,4528,4530,4539,4477,4499,4503,-29,-25,52336,2356888980,133362
306,a1409,20140220,4499,4503,4496,4518,4493,4510,4507,7,4,36282,1635390000,127620
307,a1409,20140221,4510,4507,4515,4524,4484,4514,4509,7,2,67258,3032733560,140296
308,a1409,20140224,4514,4509,4519,4557,4505,4544,4534,35,25,67604,3065510700,147572
309,a1409,20140225,4544,4534,4544,4553,4524,4525,4537,-9,3,37648,1708309680,147326
310,a1409,20140226,4525,4537,4535,4544,4515,4520,4527,-17,-10,30500,1381024440,146876
311,a1409,20140227,4520,4527,4524,4534,4498,4505,4513,-22,-14,39176,1768221840,147090
312,a1409,20140228,4505,4513,4490,4490,4452,4453,4468,-60,-45,56384,2519758400,147658
313,a1409,20140303,4453,4468,4458,4484,4458,4470,4472,2,4,34982,1564641680,149666
314,a1409,20140304,4470,4472,4467,4470,4441,4456,4453,-16,-19,44604,1986216880,147746
315,a1409,20140305,4456,4453,4460,4488,4454,4482,4472,29,19,41364,1850077000,149210
316,a1409,20140306,4482,4472,4475,4485,4471,4474,4478,2,6,17794,796815640,149142
317,a1409,20140307,4474,4478,4483,4488,4453,4454,4468,-24,-10,44666,1995928060,146216
318,a1409,20140310,4454,4468,4451,4451,4319,4336,4367,-132,-101,143864,6283341740,126596
319,a1409,20140311,4336,4367,4314,4403,4300,4398,4374,31,7,67762,2964264400,106786
320,a1409,20140312,4398,4374,4374,4393,4369,4379,4380,5,6,33716,1476908700,104896
321,a1409,20140313,4379,4380,4377,4377,4345,4368,4354,-12,-26,45570,1984482200,103528
322,a1409,20140314,4368,4354,4367,4381,4356,4364,4369,10,15,30792,1345431340,102108
323,a1409,20140317,4364,4369,4360,4362,4340,4361,4351,-8,-18,26322,1145427200,97640
324,a1409,20140318,4361,4351,4362,4378,4345,4363,4360,12,9,30882,1346734280,91658
325,a1409,20140319,4363,4360,4373,4375,4359,4362,4367,2,7,20834,910018320,90950
326,a1409,20140320,4362,4367,4360,4362,4317,4341,4338,-26,-29,50208,2178417220,90328
327,a1409,20140321,4341,4338,4331,4351,4331,4340,4341,2,3,17018,738881320,89044
328,a1409,20140324,4340,4341,4340,4349,4324,4331,4334,-10,-7,13054,565869220,87668
329,a1409,20140325,4331,4334,4330,4353,4330,4336,4343,2,9,22702,986058480,82794
330,a1409,20140326,4336,4343,4335,4347,4311,4323,4324,-20,-19,33734,1458906140,88152
331,a1409,20140327,4323,4324,4325,4346,4304,4308,4322,-16,-2,39332,1700290980,93632
332,a1409,20140328,4308,4322,4304,4316,4284,4288,4300,-34,-22,34008,1462469480,95248
333,a1409,20140331,4288,4300,4277,4295,4257,4269,4274,-31,-26,34554,1477171240,98798
334,a1409,20140401,4269,4274,4278,4335,4278,4308,4310,34,36,61356,2644653620,97212
335,a1409,20140402,4308,4310,4310,4330,4267,4267,4293,-43,-17,56410,2421758780,104238
336,a1409,20140403,4267,4293,4266,4280,4241,4261,4261,-32,-32,48574,2070039400,108792
337,a1409,20140404,4261,4261,4266,4308,4252,4291,4288,30,27,76098,3263166900,116646
338,a1409,20140408,4291,4288,4280,4298,4275,4291,4287,3,-1,34696,1487657660,115082
339,a1409,20140409,4291,4287,4300,4326,4292,4297,4312,10,25,45548,1964367000,115352
340,a1409,20140410,4297,4312,4298,4316,4298,4299,4306,-13,-6,30730,1323526180,115710
341,a1409,20140411,4299,4306,4294,4302,4280,4288,4289,-18,-17,24574,1054211540,120182
342,a1409,20140414,4288,4289,4286,4369,4286,4358,4338,69,49,113064,4904767120,132282
343,a1409,20140415,4358,4338,4355,4380,4342,4365,4359,27,21,81514,3553517120,143184
344,a1409,20140416,4365,4359,4381,4386,4354,4371,4366,12,7,44306,1934489020,143526
345,a1409,20140417,4371,4366,4385,4395,4360,4391,4377,25,11,44932,1967006980,150196
346,a1409,20140418,4391,4377,4385,4421,4380,4396,4401,19,24,98294,4326113200,174144
347,a1409,20140421,4396,4401,4401,4408,4351,4351,4372,-50,-29,76516,3345340340,183362
348,a1409,20140422,4351,4372,4350,4371,4331,4363,4354,-9,-18,52470,2285025740,180624
349,a1409,20140423,4363,4354,4353,4376,4344,4358,4359,4,5,43224,1884406180,179128
350,a1409,20140424,4358,4359,4363,4392,4356,4391,4371,32,12,27248,1191153260,182652
351,a1409,20140425,4391,4371,4388,4462,4386,4445,4439,74,68,186828,8294301820,202882
352,a1409,20140428,4445,4439,4468,4481,4451,4471,4468,32,29,91282,4078802600,216714
353,a1409,20140429,4471,4468,4459,4508,4444,4499,4485,31,17,121262,5439345980,239672
354,a1409,20140430,4499,4485,4507,4522,4481,4485,4497,0,12,82214,3697977040,240380
355,a1409,20140505,4485,4497,4454,4488,4449,4472,4472,-25,-25,52362,2341724840,240348
356,a1409,20140506,4472,4472,4470,4470,4374,4377,4418,-95,-54,232432,10270185620,276826
357,a1409,20140507,4377,4418,4369,4387,4353,4359,4366,-59,-52,120258,5251561420,282706
358,a1409,20140508,4359,4366,4356,4405,4351,4381,4384,15,18,157604,6910663660,284566
359,a1409,20140509,4381,4384,4400,4402,4373,4376,4384,-8,0,61304,2687978820,274376
360,a1409,20140512,4376,4384,4385,4400,4371,4382,4385,-2,1,74774,3279519620,262468
361,a1409,20140513,4382,4385,4386,4450,4374,4448,4420,63,35,180466,7976669020,273440
362,a1409,20140514,4448,4420,4457,4515,4456,4510,4497,90,77,178446,8024991620,299358
363,a1409,20140515,4510,4497,4510,4565,4495,4538,4539,41,42,207598,9423951040,303438
364,a1409,20140516,4538,4539,4526,4560,4517,4552,4538,13,-1,130274,5912840240,300860
365,a1409,20140519,4552,4538,4550,4600,4518,4561,4558,23,20,145062,6612865140,286900
366,a1409,20140520,4561,4558,4567,4584,4524,4547,4552,-11,-6,183856,8369190440,277002
367,a1409,20140521,4547,4552,4545,4575,4504,4512,4530,-40,-22,228242,10340777760,260496
368,a1409,20140522,4512,4530,4530,4566,4513,4523,4538,-7,8,168646,7653383240,260432
369,a1409,20140523,4523,4538,4520,4549,4507,4518,4524,-20,-14,83792,3791104700,258124
370,a1409,20140526,4518,4524,4525,4535,4495,4507,4512,-17,-12,88742,4004600520,254402
371,a1409,20140527,4507,4512,4507,4529,4495,4517,4513,5,1,106052,4786235300,245754
372,a1409,20140528,4517,4513,4515,4604,4506,4572,4568,59,55,207236,9468612020,247392
373,a1409,20140529,4572,4568,4575,4584,4546,4548,4562,-20,-6,77392,3530946240,243202
374,a1409,20140530,4548,4562,4550,4574,4464,4502,4523,-60,-39,111002,5021706140,232976
375,a1409,20140603,4502,4523,4501,4521,4489,4516,4507,-7,-16,49754,2242866960,226836
376,a1409,20140604,4516,4507,4508,4530,4485,4490,4506,-17,-1,62830,2831268480,222314
377,a1409,20140605,4490,4506,4494,4500,4435,4439,4459,-67,-47,79782,3557906040,217950
378,a1409,20140606,4439,4459,4443,4444,4408,4437,4424,-22,-35,77626,3434694500,207124
379,a1409,20140609,4437,4424,4440,4475,4436,4466,4461,42,37,56870,2537207260,196282
380,a1409,20140610,4466,4461,4466,4483,4425,4426,4456,-35,-5,73052,3255420180,188096
381,a1409,20140611,4426,4456,4428,4447,4421,4425,4432,-31,-24,30246,1340508980,185982
382,a1409,20140612,4425,4432,4417,4448,4400,4436,4428,4,-4,40658,1800527520,182642
383,a1409,20140613,4436,4428,4418,4439,4410,4426,4427,-2,-1,25144,1113139240,180436
384,a1409,20140616,4426,4427,4427,4473,4427,4461,4453,34,26,33154,1476396320,177294
385,a1409,20140617,4461,4453,4460,4463,4432,4438,4442,-15,-11,32048,1423749560,174774
386,a1409,20140618,4438,4442,4430,4460,4421,4445,4446,3,4,24102,1071741040,173858
387,a1409,20140619,4445,4446,4441,4458,4441,4445,4451,-1,5,10738,477958940,172574
388,a1409,20140620,4445,4451,4451,4477,4448,4464,4463,13,12,32392,1445762760,170774
389,a1409,20140623,4464,4463,4475,4507,4472,4490,4490,27,27,24776,1112668960,168908
390,a1409,20140624,4490,4490,4484,4489,4458,4461,4471,-29,-19,20208,903635420,166052
391,a1409,20140625,4461,4471,4460,4470,4433,4438,4449,-33,-22,28172,1253534900,166880
392,a1409,20140626,4438,4449,4438,4446,4424,4428,4430,-21,-19,16338,723883040,166308
393,a1409,20140627,4428,4430,4440,4451,4420,4420,4435,-10,5,19920,883634080,162930
394,a1409,20140630,4420,4435,4408,4426,4397,4412,4414,-23,-21,14498,639943940,162378
395,a1409,20140701,4412,4414,4395,4395,4306,4334,4346,-80,-68,76288,3316211140,161478
396,a1409,20140702,4334,4346,4341,4354,4314,4337,4332,-9,-14,22486,974109300,161342
397,a1409,20140703,4337,4332,4320,4332,4302,4326,4322,-6,-10,10028,433420380,161950
398,a1409,20140704,4326,4322,4327,4327,4290,4290,4307,-32,-15,9468,407787640,160638
399,a1409,20140707,4290,4307,4293,4293,4261,4270,4274,-37,-33,15282,653170780,158766
400,a1409,20140708,4270,4274,4269,4340,4269,4323,4314,49,40,20858,899922860,155140
401,a1409,20140709,4323,4314,4303,4324,4272,4282,4305,-32,-9,12916,556070360,153612
402,a1409,20140710,4282,4305,4279,4289,4267,4273,4274,-32,-31,17502,748089280,145294
403,a1409,20140711,4273,4274,4269,4297,4252,4280,4271,6,-3,12878,550105540,142190
404,a1409,20140714,4280,4271,4256,4295,4240,4293,4267,22,-4,34424,1469137280,122368
405,a1409,20140715,4293,4267,4299,4312,4285,4293,4298,26,31,14328,615904000,117020
406,a1409,20140716,4293,4298,4297,4310,4293,4300,4303,2,5,11480,493999780,112974
407,a1409,20140717,4300,4303,4296,4312,4292,4295,4298,-8,-5,6598,283631640,108796
408,a1409,20140718,4295,4298,4297,4319,4285,4298,4296,0,-2,7908,339775460,104978
409,a1409,20140721,4298,4296,4280,4362,4276,4339,4338,43,42,23716,1028959000,97088
410,a1409,20140722,4339,4338,4336,4413,4334,4406,4397,68,59,36506,1605429120,93216
411,a1409,20140723,4406,4397,4400,4414,4391,4399,4402,2,5,16066,707269660,90760
412,a1409,20140724,4399,4402,4413,4422,4392,4397,4401,-5,-1,6702,294965540,90842
413,a1409,20140725,4397,4401,4399,4404,4392,4397,4396,-4,-5,3498,153779600,90304
414,a1409,20140728,4397,4396,4401,4453,4401,4447,4441,51,45,17822,791544960,91888
415,a1409,20140729,4447,4441,4453,4463,4444,4446,4449,5,8,13744,611571000,86238
416,a1409,20140730,4446,4449,4436,4447,4423,4447,4437,-2,-12,4192,186000420,84810
417,a1409,20140731,4447,4437,4435,4451,4435,4447,4448,10,11,5870,261099180,84716
418,a1409,20140801,4447,4448,4456,4456,4441,4452,4448,4,0,4504,200351260,82628
419,a1409,20140804,4452,4448,4448,4491,4448,4481,4471,33,23,30204,1350452380,70964
420,a1409,20140805,4481,4471,4488,4490,4463,4467,4470,-4,-1,14062,628668340,66180
421,a1409,20140806,4467,4470,4461,4474,4457,4457,4460,-13,-10,5920,264067060,63744
422,a1409,20140807,4457,4460,4468,4470,4441,4442,4449,-18,-11,8238,366531600,57452
423,a1409,20140808,4442,4449,4442,4460,4440,4449,4450,0,1,4340,193134280,55924
424,a1409,20140811,4449,4450,4452,4479,4446,4477,4467,27,17,18058,806703780,51188
425,a1409,20140812,4477,4467,4480,4480,4457,4457,4463,-10,-4,2566,114538920,49810
426,a1409,20140813,4457,4463,4456,4523,4456,4523,4495,60,32,9022,405566100,44470
427,a1409,20140814,4523,4495,4520,4564,4472,4501,4518,6,23,18522,836871380,42012
428,a1409,20140815,4501,4518,4512,4524,4494,4506,4501,-12,-17,6602,297170180,36776
429,a1409,20140818,4506,4501,4507,4507,4474,4497,4486,-4,-15,3736,167607240,35088
430,a1409,20140819,4497,4486,4489,4497,4443,4452,4457,-34,-29,11676,520507160,28896
431,a1409,20140820,4452,4457,4465,4467,4438,4464,4453,7,-4,3240,144307820,27636
432,a1409,20140821,4464,4453,4456,4459,4433,4442,4443,-11,-10,3930,174629320,25574
433,a1409,20140822,4442,4443,4453,4461,4449,4452,4455,9,12,8442,376091600,19868
434,a1409,20140825,4452,4455,4446,4468,4442,4468,4458,13,3,4184,186544440,18682
435,a1409,20140826,4468,4458,4468,4517,4460,4515,4490,57,32,8602,386267560,14256
436,a1409,20140827,4515,4490,4502,4520,4488,4497,4503,7,13,1398,62965380,13234
437,a1409,20140828,4497,4503,4478,4495,4464,4482,4477,-21,-26,5832,261136380,10986
438,a1409,20140829,4482,4477,4474,4499,4470,4480,4489,3,12,2468,110812040,8684
439,a1409,20140901,4480,4489,4460,4500,4460,4470,4470,-19,-19,1666,74484400,7544
440,a1409,20140902,4470,4470,4480,4590,4480,4506,4485,36,15,4700,210818740,4146
441,a1409,20140903,4506,4485,4555,4564,4555,4564,4559,79,74,2628,119829880,4146
442,a1409,20140904,4564,4559,4480,4551,4480,4551,4550,-8,-9,1606,73080800,244
443,a1409,20140905,4551,4550,4551,4551,4551,4551,4551,1,1,244,11104440,0
444,a1409,20140909,4551,4551,0,0,0,4520,4520,-31,-31,0,0,0
445,a1409,20140910,4520,4520,0,0,0,4520,4520,0,0,0,0,0
446,a1409,20140911,4520,4520,0,0,0,4520,4520,0,0,0,0,0
447,a1409,20140912,4520,4520,0,0,0,4520,4520,0,0,0,0,0
448,a1409,20140915,4520,4520,0,0,0,4512,4512,-8,-8,0,0,0
449,a1411,20140102,4319,4306,4300,4300,4300,4300,4300,-6,-6,2,86000,134
450,a1411,20140103,4300,4300,4303,4303,4303,4303,4303,3,3,2,86060,134
451,a1411,20140106,4303,4303,4290,4291,4290,4290,4290,-13,-13,8,343220,136
452,a1411,20140107,4290,4290,0,0,0,4290,4290,0,0,0,0,136
453,a1411,20140108,4290,4290,4268,4268,4268,4268,4268,-22,-22,10,426800,136
454,a1411,20140109,4268,4268,4322,4325,4218,4325,4288,57,20,6,257300,134
455,a1411,20140110,4325,4288,0,0,0,4326,4326,38,38,0,0,134
456,a1411,20140113,4326,4326,0,0,0,4326,4326,0,0,0,0,134
457,a1411,20140114,4326,4326,4325,4325,4325,4325,4325,-1,-1,2,86500,136
458,a1411,20140115,4325,4325,0,0,0,4325,4325,0,0,0,0,136
459,a1411,20140116,4325,4325,4390,4390,4390,4390,4390,65,65,2,87800,138
460,a1411,20140117,4390,4390,4416,4417,4416,4417,4416,27,26,10,441680,138
461,a1411,20140120,4417,4416,4412,4445,4412,4445,4427,29,11,10,442780,138
462,a1411,20140121,4445,4427,4430,4430,4430,4430,4430,3,3,2,88600,136
463,a1411,20140122,4430,4430,0,0,0,4430,4430,0,0,0,0,136
464,a1411,20140123,4430,4430,4440,4440,4440,4440,4440,10,10,40,1776000,136
465,a1411,20140124,4440,4440,4399,4400,4399,4399,4399,-41,-41,24,1055940,134
466,a1411,20140127,4399,4399,4402,4402,4402,4402,4402,3,3,2,88040,132
467,a1411,20140128,4402,4402,4390,4395,4390,4395,4392,-7,-10,22,966400,132
468,a1411,20140129,4395,4392,4396,4396,4396,4396,4396,4,4,2,87920,132
469,a1411,20140130,4396,4396,0,0,0,4396,4396,0,0,0,0,132
470,a1411,20140207,4396,4396,0,0,0,4396,4396,0,0,0,0,132
471,a1411,20140210,4396,4396,0,0,0,4430,4430,34,34,0,0,132
472,a1411,20140211,4430,4430,4453,4490,4453,4490,4468,60,38,8,357480,132
473,a1411,20140212,4490,4468,4402,4529,4402,4487,4474,19,6,8,357940,130
474,a1411,20140213,4487,4474,4497,4497,4497,4497,4497,23,23,2,89940,130
475,a1411,20140214,4497,4497,4491,4516,4491,4516,4503,19,6,4,180140,130
476,a1411,20140217,4516,4503,4485,4485,4485,4485,4485,-18,-18,2,89700,130
477,a1411,20140218,4485,4485,4498,4498,4456,4478,4477,-7,-8,6,268640,128
478,a1411,20140219,4478,4477,4468,4468,4468,4468,4468,-9,-9,4,178720,128
479,a1411,20140220,4468,4468,0,0,0,4468,4468,0,0,0,0,128
480,a1411,20140221,4468,4468,0,0,0,4469,4469,1,1,0,0,128
481,a1411,20140224,4469,4469,0,0,0,4493,4493,24,24,0,0,128
482,a1411,20140225,4493,4493,0,0,0,4493,4493,0,0,0,0,128
483,a1411,20140226,4493,4493,4461,4472,4461,4472,4466,-21,-27,4,178660,128
484,a1411,20140227,4472,4466,4461,4461,4461,4461,4461,-5,-5,2,89220,128
485,a1411,20140228,4461,4461,4437,4437,4437,4437,4437,-24,-24,2,88740,128
486,a1411,20140303,4437,4437,0,0,0,4437,4437,0,0,0,0,128
487,a1411,20140304,4437,4437,4420,4429,4420,4425,4424,-12,-13,6,265480,128
488,a1411,20140305,4425,4424,4439,4441,4439,4441,4440,17,16,4,177600,128
489,a1411,20140306,4441,4440,4457,4457,4448,4448,4452,8,12,8,356180,128
490,a1411,20140307,4448,4452,4456,4459,4456,4459,4457,7,5,6,267420,134
491,a1411,20140310,4459,4457,4384,4384,4366,4366,4371,-91,-86,14,611960,142
492,a1411,20140311,4366,4371,4378,4380,4378,4380,4378,9,7,6,262720,136
493,a1411,20140312,4380,4378,4326,4394,4326,4374,4349,-4,-29,10,434920,136
494,a1411,20140313,4374,4349,4422,4422,4340,4340,4393,-9,44,16,702920,136
495,a1411,20140314,4340,4393,4430,4430,4430,4430,4430,37,37,2,88600,138
496,a1411,20140317,4430,4430,0,0,0,4412,4412,-18,-18,0,0,138
497,a1411,20140318,4412,4412,4371,4371,4371,4371,4371,-41,-41,2,87420,138
498,a1411,20140319,4371,4371,0,0,0,4378,4378,7,7,0,0,138
499,a1411,20140320,4378,4378,0,0,0,4349,4349,-29,-29,0,0,138
500,a1411,20140321,4349,4349,4374,4374,4374,4374,4374,25,25,2,87480,138
501,a1411,20140324,4374,4374,4367,4367,4367,4367,4367,-7,-7,4,174680,138
502,a1411,20140325,4367,4367,4368,4381,4368,4381,4374,14,7,4,174980,136
503,a1411,20140326,4381,4374,4368,4368,4368,4368,4368,-6,-6,2,87360,136
504,a1411,20140327,4368,4368,0,0,0,4368,4368,0,0,0,0,136
505,a1411,20140328,4368,4368,4353,4353,4306,4306,4337,-62,-31,6,260240,136
506,a1411,20140331,4306,4337,0,0,0,4311,4311,-26,-26,0,0,136
507,a1411,20140401,4311,4311,4356,4356,4334,4334,4340,23,29,22,954820,154
508,a1411,20140402,4334,4340,4341,4341,4289,4289,4323,-51,-17,6,259420,152
509,a1411,20140403,4289,4323,4259,4259,4259,4259,4259,-64,-64,2,85180,150
510,a1411,20140404,4259,4259,0,0,0,4290,4290,31,31,0,0,150
511,a1411,20140408,4290,4290,0,0,0,4291,4291,1,1,0,0,150
512,a1411,20140409,4291,4291,0,0,0,4291,4291,0,0,0,0,150
513,a1411,20140410,4291,4291,0,0,0,4300,4300,9,9,0,0,150
514,a1411,20140411,4300,4300,4292,4292,4292,4292,4292,-8,-8,4,171680,154
515,a1411,20140414,4292,4292,4341,4372,4341,4372,4348,80,56,18,782740,152
516,a1411,20140415,4372,4348,4409,4409,4353,4401,4390,53,42,36,1580540,148
517,a1411,20140416,4401,4390,4483,4483,4376,4376,4404,-14,14,24,1056960,150
518,a1411,20140417,4376,4404,4425,4425,4383,4393,4398,-11,-6,52,2287340,178
519,a1411,20140418,4393,4398,0,0,0,4398,4398,0,0,0,0,178
520,a1411,20140421,4398,4398,4380,4380,4346,4347,4363,-51,-35,8,349060,182
521,a1411,20140422,4347,4363,4358,4358,4343,4343,4348,-20,-15,6,260880,180
522,a1411,20140423,4343,4348,4342,4372,4337,4346,4352,-2,4,26,1131580,178
523,a1411,20140424,4346,4352,4361,4375,4359,4375,4364,23,12,10,436480,170
524,a1411,20140425,4375,4364,4401,4440,4401,4431,4430,67,66,36,1595100,172
525,a1411,20140428,4431,4430,4440,4446,4440,4446,4443,16,13,4,177720,172
526,a1411,20140429,4446,4443,4444,4461,4443,4461,4450,18,7,16,712000,170
527,a1411,20140430,4461,4450,4414,4497,4414,4446,4455,-4,5,14,623820,170
528,a1411,20140505,4446,4455,4408,4434,4393,4434,4405,-21,-50,12,528680,172
529,a1411,20140506,4434,4405,4417,4417,4356,4356,4398,-49,-7,28,1231640,176
530,a1411,20140507,4356,4398,4316,4339,4316,4339,4327,-59,-71,4,173100,174
531,a1411,20140508,4339,4327,4358,4364,4351,4351,4358,24,31,14,610200,180
532,a1411,20140509,4351,4358,4349,4349,4330,4330,4339,-28,-19,4,173580,178
533,a1411,20140512,4330,4339,4339,4339,4320,4320,4334,-19,-5,8,346740,174
534,a1411,20140513,4320,4334,4379,4388,4370,4370,4380,36,46,20,876080,170
535,a1411,20140514,4370,4380,4398,4440,4398,4424,4424,44,44,20,884900,162
536,a1411,20140515,4424,4424,4489,4490,4480,4480,4487,56,63,10,448740,156
537,a1411,20140516,4480,4487,0,0,0,4487,4487,0,0,0,0,156
538,a1411,20140519,4487,4487,4512,4512,4512,4512,4512,25,25,2,90240,156
539,a1411,20140520,4512,4512,4570,4570,4549,4570,4565,58,53,12,547800,156
540,a1411,20140521,4570,4565,4540,4579,4540,4540,4562,-25,-3,12,547520,162
541,a1411,20140522,4540,4562,4578,4604,4578,4579,4592,17,30,34,1561600,180
542,a1411,20140523,4579,4592,4549,4549,4549,4549,4549,-43,-43,2,90980,180
543,a1411,20140526,4549,4549,4561,4561,4554,4554,4557,5,8,4,182300,178
544,a1411,20140527,4554,4557,4556,4556,4500,4529,4508,-28,-49,58,2614640,218
545,a1411,20140528,4529,4508,4549,4681,4549,4615,4604,107,96,46,2118180,204
546,a1411,20140529,4615,4604,4613,4613,4561,4599,4587,-5,-17,198,9083300,190
547,a1411,20140530,4599,4587,4579,4579,4503,4505,4546,-82,-41,14,636440,184
548,a1411,20140603,4505,4546,4540,4540,4540,4540,4540,-6,-6,2,90800,186
549,a1411,20140604,4540,4540,0,0,0,4525,4525,-15,-15,0,0,186
550,a1411,20140605,4525,4525,4482,4482,4482,4482,4482,-43,-43,2,89640,186
551,a1411,20140606,4482,4482,4462,4462,4462,4462,4462,-20,-20,10,446200,186
552,a1411,20140609,4462,4462,4495,4495,4485,4485,4488,23,26,8,359040,186
553,a1411,20140610,4485,4488,4465,4465,4464,4465,4464,-23,-24,8,357160,186
554,a1411,20140611,4465,4464,4400,4468,4400,4463,4437,-1,-27,92,4082860,224
555,a1411,20140612,4463,4437,4489,4489,4452,4464,4468,27,31,80,3575160,190
556,a1411,20140613,4464,4468,4455,4455,4455,4455,4455,-13,-13,4,178200,188
557,a1411,20140616,4455,4455,4468,4500,4468,4495,4477,40,22,14,626800,182
558,a1411,20140617,4495,4477,4471,4472,4471,4472,4471,-5,-6,6,268300,180
559,a1411,20140618,4472,4471,4476,4476,4473,4473,4474,2,3,8,357940,180
560,a1411,20140619,4473,4474,0,0,0,4474,4474,0,0,0,0,180
561,a1411,20140620,4474,4474,4478,4492,4478,4491,4484,17,10,20,896960,180
562,a1411,20140623,4491,4484,4580,4580,4510,4510,4539,26,55,10,453980,180
563,a1411,20140624,4510,4539,0,0,0,4490,4490,-49,-49,0,0,180
564,a1411,20140625,4490,4490,4475,4484,4470,4470,4475,-20,-15,24,1074220,194
565,a1411,20140626,4470,4475,4439,4469,4439,4469,4454,-6,-21,4,178160,194
566,a1411,20140627,4469,4454,0,0,0,4454,4454,0,0,0,0,194
567,a1411,20140630,4454,4454,4448,4450,4448,4450,4449,-4,-5,12,533880,190
568,a1411,20140701,4450,4449,4370,4370,4321,4360,4356,-89,-93,36,1568440,182
569,a1411,20140702,4360,4356,4311,4384,4311,4351,4346,-5,-10,18,782360,184
570,a1411,20140703,4351,4346,4300,4343,4300,4343,4321,-3,-25,8,345720,184
571,a1411,20140704,4343,4321,4321,4321,4321,4321,4321,0,0,10,432100,188
572,a1411,20140707,4321,4321,4289,4289,4245,4245,4274,-76,-47,6,256460,186
573,a1411,20140708,4245,4274,4326,4333,4326,4333,4330,59,56,6,259840,188
574,a1411,20140709,4333,4330,4309,4310,4309,4309,4309,-21,-21,6,258560,184
575,a1411,20140710,4309,4309,0,0,0,4309,4309,0,0,0,0,184
576,a1411,20140711,4309,4309,0,0,0,4309,4309,0,0,0,0,184
577,a1411,20140714,4309,4309,0,0,0,4309,4309,0,0,0,0,184
578,a1411,20140715,4309,4309,0,0,0,4309,4309,0,0,0,0,184
579,a1411,20140716,4309,4309,0,0,0,4309,4309,0,0,0,0,184
580,a1411,20140717,4309,4309,0,0,0,4309,4309,0,0,0,0,184
581,a1411,20140718,4309,4309,4313,4315,4303,4315,4311,6,2,20,862320,176
582,a1411,20140721,4315,4311,4311,4332,4311,4332,4320,21,9,14,604800,170
583,a1411,20140722,4332,4320,0,0,0,4378,4378,58,58,0,0,170
584,a1411,20140723,4378,4378,0,0,0,4374,4374,-4,-4,0,0,170
585,a1411,20140724,4374,4374,0,0,0,4374,4374,0,0,0,0,170
586,a1411,20140725,4374,4374,0,0,0,4370,4370,-4,-4,0,0,170
587,a1411,20140728,4370,4370,4386,4386,4386,4386,4386,16,16,2,87720,170
588,a1411,20140729,4386,4386,0,0,0,4413,4413,27,27,0,0,170
589,a1411,20140730,4413,4413,0,0,0,4413,4413,0,0,0,0,170
590,a1411,20140731,4413,4413,4450,4450,4450,4450,4450,37,37,2,89000,170
591,a1411,20140801,4450,4450,0,0,0,4450,4450,0,0,0,0,170
592,a1411,20140804,4450,4450,0,0,0,4489,4489,39,39,0,0,170
593,a1411,20140805,4489,4489,0,0,0,4500,4500,11,11,0,0,170
594,a1411,20140806,4500,4500,4516,4530,4509,4524,4517,24,17,48,2168460,180
595,a1411,20140807,4524,4517,4521,4521,4476,4476,4504,-41,-13,8,360340,180
596,a1411,20140808,4476,4504,4475,4475,4475,4475,4475,-29,-29,2,89500,180
597,a1411,20140811,4475,4475,0,0,0,4479,4479,4,4,0,0,180
598,a1411,20140812,4479,4479,4516,4519,4516,4519,4517,40,38,4,180700,178
599,a1411,20140813,4519,4517,0,0,0,4549,4549,32,32,0,0,178
600,a1411,20140814,4549,4549,4503,4503,4503,4503,4503,-46,-46,2,90060,176
601,a1411,20140815,4503,4503,0,0,0,4503,4503,0,0,0,0,176
602,a1411,20140818,4503,4503,4503,4595,4503,4595,4568,92,65,10,456800,172
603,a1411,20140819,4595,4568,4524,4524,4524,4524,4524,-44,-44,2,90480,174
604,a1411,20140820,4524,4524,4504,4504,4504,4504,4504,-20,-20,2,90080,172
605,a1411,20140821,4504,4504,4482,4490,4471,4471,4485,-33,-19,12,538240,172
606,a1411,20140822,4471,4485,4513,4513,4502,4502,4509,17,24,8,360780,176
607,a1411,20140825,4502,4509,4498,4498,4498,4498,4498,-11,-11,2,89960,174
608,a1411,20140826,4498,4498,4514,4514,4514,4514,4514,16,16,6,270840,172
609,a1411,20140827,4514,4514,4612,4612,4521,4521,4566,7,52,4,182660,172
610,a1411,20140828,4521,4566,4560,4560,4560,4560,4560,-6,-6,4,182400,172
611,a1411,20140829,4560,4560,0,0,0,4560,4560,0,0,0,0,172
612,a1411,20140901,4560,4560,0,0,0,4560,4560,0,0,0,0,172
613,a1411,20140902,4560,4560,4653,4653,4556,4583,4601,23,41,14,644200,172
614,a1411,20140903,4583,4601,4556,4556,4556,4556,4556,-45,-45,6,273360,166
615,a1411,20140904,4556,4556,4582,4582,4540,4540,4561,-16,5,4,182440,166
616,a1411,20140905,4540,4561,0,0,0,4560,4560,-1,-1,0,0,166
617,a1411,20140909,4560,4560,4520,4602,4510,4510,4558,-50,-2,262,11943220,156
618,a1411,20140910,4510,4558,4510,4510,4508,4508,4509,-50,-49,8,360720,152
619,a1411,20140911,4508,4509,0,0,0,4509,4509,0,0,0,0,152
620,a1411,20140912,4509,4509,0,0,0,4509,4509,0,0,0,0,152
621,a1411,20140915,4509,4509,4631,4631,4573,4573,4589,64,80,134,6150340,98
622,a1411,20140916,4573,4589,4550,4667,4550,4568,4607,-21,18,30,1382100,74
623,a1411,20140917,4568,4607,4589,4597,4570,4570,4585,-37,-22,26,1192300,58
624,a1411,20140918,4570,4585,4631,4631,4561,4588,4593,3,8,14,643140,56
625,a1411,20140919,4588,4593,4437,4621,4437,4563,4564,-30,-29,58,2647120,54
626,a1411,20140922,4563,4564,4550,4586,4525,4562,4561,-2,-3,24,1094740,50
627,a1411,20140923,4562,4561,4658,4658,4541,4552,4558,-9,-3,34,1549840,52
628,a1411,20140924,4552,4558,4543,4629,4520,4536,4550,-22,-8,46,2093100,58
629,a1411,20140925,4536,4550,4536,4549,4530,4549,4536,-1,-14,44,1995900,24
630,a1411,20140926,4549,4536,4516,4580,4516,4580,4555,44,19,24,1093420,18
631,a1411,20140929,4580,4555,4627,4627,4541,4541,4598,-14,43,6,275900,20
632,a1411,20140930,4541,4598,0,0,0,4549,4549,-49,-49,0,0,20
633,a1411,20141008,4549,4549,0,0,0,4510,4510,-39,-39,0,0,20
634,a1411,20141009,4510,4510,0,0,0,4500,4500,-10,-10,0,0,20
635,a1411,20141010,4500,4500,4436,4436,4436,4436,4436,-64,-64,2,88720,18
636,a1411,20141013,4436,4436,4266,4368,4259,4290,4309,-146,-127,26,1120340,16
637,a1411,20141014,4290,4309,0,0,0,4309,4309,0,0,0,0,16
638,a1411,20141015,4309,4309,0,0,0,4310,4310,1,1,0,0,16
639,a1411,20141016,4310,4310,0,0,0,4310,4310,0,0,0,0,16
640,a1411,20141017,4310,4310,0,0,0,4310,4310,0,0,0,0,16
641,a1411,20141020,4310,4310,4300,4302,4300,4302,4301,-8,-9,12,516120,18
642,a1411,20141021,4302,4301,0,0,0,4301,4301,0,0,0,0,18
643,a1411,20141022,4301,4301,4250,4380,4250,4300,4310,-1,9,6,258600,16
644,a1411,20141023,4300,4310,4281,4380,4250,4300,4316,-10,6,12,518000,16
645,a1411,20141024,4300,4316,0,0,0,4316,4316,0,0,0,0,16
646,a1411,20141027,4316,4316,4250,4450,4250,4401,4380,85,64,44,1927300,22
647,a1411,20141028,4401,4380,4400,4400,4400,4400,4400,20,20,2,88000,20
648,a1411,20141029,4400,4400,0,0,0,4400,4400,0,0,0,0,20
649,a1411,20141030,4400,4400,4270,4401,4270,4401,4335,1,-65,4,173420,20
650,a1411,20141031,4401,4335,4335,4508,4335,4508,4472,173,137,10,447260,12
651,a1411,20141103,4508,4472,4515,4515,4515,4515,4515,43,43,4,180600,0
652,a1411,20141104,4515,4515,0,0,0,4515,4515,0,0,0,0,0
653,a1411,20141105,4515,4515,0,0,0,4515,4515,0,0,0,0,0
654,a1411,20141106,4515,4515,0,0,0,4515,4515,0,0,0,0,0
655,a1411,20141107,4515,4515,0,0,0,4515,4515,0,0,0,0,0
656,a1411,20141110,4515,4515,0,0,0,4515,4515,0,0,0,0,0
657,a1411,20141111,4515,4515,0,0,0,4515,4515,0,0,0,0,0
658,a1411,20141112,4515,4515,0,0,0,4515,4515,0,0,0,0,0
659,a1411,20141113,4515,4515,0,0,0,4515,4515,0,0,0,0,0
660,a1411,20141114,4515,4515,0,0,0,4515,4515,0,0,0,0,0
661,a1501,20140102,4196,4187,4185,4196,4140,4191,4176,4,-11,25318,1057507960,60748
662,a1501,20140103,4191,4176,4177,4198,4171,4193,4187,17,11,15140,633971160,58852
663,a1501,20140106,4193,4187,4195,4195,4129,4151,4153,-36,-34,21150,878377900,61018
664,a1501,20140107,4151,4153,4153,4163,4119,4132,4140,-21,-13,9278,384193840,61762
665,a1501,20140108,4132,4140,4131,4144,4061,4091,4089,-49,-51,27204,1112515100,60638
666,a1501,20140109,4091,4089,4080,4154,4080,4120,4117,31,28,19786,814621680,57282
667,a1501,20140110,4120,4117,4117,4217,4112,4189,4170,72,53,37048,1545162740,52174
668,a1501,20140113,4189,4170,4180,4189,4130,4140,4150,-30,-20,17768,737487980,52840
669,a1501,20140114,4140,4150,4161,4164,4141,4157,4152,7,2,6894,286295040,51806
670,a1501,20140115,4157,4152,4168,4184,4157,4176,4173,24,21,8356,348734660,54342
671,a1501,20140116,4176,4173,4190,4215,4170,4208,4194,35,21,17144,719170580,58348
672,a1501,20140117,4208,4194,4196,4238,4191,4230,4216,36,22,21472,905290460,57936
673,a1501,20140120,4230,4216,4200,4254,4199,4245,4231,29,15,20678,875001240,63100
674,a1501,20140121,4245,4231,4238,4280,4217,4274,4255,43,24,15966,679357320,58902
675,a1501,20140122,4274,4255,4253,4291,4240,4255,4268,0,13,22724,970061260,52318
676,a1501,20140123,4255,4268,4259,4275,4250,4258,4262,-10,-6,8532,363669920,52476
677,a1501,20140124,4258,4262,4250,4259,4222,4234,4233,-28,-29,9182,388738720,52126
678,a1501,20140127,4234,4233,4236,4246,4235,4244,4239,11,6,4724,200281240,50892
679,a1501,20140128,4244,4239,4243,4245,4227,4239,4235,0,-4,4916,208205880,48304
680,a1501,20140129,4239,4235,4235,4255,4235,4239,4244,4,9,4696,199333500,46912
681,a1501,20140130,4239,4244,4234,4234,4218,4223,4228,-21,-16,4170,176334280,46600
682,a1501,20140207,4223,4228,4280,4280,4245,4254,4259,26,31,3292,140207600,45904
683,a1501,20140210,4254,4259,4255,4306,4255,4303,4285,44,26,14136,605843600,51146
684,a1501,20140211,4303,4285,4292,4375,4290,4340,4349,55,64,37832,1645333500,63566
685,a1501,20140212,4340,4349,4350,4399,4345,4365,4373,16,24,23360,1021533900,68404
686,a1501,20140213,4365,4373,4350,4380,4346,4379,4367,6,-6,15854,692444940,73050
687,a1501,20140214,4379,4367,4398,4412,4372,4383,4391,16,24,16608,729372080,73130
688,a1501,20140217,4383,4391,4390,4390,4345,4348,4364,-43,-27,16840,734972660,75232
689,a1501,20140218,4348,4364,4350,4358,4330,4333,4342,-31,-22,12050,523302060,74100
690,a1501,20140219,4333,4342,4361,4365,4312,4323,4332,-19,-10,17612,762992440,79112
691,a1501,20140220,4323,4332,4320,4328,4307,4321,4317,-11,-15,11372,490964400,76916
692,a1501,20140221,4321,4317,4327,4332,4306,4313,4315,-4,-2,19264,831378500,80416
693,a1501,20140224,4313,4315,4332,4348,4311,4338,4333,23,18,19410,841193180,80556
694,a1501,20140225,4338,4333,4340,4345,4323,4323,4334,-10,1,10142,439602940,80982
695,a1501,20140226,4323,4334,4334,4334,4316,4319,4323,-15,-11,10088,436125900,80958
696,a1501,20140227,4319,4323,4322,4331,4303,4306,4315,-17,-8,6306,272162120,82996
697,a1501,20140228,4306,4315,4280,4295,4266,4269,4275,-46,-40,10926,467171640,83068
698,a1501,20140303,4269,4275,4283,4297,4279,4280,4286,5,11,11192,479794280,84136
699,a1501,20140304,4280,4286,4275,4278,4258,4268,4268,-18,-18,10346,441595920,85978
700,a1501,20140305,4268,4268,4270,4288,4270,4284,4280,16,12,7998,342357320,86884
701,a1501,20140306,4284,4280,4280,4285,4276,4278,4279,-2,-1,7222,309100840,87642
702,a1501,20140307,4278,4279,4294,4294,4276,4279,4283,0,4,9636,412780960,88650
703,a1501,20140310,4279,4283,4250,4261,4202,4214,4227,-69,-56,21264,898926300,84686
704,a1501,20140311,4214,4227,4182,4249,4182,4249,4224,22,-3,36102,1525153580,76842
705,a1501,20140312,4249,4224,4230,4253,4230,4239,4240,15,16,5460,231556460,76958
706,a1501,20140313,4239,4240,4232,4235,4220,4235,4225,-5,-15,8844,373745920,76580
707,a1501,20140314,4235,4225,4238,4238,4216,4219,4224,-6,-1,6342,267928040,76502
708,a1501,20140317,4219,4224,4211,4218,4191,4200,4199,-24,-25,5902,247838220,77670
709,a1501,20140318,4200,4199,4191,4211,4167,4186,4191,-13,-8,7912,331630940,78672
710,a1501,20140319,4186,4191,4200,4200,4183,4192,4194,1,3,6378,267496820,79340
711,a1501,20140320,4192,4194,4192,4194,4161,4171,4172,-23,-22,15296,638266960,82896
712,a1501,20140321,4171,4172,4165,4180,4161,4174,4169,2,-3,6340,264375120,84288
713,a1501,20140324,4174,4169,4169,4180,4163,4172,4171,3,2,4198,175108340,83902
714,a1501,20140325,4172,4171,4172,4191,4166,4187,4180,16,9,15640,653826880,89960
715,a1501,20140326,4187,4180,4189,4195,4168,4183,4179,3,-1,12488,521961660,94942
716,a1501,20140327,4183,4179,4185,4198,4178,4185,4189,6,10,18626,780357000,99974
717,a1501,20140328,4185,4189,4188,4189,4146,4150,4165,-39,-24,20124,838168160,105562
718,a1501,20140331,4150,4165,4148,4158,4145,4148,4150,-17,-15,14480,600989060,109292
719,a1501,20140401,4148,4150,4157,4193,4153,4183,4179,33,29,25156,1051345060,108956
720,a1501,20140402,4183,4179,4197,4211,4171,4179,4190,0,11,35146,1472756780,115756
721,a1501,20140403,4179,4190,4168,4168,4153,4160,4160,-30,-30,22574,939118300,114728
722,a1501,20140404,4160,4160,4166,4206,4161,4194,4192,34,32,43346,1817287260,120484
723,a1501,20140408,4194,4192,4201,4249,4190,4210,4202,18,10,26868,1129238880,119016
724,a1501,20140409,4210,4202,4228,4230,4202,4207,4219,5,17,27130,1144664320,120648
725,a1501,20140410,4207,4219,4216,4225,4204,4208,4212,-11,-7,17640,743049660,119416
726,a1501,20140411,4208,4212,4200,4207,4193,4203,4199,-9,-13,10954,459972400,118086
727,a1501,20140414,4203,4199,4218,4273,4195,4269,4243,70,44,56760,2408487440,120514
728,a1501,20140415,4269,4243,4280,4332,4276,4329,4304,86,61,107622,4632790300,143086
729,a1501,20140416,4329,4304,4341,4357,4317,4339,4332,35,28,59564,2580397860,152388
730,a1501,20140417,4339,4332,4345,4364,4326,4343,4342,11,10,49580,2153180360,153998
731,a1501,20140418,4343,4342,4330,4376,4330,4348,4359,6,17,90858,3960883760,172398
732,a1501,20140421,4348,4359,4348,4355,4288,4299,4315,-60,-44,85310,3681181660,167282
733,a1501,20140422,4299,4315,4283,4322,4280,4316,4306,1,-9,52380,2255841020,172110
734,a1501,20140423,4316,4306,4303,4340,4298,4314,4320,8,14,55238,2386742100,170568
735,a1501,20140424,4314,4320,4326,4340,4312,4340,4326,20,6,28420,1229508180,175790
736,a1501,20140425,4340,4326,4338,4390,4336,4370,4371,44,45,126908,5547823600,195550
737,a1501,20140428,4370,4371,4395,4408,4362,4373,4381,2,10,76636,3357927080,194216
738,a1501,20140429,4373,4381,4360,4391,4340,4376,4371,-5,-10,60034,2624339540,191922
739,a1501,20140430,4376,4371,4384,4391,4362,4363,4374,-8,3,48088,2103814040,179512
740,a1501,20140505,4363,4374,4340,4385,4337,4369,4367,-5,-7,45778,1999142600,182166
741,a1501,20140506,4369,4367,4364,4369,4302,4308,4341,-59,-26,115982,5034798140,203828
742,a1501,20140507,4308,4341,4310,4329,4292,4295,4303,-46,-38,64974,2795961560,205778
743,a1501,20140508,4295,4303,4283,4312,4278,4292,4297,-11,-6,109400,4701755140,208692
744,a1501,20140509,4292,4297,4302,4303,4276,4276,4294,-21,-3,40222,1727486920,204138
745,a1501,20140512,4276,4294,4295,4298,4270,4276,4281,-18,-13,57106,2445117820,202852
746,a1501,20140513,4276,4281,4263,4320,4259,4316,4293,35,12,97070,4168102120,211402
747,a1501,20140514,4316,4293,4320,4405,4320,4394,4378,101,85,159114,6966599260,236800
748,a1501,20140515,4394,4378,4388,4484,4376,4469,4445,91,67,240218,10678796720,254890
749,a1501,20140516,4469,4445,4460,4497,4440,4483,4471,38,26,216220,9668361400,264284
750,a1501,20140519,4483,4471,4492,4535,4458,4523,4509,52,38,272160,12272237040,289846
751,a1501,20140520,4523,4509,4550,4600,4498,4589,4557,80,48,328350,14965608240,287678
752,a1501,20140521,4589,4557,4575,4658,4561,4590,4610,33,53,566686,26125616860,337464
753,a1501,20140522,4590,4610,4629,4643,4590,4602,4616,-8,6,320738,14806779620,341760
754,a1501,20140523,4602,4616,4597,4608,4562,4572,4584,-44,-32,239014,10957935880,335674
755,a1501,20140526,4572,4584,4573,4599,4561,4574,4580,-10,-4,198946,9113354280,344086
756,a1501,20140527,4574,4580,4570,4585,4536,4552,4555,-28,-25,227804,10377775780,328662
757,a1501,20140528,4552,4555,4549,4674,4538,4651,4636,96,81,709724,32908458060,441394
758,a1501,20140529,4651,4636,4652,4670,4623,4628,4641,-8,5,341274,15840552120,432594
759,a1501,20140530,4628,4641,4630,4653,4518,4555,4589,-86,-52,495148,22725982460,382130
760,a1501,20140603,4555,4589,4547,4570,4532,4559,4556,-30,-33,162322,7396029380,381960
761,a1501,20140604,4559,4556,4535,4592,4535,4554,4564,-2,8,276968,12641605740,383672
762,a1501,20140605,4554,4564,4561,4571,4501,4501,4527,-63,-37,251012,11365475540,353108
763,a1501,20140606,4501,4527,4482,4501,4452,4466,4475,-61,-52,239258,10707417120,320906
764,a1501,20140609,4466,4475,4468,4529,4463,4507,4502,32,27,192518,8668829960,325336
765,a1501,20140610,4507,4502,4505,4517,4464,4465,4491,-37,-11,191802,8613966280,317108
766,a1501,20140611,4465,4491,4478,4497,4463,4477,4481,-14,-10,111632,5002923340,309148
767,a1501,20140612,4477,4481,4456,4512,4444,4485,4487,4,6,190554,8551479680,321720
768,a1501,20140613,4485,4487,4471,4490,4459,4477,4473,-10,-14,103704,4639180320,311800
769,a1501,20140616,4477,4473,4488,4533,4476,4516,4511,43,38,212962,9607450560,330588
770,a1501,20140617,4516,4511,4521,4521,4476,4486,4492,-25,-19,167948,7544243600,320894
771,a1501,20140618,4486,4492,4468,4507,4464,4489,4488,-3,-4,141568,6354947400,324074
772,a1501,20140619,4489,4488,4491,4510,4490,4491,4499,3,11,93252,4195731240,320924
773,a1501,20140620,4491,4499,4503,4514,4487,4499,4501,0,2,99610,4483904300,317140
774,a1501,20140623,4499,4501,4506,4550,4504,4526,4529,25,28,180324,8167868140,315262
775,a1501,20140624,4526,4529,4516,4520,4497,4504,4505,-25,-24,101040,4552274380,303704
776,a1501,20140625,4504,4505,4501,4515,4477,4490,4496,-15,-9,99544,4476195160,301126
777,a1501,20140626,4490,4496,4485,4494,4479,4484,4485,-12,-11,42378,1900928500,299478
778,a1501,20140627,4484,4485,4496,4510,4473,4476,4487,-9,2,88406,3967617580,295652
779,a1501,20140630,4476,4487,4463,4482,4451,4452,4465,-35,-22,62762,2802402700,294504
780,a1501,20140701,4452,4465,4310,4386,4309,4355,4347,-110,-118,254722,11074080320,244828
781,a1501,20140702,4355,4347,4376,4381,4337,4363,4361,16,14,91562,3993674920,245554
782,a1501,20140703,4363,4361,4331,4365,4331,4355,4353,-6,-8,57364,2497314880,246846
783,a1501,20140704,4355,4353,4344,4354,4323,4323,4336,-30,-17,47514,2060282940,243884
784,a1501,20140707,4323,4336,4327,4333,4300,4314,4311,-22,-25,60892,2625501040,243604
785,a1501,20140708,4314,4311,4315,4397,4310,4361,4367,50,56,213486,9324399840,253456
786,a1501,20140709,4361,4367,4352,4372,4320,4329,4347,-38,-20,89698,3899231600,245380
787,a1501,20140710,4329,4347,4320,4335,4312,4328,4325,-19,-22,57846,2502215420,242026
788,a1501,20140711,4328,4325,4324,4345,4297,4331,4321,6,-4,80790,3491259860,238530
789,a1501,20140714,4331,4321,4300,4344,4267,4343,4315,22,-6,106172,4582264600,240818
790,a1501,20140715,4343,4315,4343,4354,4323,4333,4337,18,22,47922,2078742580,233892
791,a1501,20140716,4333,4337,4341,4351,4335,4340,4342,3,5,54076,2348204880,230072
792,a1501,20140717,4340,4342,4340,4348,4328,4329,4336,-13,-6,39370,1707200300,226600
793,a1501,20140718,4329,4336,4330,4347,4312,4323,4328,-13,-8,65052,2815556840,226880
794,a1501,20140721,4323,4328,4316,4339,4301,4316,4322,-12,-6,66478,2873224020,232196
795,a1501,20140722,4316,4322,4316,4361,4303,4358,4336,36,14,112618,4883180920,238494
796,a1501,20140723,4358,4336,4345,4388,4338,4338,4361,2,25,148686,6484378720,223866
797,a1501,20140724,4338,4361,4362,4369,4334,4349,4352,-12,-9,67942,2957455300,222326
798,a1501,20140725,4349,4352,4348,4361,4333,4343,4346,-9,-6,50262,2184634020,219758
799,a1501,20140728,4343,4346,4360,4405,4353,4399,4379,53,33,96442,4223524940,218642
800,a1501,20140729,4399,4379,4415,4449,4410,4422,4428,43,49,121862,5396348680,213612
801,a1501,20140730,4422,4428,4406,4420,4374,4419,4399,-9,-29,59920,2636152380,212502
802,a1501,20140731,4419,4399,4410,4454,4403,4442,4428,43,29,74146,3283378560,215400
803,a1501,20140801,4442,4428,4440,4474,4424,4470,4451,42,23,138422,6161212260,231502
804,a1501,20140804,4470,4451,4467,4531,4463,4527,4497,76,46,314108,14128007380,286782
805,a1501,20140805,4527,4497,4523,4557,4515,4551,4539,54,42,204292,9273118700,293956
806,a1501,20140806,4551,4539,4544,4547,4525,4532,4533,-7,-6,111270,5044505300,299114
807,a1501,20140807,4532,4533,4546,4555,4512,4522,4527,-11,-6,131870,5970709860,302094
808,a1501,20140808,4522,4527,4512,4555,4512,4547,4539,20,12,128248,5821439580,314566
809,a1501,20140811,4547,4539,4547,4584,4547,4579,4571,40,32,143236,6548356620,321090
810,a1501,20140812,4579,4571,4577,4592,4558,4568,4573,-3,2,162298,7422354040,311636
811,a1501,20140813,4568,4573,4565,4637,4562,4633,4610,60,37,281030,12957259940,337070
812,a1501,20140814,4633,4610,4630,4652,4523,4576,4593,-34,-17,602736,27689316800,324224
813,a1501,20140815,4576,4593,4585,4608,4568,4607,4592,14,-1,259398,11913039800,351936
814,a1501,20140818,4607,4592,4609,4610,4572,4598,4588,6,-4,160944,7384279300,353538
815,a1501,20140819,4598,4588,4597,4601,4539,4558,4560,-30,-28,280634,12797041100,351764
816,a1501,20140820,4558,4560,4560,4565,4514,4533,4530,-27,-30,237926,10779815540,358274
817,a1501,20140821,4533,4530,4523,4537,4480,4490,4497,-40,-33,242250,10895013640,363910
818,a1501,20140822,4490,4497,4491,4533,4476,4512,4514,15,17,197850,8932563460,368816
819,a1501,20140825,4512,4514,4515,4520,4488,4520,4502,6,-12,117524,5291683940,369242
820,a1501,20140826,4520,4502,4513,4606,4503,4601,4554,99,52,335972,15301819640,413680
821,a1501,20140827,4601,4554,4605,4620,4582,4614,4601,60,47,397860,18306565240,434776
822,a1501,20140828,4614,4601,4610,4619,4571,4586,4593,-15,-8,442312,20315774980,421648
823,a1501,20140829,4586,4593,4592,4610,4575,4583,4591,-10,-2,316458,14529840960,419718
824,a1501,20140901,4583,4591,4585,4604,4580,4597,4591,6,0,219006,10054600620,420648
825,a1501,20140902,4597,4591,4596,4646,4595,4624,4627,33,36,453346,20979620280,439828
826,a1501,20140903,4624,4627,4624,4638,4607,4612,4621,-15,-6,225026,10398567660,443136
827,a1501,20140904,4612,4621,4603,4605,4562,4564,4584,-57,-37,251980,11550955700,432488
828,a1501,20140905,4564,4584,4564,4590,4547,4581,4568,-3,-16,279380,12764101460,425016
829,a1501,20140909,4581,4568,4566,4606,4530,4538,4567,-30,-1,298960,13655103560,417466
830,a1501,20140910,4538,4567,4521,4555,4508,4554,4532,-13,-35,211294,9576131960,418302
831,a1501,20140911,4554,4532,4547,4560,4515,4533,4531,1,-1,201686,9140200040,415928
832,a1501,20140912,4533,4531,4525,4624,4518,4619,4585,88,54,495514,22722907740,474342
833,a1501,20140915,4619,4585,4605,4641,4588,4614,4617,29,32,519754,23999301340,522906
834,a1501,20140916,4614,4617,4617,4799,4593,4623,4649,6,32,899650,41825212700,484712
835,a1501,20140917,4623,4649,4616,4646,4604,4640,4627,-9,-22,320854,14847716360,490440
836,a1501,20140918,4640,4627,4645,4666,4605,4624,4620,-3,-7,260914,12056446360,482470
837,a1501,20140919,4624,4620,4605,4626,4574,4581,4598,-39,-22,348968,16047669900,457328
838,a1501,20140922,4581,4598,4563,4578,4512,4551,4550,-47,-48,520754,23694827800,421810
839,a1501,20140923,4551,4550,4535,4550,4503,4520,4532,-30,-18,357652,16210970720,387130
840,a1501,20140924,4520,4532,4530,4576,4508,4543,4546,11,14,311020,14141687540,397468
841,a1501,20140925,4543,4546,4554,4604,4552,4579,4578,33,32,278708,12760699260,383828
842,a1501,20140926,4579,4578,4565,4622,4553,4592,4582,14,4,318316,14586768760,381754
843,a1501,20140929,4592,4582,4598,4647,4574,4588,4600,6,18,211150,9714661420,360030
844,a1501,20140930,4588,4600,4610,4616,4567,4574,4589,-26,-11,155444,7133629120,330918
845,a1501,20141008,4574,4589,4599,4600,4528,4542,4547,-47,-42,198398,9021778000,325256
846,a1501,20141009,4542,4547,4548,4564,4523,4530,4543,-17,-4,218458,9926224020,339376
847,a1501,20141010,4530,4543,4518,4542,4398,4410,4457,-133,-86,611918,27273995120,365902
848,a1501,20141013,4410,4457,4410,4444,4353,4389,4394,-68,-63,559030,24569040700,416864
849,a1501,20141014,4389,4394,4425,4458,4395,4415,4422,21,28,520802,23031781780,371782
850,a1501,20141015,4415,4422,4423,4450,4384,4439,4427,17,5,245714,10878017820,368204
851,a1501,20141016,4439,4427,4420,4455,4398,4435,4428,8,1,264886,11731212080,376164
852,a1501,20141017,4435,4428,4454,4480,4437,4456,4453,28,25,184252,8206282400,371984
853,a1501,20141020,4456,4453,4446,4449,4377,4437,4412,-16,-41,335924,14821512280,374856
854,a1501,20141021,4437,4412,4448,4498,4437,4477,4476,65,64,276024,12355536520,367810
855,a1501,20141022,4477,4476,4492,4511,4462,4481,4480,5,4,163544,7327777280,369036
856,a1501,20141023,4481,4480,4466,4490,4445,4485,4472,5,-8,163670,7319459120,372776
857,a1501,20141024,4485,4472,4510,4550,4498,4500,4520,28,48,252084,11395214940,357020
858,a1501,20141027,4500,4520,4474,4495,4464,4490,4481,-30,-39,123708,5543631580,366066
859,a1501,20141028,4490,4481,4530,4535,4462,4465,4495,-16,14,174932,7863693120,363268
860,a1501,20141029,4465,4495,4468,4498,4462,4485,4478,-10,-17,134674,6031748940,358524
861,a1501,20141030,4485,4478,4521,4526,4486,4509,4507,31,29,174892,7883017160,354020
862,a1501,20141031,4509,4507,4499,4610,4495,4604,4572,97,65,341324,15608120520,362796
863,a1501,20141103,4604,4572,4600,4620,4568,4568,4591,-4,19,180384,8281992460,345060
864,a1501,20141104,4568,4591,4562,4590,4553,4569,4573,-22,-18,141306,6463331780,336454
865,a1501,20141105,4569,4573,4560,4596,4557,4574,4581,1,8,164244,7524275700,342778
866,a1501,20141106,4574,4581,4587,4609,4483,4533,4529,-48,-52,425150,19257875540,352450
867,a1501,20141107,4533,4529,4548,4585,4547,4578,4571,49,42,185108,8462762960,359548
868,a1501,20141110,4578,4571,4592,4594,4552,4571,4566,0,-5,147712,6745838960,366154
869,a1501,20141111,4571,4566,4555,4574,4543,4557,4555,-9,-11,143432,6533922800,355026
870,a1501,20141112,4557,4555,4592,4592,4485,4499,4549,-56,-6,237954,10825625280,331882
871,a1501,20141113,4499,4549,4493,4538,4480,4519,4510,-30,-39,175070,7897236320,330000
872,a1501,20141114,4519,4510,4510,4529,4494,4521,4513,11,3,102696,4635269660,320860
873,a1501,20141117,4521,4513,4510,4531,4503,4520,4520,7,7,86710,3919839840,307794
874,a1501,20141118,4520,4520,4531,4553,4505,4526,4519,6,-1,99960,4517444040,285536
875,a1501,20141119,4526,4519,4515,4538,4510,4522,4521,3,2,67782,3064536240,284298
876,a1501,20141120,4522,4521,4521,4530,4495,4524,4517,3,-4,59950,2708139740,280244
877,a1501,20141121,4524,4517,4537,4537,4519,4529,4528,12,11,45560,2062979140,273400
878,a1501,20141124,4529,4528,4539,4541,4456,4465,4488,-63,-40,171752,7708386480,282434
879,a1501,20141125,4465,4488,4472,4505,4450,4502,4482,14,-6,102220,4581958640,279266
880,a1501,20141126,4502,4482,4497,4523,4492,4519,4511,37,29,63056,2844811820,268378
881,a1501,20141127,4519,4511,4514,4545,4507,4542,4534,31,23,98280,4456419000,246180
882,a1501,20141128,4542,4534,4540,4555,4533,4547,4542,13,8,84958,3858866920,226606
883,a1501,20141201,4547,4542,4520,4576,4520,4565,4554,23,12,67988,3096221260,229894
884,a1501,20141202,4565,4554,4566,4574,4561,4569,4567,15,13,36970,1688783520,224376
885,a1501,20141203,4569,4567,4560,4615,4550,4609,4590,42,23,107526,4935974080,208264
886,a1501,20141204,4609,4590,4610,4624,4592,4612,4611,22,21,60224,2777034780,199646
887,a1501,20141205,4612,4611,4620,4651,4615,4648,4635,37,24,72552,3363316120,183428
888,a1501,20141208,4648,4635,4668,4668,4633,4638,4642,3,7,42060,1952492600,172988
889,a1501,20141209,4638,4642,4640,4645,4624,4628,4632,-14,-10,31348,1452132720,163486
890,a1501,20141210,4628,4632,4620,4651,4620,4647,4639,15,7,36836,1708923060,153406
891,a1501,20141211,4647,4639,4643,4651,4625,4632,4639,-7,0,25364,1176677700,147938
892,a1501,20141212,4632,4639,4639,4639,4613,4636,4624,-3,-15,38728,1790899980,141564
893,a1501,20141215,4636,4624,4635,4649,4624,4640,4639,16,15,21430,994271960,132848
894,a1501,20141216,4640,4639,4633,4640,4618,4622,4624,-17,-15,24054,1112474140,124854
895,a1501,20141217,4622,4624,4616,4631,4611,4619,4619,-5,-5,18532,856153840,119234
896,a1501,20141218,4619,4619,4619,4653,4614,4625,4624,6,5,20980,970243160,111012
897,a1501,20141219,4625,4624,4629,4635,4615,4617,4625,-7,1,23586,1090925680,96730
898,a1501,20141222,4617,4625,4618,4618,4577,4586,4590,-39,-35,22890,1050784840,93596
899,a1501,20141223,4586,4590,4590,4593,4571,4584,4587,-6,-3,8808,404037940,89982
900,a1501,20141224,4584,4587,4589,4595,4566,4590,4579,3,-8,25346,1160717900,83048
901,a1501,20141225,4590,4579,4579,4631,4576,4623,4603,44,24,16916,778690620,78752
902,a1501,20141226,4623,4603,4630,4653,4623,4647,4644,44,41,21280,988432160,72216
903,a1501,20141229,4647,4644,4655,4664,4641,4660,4655,16,11,19234,895461500,59138
904,a1501,20141230,4660,4655,4652,4664,4651,4661,4659,6,4,18570,865251620,52776
905,a1501,20141231,4661,4659,4660,4737,4647,4670,4665,11,6,21586,1007096660,41886
906,a1503,20140102,4243,4243,0,0,0,4243,4243,0,0,0,0,66
907,a1503,20140103,4243,4243,0,0,0,4243,4243,0,0,0,0,66
908,a1503,20140106,4243,4243,4232,4232,4232,4232,4232,-11,-11,4,169280,66
909,a1503,20140107,4232,4232,4141,4141,4140,4140,4140,-92,-92,46,1904460,22
910,a1503,20140108,4140,4140,0,0,0,4123,4123,-17,-17,0,0,22
911,a1503,20140109,4123,4123,4110,4159,4110,4159,4122,36,-1,8,329780,22
912,a1503,20140110,4159,4122,0,0,0,4211,4211,89,89,0,0,22
913,a1503,20140113,4211,4211,4211,4211,4166,4166,4188,-45,-23,4,167540,22
914,a1503,20140114,4166,4188,4180,4180,4180,4180,4180,-8,-8,2,83600,22
915,a1503,20140115,4180,4180,0,0,0,4195,4195,15,15,0,0,22
916,a1503,20140116,4195,4195,0,0,0,4221,4221,26,26,0,0,22
917,a1503,20140117,4221,4221,0,0,0,4222,4222,1,1,0,0,22
918,a1503,20140120,4222,4222,0,0,0,4261,4261,39,39,0,0,22
919,a1503,20140121,4261,4261,0,0,0,4267,4267,6,6,0,0,22
920,a1503,20140122,4267,4267,4295,4295,4295,4295,4295,28,28,8,343600,22
921,a1503,20140123,4295,4295,4271,4276,4271,4276,4272,-19,-23,6,256360,22
922,a1503,20140124,4276,4272,0,0,0,4272,4272,0,0,0,0,22
923,a1503,20140127,4272,4272,0,0,0,4272,4272,0,0,0,0,22
924,a1503,20140128,4272,4272,0,0,0,4272,4272,0,0,0,0,22
925,a1503,20140129,4272,4272,0,0,0,4272,4272,0,0,0,0,22
926,a1503,20140130,4272,4272,0,0,0,4254,4254,-18,-18,0,0,22
927,a1503,20140207,4254,4254,0,0,0,4273,4273,19,19,0,0,22
928,a1503,20140210,4273,4273,0,0,0,4312,4312,39,39,0,0,22
929,a1503,20140211,4312,4312,4347,4347,4347,4347,4347,35,35,4,173880,24
930,a1503,20140212,4347,4347,0,0,0,4380,4380,33,33,0,0,24
931,a1503,20140213,4380,4380,0,0,0,4389,4389,9,9,0,0,24
932,a1503,20140214,4389,4389,4400,4400,4393,4399,4397,10,8,8,351820,18
933,a1503,20140217,4399,4397,0,0,0,4370,4370,-27,-27,0,0,18
934,a1503,20140218,4370,4370,0,0,0,4348,4348,-22,-22,0,0,18
935,a1503,20140219,4348,4348,0,0,0,4348,4348,0,0,0,0,18
936,a1503,20140220,4348,4348,0,0,0,4348,4348,0,0,0,0,18
937,a1503,20140221,4348,4348,0,0,0,4348,4348,0,0,0,0,18
938,a1503,20140224,4348,4348,4439,4460,4439,4460,4446,112,98,16,711500,34
939,a1503,20140225,4460,4446,4375,4375,4375,4375,4375,-71,-71,6,262500,32
940,a1503,20140226,4375,4375,0,0,0,4375,4375,0,0,0,0,32
941,a1503,20140227,4375,4375,0,0,0,4365,4365,-10,-10,0,0,32
942,a1503,20140228,4365,4365,4250,4302,4196,4302,4251,-63,-114,22,935280,20
943,a1503,20140303,4302,4251,4310,4310,4310,4310,4310,59,59,6,258600,20
944,a1503,20140304,4310,4310,4317,4317,4300,4300,4308,-10,-2,4,172340,18
945,a1503,20140305,4300,4308,0,0,0,4308,4308,0,0,0,0,18
946,a1503,20140306,4308,4308,0,0,0,4308,4308,0,0,0,0,18
947,a1503,20140307,4308,4308,0,0,0,4308,4308,0,0,0,0,18
948,a1503,20140310,4308,4308,0,0,0,4289,4289,-19,-19,0,0,18
949,a1503,20140311,4289,4289,4272,4336,4263,4263,4290,-26,1,6,257420,18
950,a1503,20140312,4263,4290,4281,4282,4281,4282,4281,-8,-9,6,256900,18
951,a1503,20140313,4282,4281,0,0,0,4266,4266,-15,-15,0,0,18
952,a1503,20140314,4266,4266,0,0,0,4266,4266,0,0,0,0,18
953,a1503,20140317,4266,4266,4228,4228,4228,4228,4228,-38,-38,2,84560,18
954,a1503,20140318,4228,4228,4141,4238,4141,4236,4187,8,-41,20,837580,22
955,a1503,20140319,4236,4187,0,0,0,4187,4187,0,0,0,0,22
956,a1503,20140320,4187,4187,0,0,0,4187,4187,0,0,0,0,22
957,a1503,20140321,4187,4187,0,0,0,4187,4187,0,0,0,0,22
958,a1503,20140324,4187,4187,0,0,0,4187,4187,0,0,0,0,22
959,a1503,20140325,4187,4187,0,0,0,4190,4190,3,3,0,0,22
960,a1503,20140326,4190,4190,0,0,0,4190,4190,0,0,0,0,22
961,a1503,20140327,4190,4190,0,0,0,4199,4199,9,9,0,0,22
962,a1503,20140328,4199,4199,0,0,0,4199,4199,0,0,0,0,22
963,a1503,20140331,4199,4199,0,0,0,4199,4199,0,0,0,0,22
964,a1503,20140401,4199,4199,0,0,0,4204,4204,5,5,0,0,22
965,a1503,20140402,4204,4204,0,0,0,4210,4210,6,6,0,0,22
966,a1503,20140403,4210,4210,0,0,0,4210,4210,0,0,0,0,22
967,a1503,20140404,4210,4210,4249,4249,4248,4248,4248,38,38,4,169940,18
968,a1503,20140408,4248,4248,0,0,0,4258,4258,10,10,0,0,18
969,a1503,20140409,4258,4258,0,0,0,4258,4258,0,0,0,0,18
970,a1503,20140410,4258,4258,4262,4262,4262,4262,4262,4,4,4,170480,20
971,a1503,20140411,4262,4262,4262,4262,4250,4255,4256,-7,-6,14,595940,22
972,a1503,20140414,4255,4256,4266,4266,4266,4266,4266,10,10,2,85320,20
973,a1503,20140415,4266,4266,0,0,0,4366,4366,100,100,0,0,20
974,a1503,20140416,4366,4366,0,0,0,4394,4394,28,28,0,0,20
975,a1503,20140417,4394,4394,0,0,0,4394,4394,0,0,0,0,20
976,a1503,20140418,4394,4394,4407,4407,4402,4402,4403,8,9,6,264220,18
977,a1503,20140421,4402,4403,0,0,0,4383,4383,-20,-20,0,0,18
978,a1503,20140422,4383,4383,4291,4358,4291,4358,4318,-25,-65,26,1122920,24
979,a1503,20140423,4358,4318,4364,4365,4364,4365,4364,47,46,6,261860,28
980,a1503,20140424,4365,4364,4364,4364,4364,4364,4364,0,0,2,87280,28
981,a1503,20140425,4364,4364,4449,4449,4386,4386,4417,22,53,46,2032240,30
982,a1503,20140428,4386,4417,0,0,0,4417,4417,0,0,0,0,30
983,a1503,20140429,4417,4417,0,0,0,4417,4417,0,0,0,0,30
984,a1503,20140430,4417,4417,4419,4419,4419,4419,4419,2,2,2,88380,30
985,a1503,20140505,4419,4419,4415,4421,4415,4421,4418,2,-1,4,176720,30
986,a1503,20140506,4421,4418,4400,4411,4370,4370,4393,-48,-25,20,878680,36
987,a1503,20140507,4370,4393,4308,4308,4308,4308,4308,-85,-85,2,86160,34
988,a1503,20140508,4308,4308,0,0,0,4302,4302,-6,-6,0,0,34
989,a1503,20140509,4302,4302,4340,4340,4335,4335,4337,33,35,4,173500,34
990,a1503,20140512,4335,4337,4330,4330,4330,4330,4330,-7,-7,2,86600,36
991,a1503,20140513,4330,4330,4340,4340,4340,4340,4340,10,10,2,86800,34
992,a1503,20140514,4340,4340,0,0,0,4425,4425,85,85,0,0,34
993,a1503,20140515,4425,4425,4430,4459,4430,4459,4444,34,19,4,177780,36
994,a1503,20140516,4459,4444,4509,4509,4509,4509,4509,65,65,6,270540,34
995,a1503,20140519,4509,4509,4524,4585,4524,4583,4549,74,40,56,2547560,34
996,a1503,20140520,4583,4549,4557,4600,4557,4600,4595,51,46,22,1011100,18
997,a1503,20140521,4600,4595,4672,4672,4651,4651,4658,56,63,14,652200,14
998,a1503,20140522,4651,4658,4674,4674,4674,4674,4674,16,16,6,280440,14
999,a1503,20140523,4674,4674,4595,4649,4595,4622,4623,-52,-51,254,11742500,74
1000,a1503,20140526,4622,4623,4631,4643,4630,4643,4637,20,14,14,649200,74
1001,a1503,20140527,4643,4637,4634,4634,4610,4610,4622,-27,-15,4,184880,76
1002,a1503,20140528,4610,4622,4622,4719,4622,4703,4696,81,74,24,1127100,80
1003,a1503,20140529,4703,4696,4650,4710,4650,4695,4697,-1,1,20,939540,86
1004,a1503,20140530,4695,4697,0,0,0,4662,4662,-35,-35,0,0,86
1005,a1503,20140603,4662,4662,4600,4611,4600,4611,4609,-51,-53,14,645300,76
1006,a1503,20140604,4611,4609,4599,4614,4588,4599,4599,-10,-10,68,3127740,46
1007,a1503,20140605,4599,4599,4610,4610,4567,4572,4594,-27,-5,42,1929520,66
1008,a1503,20140606,4572,4594,0,0,0,4547,4547,-47,-47,0,0,66
1009,a1503,20140609,4547,4547,4578,4578,4577,4577,4577,30,30,4,183100,64
1010,a1503,20140610,4577,4577,0,0,0,4557,4557,-20,-20,0,0,64
1011,a1503,20140611,4557,4557,0,0,0,4557,4557,0,0,0,0,64
1012,a1503,20140612,4557,4557,4536,4536,4536,4536,4536,-21,-21,2,90720,62
1013,a1503,20140613,4536,4536,0,0,0,4536,4536,0,0,0,0,62
1014,a1503,20140616,4536,4536,4549,4567,4549,4567,4555,31,19,6,273300,62
1015,a1503,20140617,4567,4555,4550,4550,4550,4550,4550,-5,-5,4,182000,62
1016,a1503,20140618,4550,4550,4544,4550,4535,4550,4541,0,-9,16,726560,54
1017,a1503,20140619,4550,4541,0,0,0,4541,4541,0,0,0,0,54
1018,a1503,20140620,4541,4541,0,0,0,4541,4541,0,0,0,0,54
1019,a1503,20140623,4541,4541,4571,4571,4570,4570,4570,29,29,16,731260,42
1020,a1503,20140624,4570,4570,0,0,0,4567,4567,-3,-3,0,0,42
1021,a1503,20140625,4567,4567,0,0,0,4558,4558,-9,-9,0,0,42
1022,a1503,20140626,4558,4558,0,0,0,4553,4553,-5,-5,0,0,42
1023,a1503,20140627,4553,4553,0,0,0,4555,4555,2,2,0,0,42
1024,a1503,20140630,4555,4555,0,0,0,4533,4533,-22,-22,0,0,42
1025,a1503,20140701,4533,4533,0,0,0,4414,4414,-119,-119,0,0,42
1026,a1503,20140702,4414,4414,0,0,0,4428,4428,14,14,0,0,42
1027,a1503,20140703,4428,4428,0,0,0,4420,4420,-8,-8,0,0,42
1028,a1503,20140704,4420,4420,4390,4390,4366,4366,4374,-54,-46,12,524980,42
1029,a1503,20140707,4366,4374,4300,4330,4300,4330,4305,-44,-69,26,1119480,62
1030,a1503,20140708,4330,4305,4359,4403,4359,4401,4391,96,86,26,1141780,60
1031,a1503,20140709,4401,4391,0,0,0,4370,4370,-21,-21,0,0,60
1032,a1503,20140710,4370,4370,4383,4383,4330,4353,4355,-17,-15,12,522640,56
1033,a1503,20140711,4353,4355,0,0,0,4355,4355,0,0,0,0,56
1034,a1503,20140714,4355,4355,4358,4358,4358,4358,4358,3,3,4,174320,56
1035,a1503,20140715,4358,4358,4347,4348,4347,4348,4347,-10,-11,4,173900,54
1036,a1503,20140716,4348,4347,4406,4407,4370,4378,4388,31,41,52,2281940,38
1037,a1503,20140717,4378,4388,4390,4390,4390,4390,4390,2,2,6,263400,44
1038,a1503,20140718,4390,4390,4380,4381,4368,4381,4376,-9,-14,10,437620,42
1039,a1503,20140721,4381,4376,0,0,0,4376,4376,0,0,0,0,42
1040,a1503,20140722,4376,4376,4368,4386,4368,4386,4377,10,1,4,175080,44
1041,a1503,20140723,4386,4377,0,0,0,4402,4402,25,25,0,0,44
1042,a1503,20140724,4402,4402,0,0,0,4398,4398,-4,-4,0,0,44
1043,a1503,20140725,4398,4398,0,0,0,4387,4387,-11,-11,0,0,44
1044,a1503,20140728,4387,4387,0,0,0,4420,4420,33,33,0,0,44
1045,a1503,20140729,4420,4420,0,0,0,4432,4432,12,12,0,0,44
1046,a1503,20140730,4432,4432,4438,4438,4438,4438,4438,6,6,2,88760,42
1047,a1503,20140731,4438,4438,4452,4452,4452,4452,4452,14,14,4,178080,46
1048,a1503,20140801,4452,4452,4451,4451,4451,4451,4451,-1,-1,6,267060,42
1049,a1503,20140804,4451,4451,4508,4508,4508,4508,4508,57,57,8,360640,40
1050,a1503,20140805,4508,4508,4574,4574,4548,4548,4561,40,53,4,182440,40
1051,a1503,20140806,4548,4561,0,0,0,4561,4561,0,0,0,0,40
1052,a1503,20140807,4561,4561,4575,4578,4529,4578,4554,17,-7,8,364320,38
1053,a1503,20140808,4578,4554,4536,4573,4536,4573,4556,19,2,18,820220,36
1054,a1503,20140811,4573,4556,0,0,0,4574,4574,18,18,0,0,36
1055,a1503,20140812,4574,4574,0,0,0,4577,4577,3,3,0,0,36
1056,a1503,20140813,4577,4577,0,0,0,4632,4632,55,55,0,0,36
1057,a1503,20140814,4632,4632,4575,4575,4575,4575,4575,-57,-57,2,91500,36
1058,a1503,20140815,4575,4575,4606,4606,4606,4606,4606,31,31,2,92120,38
1059,a1503,20140818,4606,4606,4587,4587,4587,4587,4587,-19,-19,2,91740,40
1060,a1503,20140819,4587,4587,4645,4645,4562,4562,4592,-25,5,24,1102080,34
1061,a1503,20140820,4562,4592,0,0,0,4587,4587,-5,-5,0,0,34
1062,a1503,20140821,4587,4587,4509,4577,4509,4534,4540,-53,-47,6,272400,32
1063,a1503,20140822,4534,4540,4540,4540,4540,4540,4540,0,0,4,181600,32
1064,a1503,20140825,4540,4540,0,0,0,4540,4540,0,0,0,0,32
1065,a1503,20140826,4540,4540,0,0,0,4592,4592,52,52,0,0,32
1066,a1503,20140827,4592,4592,0,0,0,4623,4623,31,31,0,0,32
1067,a1503,20140828,4623,4623,4620,4620,4617,4617,4618,-6,-5,4,184740,32
1068,a1503,20140829,4617,4618,4620,4652,4620,4620,4630,2,12,6,277840,32
1069,a1503,20140901,4620,4630,4637,4637,4611,4611,4627,-19,-3,14,647780,32
1070,a1503,20140902,4611,4627,4662,4662,4662,4662,4662,35,35,2,93240,30
1071,a1503,20140903,4662,4662,4636,4636,4636,4636,4636,-26,-26,2,92720,32
1072,a1503,20140904,4636,4636,4629,4629,4629,4629,4629,-7,-7,2,92580,30
1073,a1503,20140905,4629,4629,4630,4630,4578,4588,4598,-41,-31,6,275920,32
1074,a1503,20140909,4588,4598,4632,4632,4553,4584,4589,-14,-9,6,275380,30
1075,a1503,20140910,4584,4589,4491,4576,4491,4576,4533,-13,-56,4,181340,30
1076,a1503,20140911,4576,4533,4526,4560,4526,4549,4545,16,12,14,636360,24
1077,a1503,20140912,4549,4545,4599,4671,4599,4617,4639,72,94,8,371160,24
1078,a1503,20140915,4617,4639,4616,4656,4615,4615,4635,-24,-4,8,370820,24
1079,a1503,20140916,4615,4635,0,0,0,4635,4635,0,0,0,0,24
1080,a1503,20140917,4635,4635,0,0,0,4635,4635,0,0,0,0,24
1081,a1503,20140918,4635,4635,0,0,0,4635,4635,0,0,0,0,24
1082,a1503,20140919,4635,4635,4656,4656,4558,4558,4607,-77,-28,4,184280,24
1083,a1503,20140922,4558,4607,4556,4564,4556,4564,4560,-43,-47,4,182400,24
1084,a1503,20140923,4564,4560,4530,4567,4530,4541,4549,-19,-11,18,818860,26
1085,a1503,20140924,4541,4549,0,0,0,4551,4551,2,2,0,0,26
1086,a1503,20140925,4551,4551,0,0,0,4568,4568,17,17,0,0,26
1087,a1503,20140926,4568,4568,0,0,0,4568,4568,0,0,0,0,26
1088,a1503,20140929,4568,4568,4643,4643,4601,4601,4623,33,55,6,277380,26
1089,a1503,20140930,4601,4623,0,0,0,4612,4612,-11,-11,0,0,26
1090,a1503,20141008,4612,4612,0,0,0,4601,4601,-11,-11,0,0,26
1091,a1503,20141009,4601,4601,0,0,0,4589,4589,-12,-12,0,0,26
1092,a1503,20141010,4589,4589,4522,4522,4411,4411,4469,-178,-120,10,446900,24
1093,a1503,20141013,4411,4469,0,0,0,4464,4464,-5,-5,0,0,24
1094,a1503,20141014,4464,4464,4428,4454,4406,4406,4421,-58,-43,36,1591680,42
1095,a1503,20141015,4406,4421,4403,4453,4403,4453,4419,32,-2,18,795540,28
1096,a1503,20141016,4453,4419,0,0,0,4419,4419,0,0,0,0,28
1097,a1503,20141017,4419,4419,0,0,0,4443,4443,24,24,0,0,28
1098,a1503,20141020,4443,4443,4377,4408,4355,4408,4378,-35,-65,10,437880,34
1099,a1503,20141021,4408,4378,0,0,0,4441,4441,63,63,0,0,34
1100,a1503,20141022,4441,4441,0,0,0,4444,4444,3,3,0,0,34
1101,a1503,20141023,4444,4444,4442,4460,4369,4391,4418,-53,-26,12,530260,36
1102,a1503,20141024,4391,4418,0,0,0,4465,4465,47,47,0,0,36
1103,a1503,20141027,4465,4465,0,0,0,4427,4427,-38,-38,0,0,36
1104,a1503,20141028,4427,4427,4401,4449,4401,4449,4433,22,6,6,265980,36
1105,a1503,20141029,4449,4433,4341,4440,4341,4440,4390,7,-43,4,175620,36
1106,a1503,20141030,4440,4390,4405,4405,4405,4405,4405,15,15,2,88100,36
1107,a1503,20141031,4405,4405,0,0,0,4468,4468,63,63,0,0,36
1108,a1503,20141103,4468,4468,0,0,0,4486,4486,18,18,0,0,36
1109,a1503,20141104,4486,4486,4518,4518,4518,4518,4518,32,32,2,90360,36
1110,a1503,20141105,4518,4518,4515,4515,4468,4468,4491,-50,-27,8,359320,36
1111,a1503,20141106,4468,4491,4384,4463,4384,4463,4423,-28,-68,4,176940,38
1112,a1503,20141107,4463,4423,0,0,0,4443,4443,20,20,0,0,38
1113,a1503,20141110,4443,4443,4389,4476,4369,4473,4429,30,-14,16,708740,40
1114,a1503,20141111,4473,4429,4350,4350,4350,4350,4350,-79,-79,10,435000,50
1115,a1503,20141112,4350,4350,4350,4360,4300,4300,4303,-50,-47,1618,69623500,1450
1116,a1503,20141113,4300,4303,4300,4301,4300,4301,4300,-2,-3,32,1376080,1428
1117,a1503,20141114,4301,4300,0,0,0,4305,4305,5,5,0,0,1428
1118,a1503,20141117,4305,4305,0,0,0,4305,4305,0,0,0,0,1428
1119,a1503,20141118,4305,4305,4354,4360,4305,4348,4355,43,50,164,7142240,1280
1120,a1503,20141119,4348,4355,4301,4365,4301,4333,4332,-22,-23,26,1126480,1280
1121,a1503,20141120,4333,4332,4300,4319,4300,4309,4301,-23,-31,312,13421820,1100
1122,a1503,20141121,4309,4301,4313,4313,4313,4313,4313,12,12,2,86260,1100
1123,a1503,20141124,4313,4313,4301,4308,4300,4308,4300,-5,-13,1094,47044840,150
1124,a1503,20141125,4308,4300,4301,4321,4301,4321,4305,21,5,36,1549820,124
1125,a1503,20141126,4321,4305,4385,4385,4350,4350,4361,45,56,6,261700,124
1126,a1503,20141127,4350,4361,4323,4359,4323,4359,4349,-2,-12,8,347920,124
1127,a1503,20141128,4359,4349,4366,4366,4366,4366,4366,17,17,2,87320,122
1128,a1503,20141201,4366,4366,4428,4428,4370,4390,4389,24,23,14,614480,122
1129,a1503,20141202,4390,4389,4376,4376,4376,4376,4376,-13,-13,8,350080,124
1130,a1503,20141203,4376,4376,4389,4400,4370,4400,4385,24,9,14,613920,120
1131,a1503,20141204,4400,4385,4398,4398,4398,4398,4398,13,13,2,87960,120
1132,a1503,20141205,4398,4398,4358,4492,4358,4421,4448,23,50,18,800640,120
1133,a1503,20141208,4421,4448,4465,4474,4421,4459,4450,11,2,72,3204100,168
1134,a1503,20141209,4459,4450,4412,4412,4340,4398,4395,-52,-55,68,2989020,142
1135,a1503,20141210,4398,4395,4419,4419,4396,4407,4405,12,10,58,2555120,140
1136,a1503,20141211,4407,4405,4380,4405,4372,4375,4383,-30,-22,34,1490360,138
1137,a1503,20141212,4375,4383,4382,4394,4376,4376,4384,-7,1,8,350740,136
1138,a1503,20141215,4376,4384,0,0,0,4382,4382,-2,-2,0,0,136
1139,a1503,20141216,4382,4382,4327,4335,4327,4335,4331,-47,-51,4,173240,134
1140,a1503,20141217,4335,4331,4352,4352,4308,4338,4336,7,5,46,1994920,120
1141,a1503,20141218,4338,4336,4357,4357,4313,4342,4338,6,2,10,433880,120
1142,a1503,20141219,4342,4338,4352,4387,4341,4341,4358,3,20,8,348640,116
1143,a1503,20141222,4341,4358,0,0,0,4358,4358,0,0,0,0,116
1144,a1503,20141223,4358,4358,4370,4389,4370,4379,4379,21,21,8,350320,116
1145,a1503,20141224,4379,4379,4400,4400,4400,4400,4400,21,21,2,88000,114
1146,a1503,20141225,4400,4400,4424,4479,4424,4464,4459,64,59,22,981020,122
1147,a1503,20141226,4464,4459,4435,4478,4435,4455,4455,-4,-4,48,2138400,144
1148,a1503,20141229,4455,4455,4452,4460,4452,4457,4457,2,2,42,1871980,174
1149,a1503,20141230,4457,4457,4430,4488,4430,4450,4456,-7,-1,6,267360,176
1150,a1503,20141231,4450,4456,4451,4451,4436,4445,4444,-11,-12,24,1066680,200
1151,a1505,20140102,4236,4232,4218,4239,4213,4239,4226,7,-6,50,2113460,718
1152,a1505,20140103,4239,4226,4239,4261,4226,4244,4236,18,10,64,2711360,708
1153,a1505,20140106,4244,4236,4212,4227,4185,4200,4202,-36,-34,258,10842860,646
1154,a1505,20140107,4200,4202,4205,4212,4180,4180,4195,-22,-7,114,4782940,630
1155,a1505,20140108,4180,4195,4194,4194,4121,4141,4148,-54,-47,276,11449600,668
1156,a1505,20140109,4141,4148,4138,4179,4100,4169,4156,21,8,160,6650840,678
1157,a1505,20140110,4169,4156,4176,4223,4165,4223,4195,67,39,228,9566760,744
1158,a1505,20140113,4223,4195,4228,4228,4160,4175,4177,-20,-18,186,7770380,786
1159,a1505,20140114,4175,4177,4179,4190,4172,4187,4184,10,7,58,2426800,798
1160,a1505,20140115,4187,4184,4196,4212,4194,4205,4205,21,21,88,3700860,838
1161,a1505,20140116,4205,4205,4207,4237,4202,4236,4224,31,19,114,4815920,872
1162,a1505,20140117,4236,4224,4236,4265,4225,4251,4242,27,18,118,5006420,842
1163,a1505,20140120,4251,4242,4242,4279,4240,4273,4262,31,20,114,4859580,850
1164,a1505,20140121,4273,4262,4275,4300,4262,4300,4274,38,12,86,3676160,848
1165,a1505,20140122,4300,4274,4319,4319,4231,4278,4288,4,14,176,7548420,820
1166,a1505,20140123,4278,4288,4300,4304,4280,4280,4293,-8,5,64,2747620,842
1167,a1505,20140124,4280,4293,4294,4294,4259,4267,4265,-26,-28,70,2985600,868
1168,a1505,20140127,4267,4265,4261,4275,4261,4275,4269,10,4,64,2732680,848
1169,a1505,20140128,4275,4269,4265,4271,4265,4271,4269,2,0,10,426980,850
1170,a1505,20140129,4271,4269,4290,4290,4262,4279,4277,10,8,22,941100,850
1171,a1505,20140130,4279,4277,4252,4262,4235,4235,4247,-42,-30,246,10449140,734
1172,a1505,20140207,4235,4247,4281,4290,4277,4278,4284,31,37,38,1628020,736
1173,a1505,20140210,4278,4284,4281,4329,4281,4319,4300,35,16,152,6536520,744
1174,a1505,20140211,4319,4300,4310,4394,4310,4361,4359,61,59,248,10812420,784
1175,a1505,20140212,4361,4359,4388,4411,4371,4378,4384,19,25,52,2280100,792
1176,a1505,20140213,4378,4384,4439,4439,4377,4387,4388,3,4,68,2984020,790
1177,a1505,20140214,4387,4388,4421,4421,4394,4395,4405,7,17,44,1938420,802
1178,a1505,20140217,4395,4405,4386,4389,4362,4366,4374,-39,-31,216,9448220,836
1179,a1505,20140218,4366,4374,4366,4370,4312,4350,4354,-24,-20,76,3309100,814
1180,a1505,20140219,4350,4354,4384,4384,4332,4348,4355,-6,1,178,7752920,844
1181,a1505,20140220,4348,4355,4336,4350,4332,4342,4341,-13,-14,78,3386320,874
1182,a1505,20140221,4342,4341,4334,4390,4334,4355,4354,14,13,620,26998180,1050
1183,a1505,20140224,4355,4354,4354,4377,4350,4377,4358,23,4,158,6886280,964
1184,a1505,20140225,4377,4358,4373,4373,4346,4348,4364,-10,6,162,7070020,984
1185,a1505,20140226,4348,4364,4350,4350,4343,4349,4348,-15,-16,128,5566400,1010
1186,a1505,20140227,4349,4348,4341,4345,4320,4320,4336,-28,-12,98,4249800,1056
1187,a1505,20140228,4320,4336,4312,4312,4286,4290,4297,-46,-39,344,14782220,1176
1188,a1505,20140303,4290,4297,4301,4316,4300,4300,4306,3,9,282,12143460,1320
1189,a1505,20140304,4300,4306,4289,4299,4280,4284,4289,-22,-17,256,10980740,1364
1190,a1505,20140305,4284,4289,4290,4308,4290,4303,4298,14,9,138,5931780,1404
1191,a1505,20140306,4303,4298,4300,4303,4295,4298,4299,0,1,158,6793600,1490
1192,a1505,20140307,4298,4299,4310,4312,4300,4308,4305,9,6,216,9299240,1526
1193,a1505,20140310,4308,4305,4270,4280,4242,4245,4256,-60,-49,378,16088160,1512
1194,a1505,20140311,4245,4256,4240,4267,4230,4267,4255,11,-1,44,1872520,1512
1195,a1505,20140312,4267,4255,4269,4280,4269,4279,4276,24,21,144,6158560,1544
1196,a1505,20140313,4279,4276,4265,4267,4256,4267,4263,-9,-13,64,2728680,1530
1197,a1505,20140314,4267,4263,4259,4265,4249,4249,4256,-14,-7,134,5704260,1548
1198,a1505,20140317,4249,4256,4240,4240,4226,4230,4235,-26,-21,98,4150320,1558
1199,a1505,20140318,4230,4235,4230,4242,4200,4210,4210,-25,-25,504,21220040,1832
1200,a1505,20140319,4210,4210,4227,4239,4224,4228,4229,18,19,218,9221340,1900
1201,a1505,20140320,4228,4229,4219,4244,4212,4226,4231,-3,2,698,29536360,1930
1202,a1505,20140321,4226,4231,4280,4280,4220,4237,4230,6,-1,328,13876140,1978
1203,a1505,20140324,4237,4230,4230,4239,4229,4230,4232,0,2,78,3300980,1996
1204,a1505,20140325,4230,4232,4230,4255,4230,4245,4238,13,6,216,9155440,2116
1205,a1505,20140326,4245,4238,4246,4249,4230,4246,4241,8,3,266,11282440,2176
1206,a1505,20140327,4246,4241,4235,4259,4235,4251,4254,10,13,374,15911260,2158
1207,a1505,20140328,4251,4254,4250,4255,4222,4222,4242,-32,-12,234,9926960,2278
1208,a1505,20140331,4222,4242,4222,4234,4216,4225,4226,-17,-16,214,9044840,2366
1209,a1505,20140401,4225,4226,4230,4257,4229,4252,4250,26,24,250,10625600,2430
1210,a1505,20140402,4252,4250,4279,4279,4251,4254,4261,4,11,726,30935740,2734
1211,a1505,20140403,4254,4261,4236,4251,4228,4237,4241,-24,-20,404,17137220,2862
1212,a1505,20140404,4237,4241,4244,4269,4240,4263,4255,22,14,440,18724240,2850
1213,a1505,20140408,4263,4255,4267,4283,4262,4279,4271,24,16,344,14694580,2922
1214,a1505,20140409,4279,4271,4285,4297,4272,4277,4287,6,16,262,11233600,3006
1215,a1505,20140410,4277,4287,4288,4290,4277,4277,4281,-10,-6,98,4195940,3022
1216,a1505,20140411,4277,4281,4268,4273,4261,4268,4269,-13,-12,46,1963820,3042
1217,a1505,20140414,4268,4269,4279,4340,4279,4332,4313,63,44,514,22172140,3084
1218,a1505,20140415,4332,4313,4332,4393,4332,4393,4371,80,58,1216,53153360,3136
1219,a1505,20140416,4393,4371,4404,4411,4382,4403,4399,32,28,602,26482860,3092
1220,a1505,20140417,4403,4399,4405,4423,4398,4411,4405,12,6,696,30664520,3064
1221,a1505,20140418,4411,4405,4401,4436,4401,4415,4423,10,18,430,19021600,3090
1222,a1505,20140421,4415,4423,4401,4415,4360,4364,4381,-59,-42,600,26290140,3266
1223,a1505,20140422,4364,4381,4351,4380,4341,4380,4368,-1,-13,324,14155520,3278
1224,a1505,20140423,4380,4368,4367,4398,4366,4379,4382,11,14,136,5959760,3298
1225,a1505,20140424,4379,4382,4389,4399,4380,4399,4387,17,5,102,4475280,3316
1226,a1505,20140425,4399,4387,4412,4444,4403,4424,4428,37,41,868,38442060,3424
1227,a1505,20140428,4424,4428,4449,4485,4430,4431,4449,3,21,328,14594680,3478
1228,a1505,20140429,4431,4449,4401,4448,4401,4436,4429,-13,-20,376,16653120,3516
1229,a1505,20140430,4436,4429,4451,4451,4423,4423,4433,-6,4,348,15427360,3546
1230,a1505,20140505,4423,4433,4406,4438,4398,4426,4419,-7,-14,792,35001800,3422
1231,a1505,20140506,4426,4419,4413,4427,4372,4376,4403,-43,-16,1606,70716760,3548
1232,a1505,20140507,4376,4403,4366,4410,4361,4366,4373,-37,-30,1528,66827400,3784
1233,a1505,20140508,4366,4373,4367,4386,4350,4353,4367,-20,-6,516,22536320,3824
1234,a1505,20140509,4353,4367,4367,4369,4352,4352,4362,-15,-5,434,18934080,3700
1235,a1505,20140512,4352,4362,4367,4367,4344,4350,4354,-12,-8,526,22907140,4004
1236,a1505,20140513,4350,4354,4346,4390,4341,4389,4369,35,15,922,40290100,4130
1237,a1505,20140514,4389,4369,4392,4461,4322,4455,4439,86,70,2474,109822140,4516
1238,a1505,20140515,4455,4439,4448,4549,4444,4544,4518,105,79,2672,120726480,5036
1239,a1505,20140516,4544,4518,4525,4567,4512,4554,4541,36,23,3158,143433700,5290
1240,a1505,20140519,4554,4541,4560,4600,4497,4578,4556,37,15,18618,848405800,15166
1241,a1505,20140520,4578,4556,4596,4676,4556,4660,4626,104,70,17782,822758300,21584
1242,a1505,20140521,4660,4626,4665,4767,4650,4708,4716,82,90,37756,1780757920,33654
1243,a1505,20140522,4708,4716,4715,4767,4699,4719,4731,3,15,27304,1291779920,34772
1244,a1505,20140523,4719,4731,4728,4728,4681,4691,4700,-40,-31,16242,763465720,37458
1245,a1505,20140526,4691,4700,4683,4715,4679,4696,4699,-4,-1,11692,549415480,41178
1246,a1505,20140527,4696,4699,4695,4705,4662,4669,4681,-30,-18,15984,748247360,45408
1247,a1505,20140528,4669,4681,4657,4782,4651,4770,4752,89,71,44290,2104696380,65062
1248,a1505,20140529,4770,4752,4760,4786,4745,4751,4762,-1,10,26776,1275129660,69286
1249,a1505,20140530,4751,4762,4753,4776,4648,4684,4715,-78,-47,34762,1639287980,67964
1250,a1505,20140603,4684,4715,4640,4696,4640,4686,4681,-29,-34,21080,986805580,75262
1251,a1505,20140604,4686,4681,4675,4718,4658,4682,4690,1,9,16828,789294160,76796
1252,a1505,20140605,4682,4690,4682,4710,4641,4645,4677,-45,-13,31860,1490103160,84106
1253,a1505,20140606,4645,4677,4660,4660,4589,4596,4614,-81,-63,45130,2082639940,94292
1254,a1505,20140609,4596,4614,4600,4646,4594,4629,4621,15,7,21046,972737260,95362
1255,a1505,20140610,4629,4621,4621,4637,4588,4588,4609,-33,-12,24744,1140536840,96306
1256,a1505,20140611,4588,4609,4595,4615,4587,4597,4598,-12,-11,10770,495255680,95814
1257,a1505,20140612,4597,4598,4599,4617,4563,4597,4592,-1,-6,12608,579004760,95946
1258,a1505,20140613,4597,4592,4580,4600,4568,4585,4586,-7,-6,11826,542441040,97842
1259,a1505,20140616,4585,4586,4595,4631,4585,4615,4612,29,26,24260,1118989580,97258
1260,a1505,20140617,4615,4612,4611,4611,4580,4581,4593,-31,-19,17966,825216960,100032
1261,a1505,20140618,4581,4593,4571,4599,4556,4586,4587,-7,-6,9154,419941180,100130
1262,a1505,20140619,4586,4587,4586,4603,4586,4589,4595,2,8,8320,382367240,99672
1263,a1505,20140620,4589,4595,4595,4602,4584,4587,4591,-8,-4,15808,725883100,100234
1264,a1505,20140623,4587,4591,4602,4624,4595,4611,4607,20,16,11766,542157560,100822
1265,a1505,20140624,4611,4607,4599,4605,4577,4583,4586,-24,-21,12846,589201620,106038
1266,a1505,20140625,4583,4586,4581,4596,4575,4580,4583,-6,-3,9832,450661920,109906
1267,a1505,20140626,4580,4583,4580,4585,4569,4575,4575,-8,-8,9414,430756480,114586
1268,a1505,20140627,4575,4575,4580,4599,4565,4577,4579,2,4,6904,316184560,114868
1269,a1505,20140630,4577,4579,4584,4584,4546,4547,4557,-32,-22,9600,437473340,117016
1270,a1505,20140701,4547,4557,4461,4468,4402,4435,4430,-122,-127,34404,1524224500,113362
1271,a1505,20140702,4435,4430,4430,4458,4416,4443,4438,13,8,9324,413870700,113814
1272,a1505,20140703,4443,4438,4425,4432,4413,4417,4420,-21,-18,13930,615743780,109784
1273,a1505,20140704,4417,4420,4410,4416,4383,4386,4398,-34,-22,12484,549058060,110750
1274,a1505,20140707,4386,4398,4385,4387,4356,4368,4369,-30,-29,11062,483393040,111694
1275,a1505,20140708,4368,4369,4378,4444,4365,4418,4416,49,47,28634,1264752080,112030
1276,a1505,20140709,4418,4416,4405,4423,4381,4393,4402,-23,-14,12950,570098280,111364
1277,a1505,20140710,4393,4402,4388,4399,4362,4381,4378,-21,-24,10724,469560840,110236
1278,a1505,20140711,4381,4378,4370,4391,4352,4387,4375,9,-3,9656,422539700,109914
1279,a1505,20140714,4387,4375,4356,4399,4330,4396,4374,21,-1,31238,1366625300,121846
1280,a1505,20140715,4396,4374,4399,4409,4381,4389,4392,15,18,7574,332695180,122112
1281,a1505,20140716,4389,4392,4395,4407,4392,4397,4398,5,6,12112,532762300,122174
1282,a1505,20140717,4397,4398,4406,4406,4387,4388,4393,-10,-5,8422,370052840,122230
1283,a1505,20140718,4388,4393,4379,4401,4371,4382,4383,-11,-10,8520,373447840,121472
1284,a1505,20140721,4382,4383,4377,4388,4359,4362,4369,-21,-14,16142,705360760,124766
1285,a1505,20140722,4362,4369,4354,4402,4354,4402,4381,33,12,32546,1425882760,123788
1286,a1505,20140723,4402,4381,4398,4440,4382,4382,4409,1,28,46422,2046819080,116172
1287,a1505,20140724,4382,4409,4406,4412,4377,4390,4392,-19,-17,11420,501643060,115752
1288,a1505,20140725,4390,4392,4392,4396,4374,4383,4383,-9,-9,5988,262497440,116696
1289,a1505,20140728,4383,4383,4390,4428,4390,4426,4408,43,25,20186,889954820,122500
1290,a1505,20140729,4426,4408,4447,4468,4432,4450,4451,42,43,35082,1561824680,112280
1291,a1505,20140730,4450,4451,4435,4445,4408,4445,4426,-6,-25,13608,602332280,115096
1292,a1505,20140731,4445,4426,4430,4475,4425,4468,4451,42,25,11536,513482520,117592
1293,a1505,20140801,4468,4451,4460,4495,4455,4493,4471,42,20,26826,1199590940,122030
1294,a1505,20140804,4493,4471,4502,4563,4493,4550,4522,79,51,47946,2168452520,127816
1295,a1505,20140805,4550,4522,4600,4603,4537,4599,4574,77,52,44248,2023921340,128930
1296,a1505,20140806,4599,4574,4585,4608,4584,4596,4596,22,22,30520,1402842140,131422
1297,a1505,20140807,4596,4596,4611,4624,4588,4596,4600,0,4,24560,1129971700,132618
1298,a1505,20140808,4596,4600,4594,4622,4593,4612,4606,12,6,21500,990454180,135262
1299,a1505,20140811,4612,4606,4620,4659,4620,4648,4640,42,34,34004,1577895760,141608
1300,a1505,20140812,4648,4640,4642,4661,4622,4634,4637,-6,-3,33730,1564240920,142308
1301,a1505,20140813,4634,4637,4646,4699,4635,4699,4675,62,38,44516,2081459340,144550
1302,a1505,20140814,4699,4675,4708,4710,4592,4635,4662,-40,-13,71672,3341751860,130766
1303,a1505,20140815,4635,4662,4643,4668,4631,4665,4652,3,-10,25894,1204610480,133596
1304,a1505,20140818,4665,4652,4612,4664,4612,4654,4648,2,-4,23502,1092559820,137852
1305,a1505,20140819,4654,4648,4650,4655,4612,4624,4626,-24,-22,30754,1422759180,134230
1306,a1505,20140820,4624,4626,4626,4628,4571,4589,4589,-37,-37,28648,1314868460,137522
1307,a1505,20140821,4589,4589,4575,4589,4542,4548,4556,-41,-33,37528,1709816620,140478
1308,a1505,20140822,4548,4556,4550,4585,4538,4562,4568,6,12,33154,1514664220,145474
1309,a1505,20140825,4562,4568,4569,4575,4550,4574,4560,6,-8,12882,587547220,145028
1310,a1505,20140826,4574,4560,4560,4645,4555,4643,4598,83,38,37736,1735309580,157842
1311,a1505,20140827,4643,4598,4645,4664,4628,4653,4643,55,45,38358,1781079200,162624
1312,a1505,20140828,4653,4643,4652,4656,4621,4632,4638,-11,-5,50588,2346469060,160422
1313,a1505,20140829,4632,4638,4639,4651,4621,4628,4634,-10,-4,28324,1312676560,163646
1314,a1505,20140901,4628,4634,4621,4644,4618,4640,4634,6,0,25708,1191481060,165836
1315,a1505,20140902,4640,4634,4642,4684,4640,4666,4668,32,34,43572,2034322540,171128
1316,a1505,20140903,4666,4668,4665,4680,4651,4654,4665,-14,-3,23444,1093755380,173166
1317,a1505,20140904,4654,4665,4645,4649,4613,4613,4629,-52,-36,35638,1649741900,169904
1318,a1505,20140905,4613,4629,4620,4631,4601,4625,4615,-4,-14,33210,1532721520,169742
1319,a1505,20140909,4625,4615,4613,4651,4580,4590,4617,-25,2,37162,1715827900,169248
1320,a1505,20140910,4590,4617,4585,4600,4555,4599,4578,-18,-39,37710,1726720360,173682
1321,a1505,20140911,4599,4578,4605,4605,4565,4578,4579,0,1,23000,1053226580,173026
1322,a1505,20140912,4578,4579,4562,4670,4562,4666,4627,87,48,71658,3316142900,184432
1323,a1505,20140915,4666,4627,4644,4683,4633,4661,4663,34,36,72770,3393643780,187654
1324,a1505,20140916,4661,4663,4665,4822,4640,4666,4692,3,29,122852,5765149560,183416
1325,a1505,20140917,4666,4692,4641,4689,4641,4685,4671,-7,-21,30620,1430532880,183652
1326,a1505,20140918,4685,4671,4671,4711,4656,4676,4667,5,-4,50786,2370313460,184068
1327,a1505,20140919,4676,4667,4659,4675,4627,4632,4648,-35,-19,56604,2630972480,188220
1328,a1505,20140922,4632,4648,4610,4625,4564,4605,4598,-43,-50,79458,3653488160,190458
1329,a1505,20140923,4605,4598,4592,4609,4564,4581,4591,-17,-7,63336,2908336160,194830
1330,a1505,20140924,4581,4591,4580,4625,4570,4592,4603,1,12,60264,2774032180,203532
1331,a1505,20140925,4592,4603,4600,4650,4600,4627,4625,24,22,47062,2176885440,200068
1332,a1505,20140926,4627,4625,4608,4666,4605,4642,4628,17,3,55444,2566361400,188612
1333,a1505,20140929,4642,4628,4666,4690,4627,4634,4649,6,21,64356,2992157920,181742
1334,a1505,20140930,4634,4649,4660,4660,4613,4619,4633,-30,-16,55054,2551153800,180908
1335,a1505,20141008,4619,4633,4640,4644,4583,4594,4600,-39,-33,49464,2275695260,173670
1336,a1505,20141009,4594,4600,4593,4620,4579,4583,4594,-17,-6,47148,2166179780,181992
1337,a1505,20141010,4583,4594,4567,4589,4454,4465,4506,-129,-88,126518,5701035600,179260
1338,a1505,20141013,4465,4506,4465,4486,4386,4418,4430,-88,-76,168982,7486086260,223808
1339,a1505,20141014,4418,4430,4444,4450,4365,4368,4398,-62,-32,255000,11215992260,244124
1340,a1505,20141015,4368,4398,4380,4445,4361,4415,4415,17,17,168524,7441773720,211534
1341,a1505,20141016,4415,4415,4402,4421,4349,4379,4379,-36,-36,159250,6974769820,238824
1342,a1505,20141017,4379,4379,4400,4413,4368,4377,4384,-2,5,84008,3683295280,242002
1343,a1505,20141020,4377,4384,4363,4365,4294,4335,4321,-49,-63,178512,7713751600,247478
1344,a1505,20141021,4335,4321,4340,4392,4312,4356,4367,35,46,117106,5114846700,235354
1345,a1505,20141022,4356,4367,4381,4390,4354,4363,4366,-4,-1,81496,3558442160,231524
1346,a1505,20141023,4363,4366,4330,4378,4330,4374,4360,8,-6,62734,2735381980,232002
1347,a1505,20141024,4374,4360,4400,4418,4374,4377,4394,17,34,87072,3826174280,233094
1348,a1505,20141027,4377,4394,4350,4362,4326,4360,4344,-34,-50,101428,4406323200,244896
1349,a1505,20141028,4360,4344,4400,4405,4355,4359,4377,15,33,78008,3414845860,234742
1350,a1505,20141029,4359,4377,4361,4387,4355,4384,4372,7,-5,60128,2629078260,239184
1351,a1505,20141030,4384,4372,4393,4416,4369,4382,4389,10,17,91004,3994889000,251564
1352,a1505,20141031,4382,4389,4375,4447,4363,4430,4419,41,30,204174,9022622300,246194
1353,a1505,20141103,4430,4419,4431,4469,4406,4416,4439,-3,20,135792,6028883480,247316
1354,a1505,20141104,4416,4439,4406,4426,4385,4396,4409,-43,-30,87166,3843440220,246562
1355,a1505,20141105,4396,4409,4394,4422,4384,4390,4405,-19,-4,80334,3539268120,246214
1356,a1505,20141106,4390,4405,4408,4425,4275,4323,4328,-82,-77,359136,15544947900,292840
1357,a1505,20141107,4323,4328,4335,4368,4334,4346,4345,18,17,151714,6592458580,276854
1358,a1505,20141110,4346,4345,4350,4360,4318,4343,4339,-2,-6,100842,4375639160,274472
1359,a1505,20141111,4343,4339,4322,4336,4270,4290,4302,-49,-37,177476,7635497160,292422
1360,a1505,20141112,4290,4302,4305,4350,4288,4296,4312,-6,10,168130,7251103840,289426
1361,a1505,20141113,4296,4312,4286,4326,4262,4317,4298,5,-14,167498,7200544420,277734
1362,a1505,20141114,4317,4298,4305,4348,4302,4338,4328,40,30,171154,7408554980,276604
1363,a1505,20141117,4338,4328,4328,4354,4320,4328,4331,0,3,90406,3915733220,276802
1364,a1505,20141118,4328,4331,4335,4344,4294,4318,4310,-13,-21,106410,4586713200,267938
1365,a1505,20141119,4318,4310,4306,4315,4283,4290,4295,-20,-15,88184,3787969260,271866
1366,a1505,20141120,4290,4295,4221,4314,4221,4304,4284,9,-11,124474,5333530560,271416
1367,a1505,20141121,4304,4284,4311,4328,4303,4319,4314,35,30,77886,3360612180,269294
1368,a1505,20141124,4319,4314,4330,4337,4270,4274,4294,-40,-20,123262,5293511080,287382
1369,a1505,20141125,4274,4294,4273,4281,4236,4266,4259,-28,-35,149010,6346383180,299232
1370,a1505,20141126,4266,4259,4270,4270,4241,4250,4254,-9,-5,117092,4981684700,308486
1371,a1505,20141127,4250,4254,4250,4316,4243,4306,4280,52,26,160860,6886374160,299938
1372,a1505,20141128,4306,4280,4296,4324,4286,4318,4309,38,29,133104,5735777900,291262
1373,a1505,20141201,4318,4309,4284,4311,4268,4303,4296,-6,-13,97256,4179074000,292962
1374,a1505,20141202,4303,4296,4315,4350,4288,4300,4311,4,15,108916,4695727920,292774
1375,a1505,20141203,4300,4311,4272,4306,4270,4299,4290,-12,-21,143294,6148597720,312348
1376,a1505,20141204,4299,4290,4301,4334,4295,4314,4317,24,27,143682,6203267740,315880
1377,a1505,20141205,4314,4317,4319,4403,4315,4392,4373,75,56,282552,12358377920,326132
1378,a1505,20141208,4392,4373,4405,4410,4361,4382,4382,9,9,129220,5663398380,322080
1379,a1505,20141209,4382,4382,4390,4390,4347,4350,4360,-32,-22,111014,4840602840,308612
1380,a1505,20141210,4350,4360,4359,4394,4340,4381,4375,21,15,125172,5477440420,297768
1381,a1505,20141211,4381,4375,4362,4383,4346,4368,4367,-7,-8,92628,4045865120,284794
1382,a1505,20141212,4368,4367,4371,4387,4358,4364,4371,-3,4,65790,2876013900,278470
1383,a1505,20141215,4364,4371,4361,4375,4350,4361,4364,-10,-7,57276,2500073900,272014
1384,a1505,20141216,4361,4364,4350,4357,4311,4322,4324,-42,-40,109512,4735697040,265180
1385,a1505,20141217,4322,4324,4317,4339,4305,4310,4317,-14,-7,64892,2801756560,261686
1386,a1505,20141218,4310,4317,4313,4326,4287,4313,4309,-4,-8,82930,3573516860,256616
1387,a1505,20141219,4313,4309,4320,4343,4306,4336,4328,27,19,84034,3637254700,249500
1388,a1505,20141222,4336,4328,4335,4339,4317,4322,4326,-6,-2,58574,2534080300,249476
1389,a1505,20141223,4322,4326,4332,4369,4308,4326,4345,0,19,111794,4858398020,244120
1390,a1505,20141224,4326,4345,4327,4395,4309,4388,4346,43,1,193040,8389666060,254934
1391,a1505,20141225,4388,4346,4390,4440,4380,4434,4408,88,62,208920,9211197620,272536
1392,a1505,20141226,4434,4408,4435,4457,4423,4453,4441,45,33,124316,5521019000,270598
1393,a1505,20141229,4453,4441,4449,4534,4437,4527,4504,86,63,408206,18386613580,279082
1394,a1505,20141230,4527,4504,4518,4538,4501,4515,4517,11,13,161422,7292021060,271798
1395,a1505,20141231,4515,4517,4510,4527,4486,4510,4505,-7,-12,133694,6023239840,258734
1396,a1507,20140116,4183,4183,0,0,0,4183,4183,0,0,0,0,0
1397,a1507,20140117,4183,4183,0,0,0,4185,4185,2,2,0,0,0
1398,a1507,20140120,4185,4185,0,0,0,4200,4200,15,15,0,0,0
1399,a1507,20140121,4200,4200,0,0,0,4201,4201,1,1,0,0,0
1400,a1507,20140122,4201,4201,0,0,0,4201,4201,0,0,0,0,0
1401,a1507,20140123,4201,4201,0,0,0,4226,4226,25,25,0,0,0
1402,a1507,20140124,4226,4226,0,0,0,4226,4226,0,0,0,0,0
1403,a1507,20140127,4226,4226,0,0,0,4255,4255,29,29,0,0,0
1404,a1507,20140128,4255,4255,0,0,0,4255,4255,0,0,0,0,0
1405,a1507,20140129,4255,4255,0,0,0,4255,4255,0,0,0,0,0
1406,a1507,20140130,4255,4255,0,0,0,4255,4255,0,0,0,0,0
1407,a1507,20140207,4255,4255,0,0,0,4255,4255,0,0,0,0,0
1408,a1507,20140210,4255,4255,0,0,0,4285,4285,30,30,0,0,0
1409,a1507,20140211,4285,4285,0,0,0,4338,4338,53,53,0,0,0
1410,a1507,20140212,4338,4338,0,0,0,4359,4359,21,21,0,0,0
1411,a1507,20140213,4359,4359,0,0,0,4359,4359,0,0,0,0,0
1412,a1507,20140214,4359,4359,0,0,0,4369,4369,10,10,0,0,0
1413,a1507,20140217,4369,4369,0,0,0,4369,4369,0,0,0,0,0
1414,a1507,20140218,4369,4369,0,0,0,4369,4369,0,0,0,0,0
1415,a1507,20140219,4369,4369,4358,4358,4307,4307,4332,-62,-37,4,173300,2
1416,a1507,20140220,4307,4332,0,0,0,4319,4319,-13,-13,0,0,2
1417,a1507,20140221,4319,4319,0,0,0,4331,4331,12,12,0,0,2
1418,a1507,20140224,4331,4331,4355,4355,4355,4355,4355,24,24,2,87100,2
1419,a1507,20140225,4355,4355,0,0,0,4355,4355,0,0,0,0,2
1420,a1507,20140226,4355,4355,0,0,0,4355,4355,0,0,0,0,2
1421,a1507,20140227,4355,4355,0,0,0,4355,4355,0,0,0,0,2
1422,a1507,20140228,4355,4355,0,0,0,4316,4316,-39,-39,0,0,2
1423,a1507,20140303,4316,4316,0,0,0,4316,4316,0,0,0,0,2
1424,a1507,20140304,4316,4316,0,0,0,4316,4316,0,0,0,0,2
1425,a1507,20140305,4316,4316,0,0,0,4316,4316,0,0,0,0,2
1426,a1507,20140306,4316,4316,0,0,0,4316,4316,0,0,0,0,2
1427,a1507,20140307,4316,4316,0,0,0,4316,4316,0,0,0,0,2
1428,a1507,20140310,4316,4316,0,0,0,4316,4316,0,0,0,0,2
1429,a1507,20140311,4316,4316,4213,4318,4213,4318,4268,2,-48,6,256120,4
1430,a1507,20140312,4318,4268,0,0,0,4289,4289,21,21,0,0,4
1431,a1507,20140313,4289,4289,0,0,0,4276,4276,-13,-13,0,0,4
1432,a1507,20140314,4276,4276,0,0,0,4276,4276,0,0,0,0,4
1433,a1507,20140317,4276,4276,0,0,0,4255,4255,-21,-21,0,0,4
1434,a1507,20140318,4255,4255,0,0,0,4255,4255,0,0,0,0,4
1435,a1507,20140319,4255,4255,4223,4306,4223,4253,4260,-2,5,26,1107800,6
1436,a1507,20140320,4253,4260,4225,4240,4225,4240,4234,-20,-26,8,338740,0
1437,a1507,20140321,4240,4234,0,0,0,4234,4234,0,0,0,0,0
1438,a1507,20140324,4234,4234,0,0,0,4234,4234,0,0,0,0,0
1439,a1507,20140325,4234,4234,4332,4332,4274,4274,4309,40,75,10,430900,6
1440,a1507,20140326,4274,4309,0,0,0,4312,4312,3,3,0,0,6
1441,a1507,20140327,4312,4312,4266,4266,4266,4266,4266,-46,-46,2,85320,6
1442,a1507,20140328,4266,4266,0,0,0,4266,4266,0,0,0,0,6
1443,a1507,20140331,4266,4266,0,0,0,4266,4266,0,0,0,0,6
1444,a1507,20140401,4266,4266,4270,4270,4270,4270,4270,4,4,2,85400,4
1445,a1507,20140402,4270,4270,0,0,0,4272,4272,2,2,0,0,4
1446,a1507,20140403,4272,4272,4250,4250,4250,4250,4250,-22,-22,2,85000,2
1447,a1507,20140404,4250,4250,0,0,0,4265,4265,15,15,0,0,2
1448,a1507,20140408,4265,4265,0,0,0,4281,4281,16,16,0,0,2
1449,a1507,20140409,4281,4281,0,0,0,4281,4281,0,0,0,0,2
1450,a1507,20140410,4281,4281,0,0,0,4281,4281,0,0,0,0,2
1451,a1507,20140411,4281,4281,0,0,0,4281,4281,0,0,0,0,2
1452,a1507,20140414,4281,4281,0,0,0,4342,4342,61,61,0,0,2
1453,a1507,20140415,4342,4342,0,0,0,4400,4400,58,58,0,0,2
1454,a1507,20140416,4400,4400,0,0,0,4428,4428,28,28,0,0,2
1455,a1507,20140417,4428,4428,0,0,0,4434,4434,6,6,0,0,2
1456,a1507,20140418,4434,4434,0,0,0,4434,4434,0,0,0,0,2
1457,a1507,20140421,4434,4434,0,0,0,4425,4425,-9,-9,0,0,2
1458,a1507,20140422,4425,4425,0,0,0,4425,4425,0,0,0,0,2
1459,a1507,20140423,4425,4425,0,0,0,4425,4425,0,0,0,0,2
1460,a1507,20140424,4425,4425,4385,4420,4385,4420,4402,-5,-23,4,176100,4
1461,a1507,20140425,4420,4402,0,0,0,4413,4413,11,11,0,0,4
1462,a1507,20140428,4413,4413,0,0,0,4413,4413,0,0,0,0,4
1463,a1507,20140429,4413,4413,0,0,0,4421,4421,8,8,0,0,4
1464,a1507,20140430,4421,4421,4532,4532,4486,4486,4509,65,88,4,180360,6
1465,a1507,20140505,4486,4509,4491,4497,4491,4496,4495,-13,-14,16,719280,18
1466,a1507,20140506,4496,4495,4463,4463,4411,4411,4450,-84,-45,16,712000,10
1467,a1507,20140507,4411,4450,0,0,0,4419,4419,-31,-31,0,0,10
1468,a1507,20140508,4419,4419,4403,4403,4403,4403,4403,-16,-16,2,88060,8
1469,a1507,20140509,4403,4403,0,0,0,4403,4403,0,0,0,0,8
1470,a1507,20140512,4403,4403,0,0,0,4403,4403,0,0,0,0,8
1471,a1507,20140513,4403,4403,0,0,0,4416,4416,13,13,0,0,8
1472,a1507,20140514,4416,4416,4406,4490,4406,4475,4457,59,41,6,267420,8
1473,a1507,20140515,4475,4457,4480,4583,4480,4532,4548,75,91,12,545860,8
1474,a1507,20140516,4532,4548,4548,4556,4548,4556,4552,8,4,4,182080,8
1475,a1507,20140519,4556,4552,0,0,0,4567,4567,15,15,0,0,8
1476,a1507,20140520,4567,4567,0,0,0,4650,4650,83,83,0,0,8
1477,a1507,20140521,4650,4650,4738,4738,4708,4708,4732,58,82,10,473200,10
1478,a1507,20140522,4708,4732,0,0,0,4732,4732,0,0,0,0,10
1479,a1507,20140523,4732,4732,0,0,0,4708,4708,-24,-24,0,0,10
1480,a1507,20140526,4708,4708,0,0,0,4708,4708,0,0,0,0,10
1481,a1507,20140527,4708,4708,0,0,0,4700,4700,-8,-8,0,0,10
1482,a1507,20140528,4700,4700,0,0,0,4740,4740,40,40,0,0,10
1483,a1507,20140529,4740,4740,4776,4776,4776,4776,4776,36,36,4,191040,12
1484,a1507,20140530,4776,4776,4750,4797,4750,4750,4777,-26,1,24,1146500,8
1485,a1507,20140603,4750,4777,4671,4700,4671,4700,4680,-77,-97,12,561680,8
1486,a1507,20140604,4700,4680,4720,4720,4720,4720,4720,40,40,4,188800,8
1487,a1507,20140605,4720,4720,0,0,0,4720,4720,0,0,0,0,8
1488,a1507,20140606,4720,4720,0,0,0,4720,4720,0,0,0,0,8
1489,a1507,20140609,4720,4720,0,0,0,4685,4685,-35,-35,0,0,8
1490,a1507,20140610,4685,4685,0,0,0,4685,4685,0,0,0,0,8
1491,a1507,20140611,4685,4685,0,0,0,4662,4662,-23,-23,0,0,8
1492,a1507,20140612,4662,4662,0,0,0,4662,4662,0,0,0,0,8
1493,a1507,20140613,4662,4662,0,0,0,4658,4658,-4,-4,0,0,8
1494,a1507,20140616,4658,4658,0,0,0,4658,4658,0,0,0,0,8
1495,a1507,20140617,4658,4658,0,0,0,4658,4658,0,0,0,0,8
1496,a1507,20140618,4658,4658,4684,4684,4586,4655,4661,-3,3,40,1864780,22
1497,a1507,20140619,4655,4661,0,0,0,4660,4660,-1,-1,0,0,22
1498,a1507,20140620,4660,4660,4660,4660,4637,4637,4648,-23,-12,18,836640,28
1499,a1507,20140623,4637,4648,4652,4652,4629,4648,4640,0,-8,46,2134760,20
1500,a1507,20140624,4648,4640,4640,4640,4631,4631,4635,-9,-5,4,185420,20
1501,a1507,20140625,4631,4635,4621,4621,4621,4621,4621,-14,-14,6,277260,14
1502,a1507,20140626,4621,4621,0,0,0,4621,4621,0,0,0,0,14
1503,a1507,20140627,4621,4621,0,0,0,4621,4621,0,0,0,0,14
1504,a1507,20140630,4621,4621,0,0,0,4599,4599,-22,-22,0,0,14
1505,a1507,20140701,4599,4599,4500,4500,4460,4460,4480,-139,-119,4,179200,18
1506,a1507,20140702,4460,4480,4467,4467,4467,4467,4467,-13,-13,2,89340,16
1507,a1507,20140703,4467,4467,0,0,0,4467,4467,0,0,0,0,16
1508,a1507,20140704,4467,4467,0,0,0,4450,4450,-17,-17,0,0,16
1509,a1507,20140707,4450,4450,0,0,0,4439,4439,-11,-11,0,0,16
1510,a1507,20140708,4439,4439,0,0,0,4439,4439,0,0,0,0,16
1511,a1507,20140709,4439,4439,0,0,0,4439,4439,0,0,0,0,16
1512,a1507,20140710,4439,4439,0,0,0,4439,4439,0,0,0,0,16
1513,a1507,20140711,4439,4439,0,0,0,4439,4439,0,0,0,0,16
1514,a1507,20140714,4439,4439,4439,4441,4439,4440,4440,1,1,8,355220,24
1515,a1507,20140715,4440,4440,0,0,0,4458,4458,18,18,0,0,24
1516,a1507,20140716,4458,4458,4440,4440,4440,4440,4440,-18,-18,2,88800,26
1517,a1507,20140717,4440,4440,0,0,0,4440,4440,0,0,0,0,26
1518,a1507,20140718,4440,4440,0,0,0,4430,4430,-10,-10,0,0,26
1519,a1507,20140721,4430,4430,0,0,0,4416,4416,-14,-14,0,0,26
1520,a1507,20140722,4416,4416,0,0,0,4416,4416,0,0,0,0,26
1521,a1507,20140723,4416,4416,0,0,0,4444,4444,28,28,0,0,26
1522,a1507,20140724,4444,4444,0,0,0,4427,4427,-17,-17,0,0,26
1523,a1507,20140725,4427,4427,0,0,0,4418,4418,-9,-9,0,0,26
1524,a1507,20140728,4418,4418,4443,4443,4442,4442,4442,24,24,6,266540,30
1525,a1507,20140729,4442,4442,0,0,0,4442,4442,0,0,0,0,30
1526,a1507,20140730,4442,4442,4450,4450,4415,4422,4433,-20,-9,8,354700,32
1527,a1507,20140731,4422,4433,0,0,0,4458,4458,25,25,0,0,32
1528,a1507,20140801,4458,4458,4469,4490,4469,4490,4483,32,25,10,448320,22
1529,a1507,20140804,4490,4483,4540,4540,4540,4540,4540,57,57,10,454000,12
1530,a1507,20140805,4540,4540,4564,4587,4564,4581,4581,41,41,10,458120,8
1531,a1507,20140806,4581,4581,4584,4584,4584,4584,4584,3,3,12,550080,14
1532,a1507,20140807,4584,4584,0,0,0,4587,4587,3,3,0,0,14
1533,a1507,20140808,4587,4587,4603,4603,4591,4591,4598,4,11,6,275920,10
1534,a1507,20140811,4591,4598,0,0,0,4643,4643,45,45,0,0,10
1535,a1507,20140812,4643,4643,4677,4677,4627,4627,4652,-16,9,4,186080,10
1536,a1507,20140813,4627,4652,0,0,0,4652,4652,0,0,0,0,10
1537,a1507,20140814,4652,4652,0,0,0,4640,4640,-12,-12,0,0,10
1538,a1507,20140815,4640,4640,0,0,0,4631,4631,-9,-9,0,0,10
1539,a1507,20140818,4631,4631,0,0,0,4631,4631,0,0,0,0,10
1540,a1507,20140819,4631,4631,0,0,0,4631,4631,0,0,0,0,10
1541,a1507,20140820,4631,4631,0,0,0,4630,4630,-1,-1,0,0,10
1542,a1507,20140821,4630,4630,0,0,0,4600,4600,-30,-30,0,0,10
1543,a1507,20140822,4600,4600,4561,4561,4561,4561,4561,-39,-39,2,91220,10
1544,a1507,20140825,4561,4561,0,0,0,4554,4554,-7,-7,0,0,10
1545,a1507,20140826,4554,4554,0,0,0,4622,4622,68,68,0,0,10
1546,a1507,20140827,4622,4622,4691,4691,4661,4673,4675,51,53,6,280500,8
1547,a1507,20140828,4673,4675,0,0,0,4675,4675,0,0,0,0,8
1548,a1507,20140829,4675,4675,0,0,0,4671,4671,-4,-4,0,0,8
1549,a1507,20140901,4671,4671,0,0,0,4671,4671,0,0,0,0,8
1550,a1507,20140902,4671,4671,0,0,0,4682,4682,11,11,0,0,8
1551,a1507,20140903,4682,4682,0,0,0,4682,4682,0,0,0,0,8
1552,a1507,20140904,4682,4682,0,0,0,4673,4673,-9,-9,0,0,8
1553,a1507,20140905,4673,4673,0,0,0,4673,4673,0,0,0,0,8
1554,a1507,20140909,4673,4673,0,0,0,4650,4650,-23,-23,0,0,8
1555,a1507,20140910,4650,4650,0,0,0,4650,4650,0,0,0,0,8
1556,a1507,20140911,4650,4650,0,0,0,4639,4639,-11,-11,0,0,8
1557,a1507,20140912,4639,4639,0,0,0,4690,4690,51,51,0,0,8
1558,a1507,20140915,4690,4690,0,0,0,4690,4690,0,0,0,0,8
1559,a1507,20140916,4690,4690,4725,4789,4700,4700,4754,10,64,174,8272940,8
1560,a1507,20140917,4700,4754,4689,4689,4689,4689,4689,-65,-65,2,93780,8
1561,a1507,20140918,4689,4689,0,0,0,4689,4689,0,0,0,0,8
1562,a1507,20140919,4689,4689,4666,4666,4666,4666,4666,-23,-23,2,93320,6
1563,a1507,20140922,4666,4666,0,0,0,4657,4657,-9,-9,0,0,6
1564,a1507,20140923,4657,4657,0,0,0,4633,4633,-24,-24,0,0,6
1565,a1507,20140924,4633,4633,0,0,0,4633,4633,0,0,0,0,6
1566,a1507,20140925,4633,4633,0,0,0,4633,4633,0,0,0,0,6
1567,a1507,20140926,4633,4633,4626,4678,4610,4678,4641,45,8,42,1949480,4
1568,a1507,20140929,4678,4641,0,0,0,4641,4641,0,0,0,0,4
1569,a1507,20140930,4641,4641,0,0,0,4641,4641,0,0,0,0,4
1570,a1507,20141008,4641,4641,0,0,0,4641,4641,0,0,0,0,4
1571,a1507,20141009,4641,4641,0,0,0,4640,4640,-1,-1,0,0,4
1572,a1507,20141010,4640,4640,0,0,0,4509,4509,-131,-131,0,0,4
1573,a1507,20141013,4509,4509,4415,4415,4415,4415,4415,-94,-94,4,176600,6
1574,a1507,20141014,4415,4415,4438,4450,4395,4395,4424,-20,9,10,442480,8
1575,a1507,20141015,4395,4424,0,0,0,4441,4441,17,17,0,0,8
1576,a1507,20141016,4441,4441,0,0,0,4405,4405,-36,-36,0,0,8
1577,a1507,20141017,4405,4405,0,0,0,4405,4405,0,0,0,0,8
1578,a1507,20141020,4405,4405,0,0,0,4342,4342,-63,-63,0,0,8
1579,a1507,20141021,4342,4342,0,0,0,4388,4388,46,46,0,0,8
1580,a1507,20141022,4388,4388,4382,4382,4382,4382,4382,-6,-6,4,175280,8
1581,a1507,20141023,4382,4382,0,0,0,4382,4382,0,0,0,0,8
1582,a1507,20141024,4382,4382,4419,4419,4419,4419,4419,37,37,2,88380,8
1583,a1507,20141027,4419,4419,4358,4358,4358,4358,4358,-61,-61,4,174320,8
1584,a1507,20141028,4358,4358,4429,4429,4376,4376,4402,18,44,4,176100,8
1585,a1507,20141029,4376,4402,0,0,0,4402,4402,0,0,0,0,8
1586,a1507,20141030,4402,4402,0,0,0,4402,4402,0,0,0,0,8
1587,a1507,20141031,4402,4402,0,0,0,4432,4432,30,30,0,0,8
1588,a1507,20141103,4432,4432,4459,4459,4459,4459,4459,27,27,2,89180,8
1589,a1507,20141104,4459,4459,0,0,0,4429,4429,-30,-30,0,0,8
1590,a1507,20141105,4429,4429,4439,4439,4439,4439,4439,10,10,2,88780,8
1591,a1507,20141106,4439,4439,4395,4395,4300,4330,4344,-109,-95,12,521280,8
1592,a1507,20141107,4330,4344,0,0,0,4344,4344,0,0,0,0,8
1593,a1507,20141110,4344,4344,0,0,0,4339,4339,-5,-5,0,0,8
1594,a1507,20141111,4339,4339,0,0,0,4303,4303,-36,-36,0,0,8
1595,a1507,20141112,4303,4303,0,0,0,4313,4313,10,10,0,0,8
1596,a1507,20141113,4313,4313,4350,4351,4303,4333,4335,20,22,62,2688160,18
1597,a1507,20141114,4333,4335,4334,4334,4334,4334,4334,-1,-1,2,86680,16
1598,a1507,20141117,4334,4334,0,0,0,4334,4334,0,0,0,0,16
1599,a1507,20141118,4334,4334,4400,4400,4352,4352,4376,18,42,8,350080,12
1600,a1507,20141119,4352,4376,0,0,0,4361,4361,-15,-15,0,0,12
1601,a1507,20141120,4361,4361,0,0,0,4350,4350,-11,-11,0,0,12
1602,a1507,20141121,4350,4350,0,0,0,4380,4380,30,30,0,0,12
1603,a1507,20141124,4380,4380,4277,4417,4276,4326,4350,-54,-30,26,1131120,12
1604,a1507,20141125,4326,4350,0,0,0,4350,4350,0,0,0,0,12
1605,a1507,20141126,4350,4350,4259,4277,4251,4272,4262,-78,-88,18,767280,8
1606,a1507,20141127,4272,4262,0,0,0,4288,4288,26,26,0,0,8
1607,a1507,20141128,4288,4288,0,0,0,4317,4317,29,29,0,0,8
1608,a1507,20141201,4317,4317,4336,4336,4303,4303,4319,-14,2,4,172780,8
1609,a1507,20141202,4303,4319,4259,4267,4224,4267,4252,-52,-67,8,340180,10
1610,a1507,20141203,4267,4252,0,0,0,4252,4252,0,0,0,0,10
1611,a1507,20141204,4252,4252,4295,4296,4288,4296,4293,44,41,6,257580,8
1612,a1507,20141205,4296,4293,4362,4362,4362,4362,4362,69,69,2,87240,8
1613,a1507,20141208,4362,4362,4346,4368,4346,4368,4353,6,-9,6,261200,8
1614,a1507,20141209,4368,4353,0,0,0,4332,4332,-21,-21,0,0,8
1615,a1507,20141210,4332,4332,0,0,0,4332,4332,0,0,0,0,8
1616,a1507,20141211,4332,4332,4366,4395,4271,4368,4332,36,0,64,2772720,20
1617,a1507,20141212,4368,4332,0,0,0,4335,4335,3,3,0,0,20
1618,a1507,20141215,4335,4335,0,0,0,4329,4329,-6,-6,0,0,20
1619,a1507,20141216,4329,4329,4311,4318,4311,4317,4314,-12,-15,20,862960,16
1620,a1507,20141217,4317,4314,4308,4308,4308,4308,4308,-6,-6,2,86160,14
1621,a1507,20141218,4308,4308,4308,4308,4308,4308,4308,0,0,8,344640,8
1622,a1507,20141219,4308,4308,0,0,0,4308,4308,0,0,0,0,8
1623,a1507,20141222,4308,4308,4302,4325,4302,4325,4313,17,5,18,776360,12
1624,a1507,20141223,4325,4313,4336,4421,4297,4297,4343,-16,30,12,521260,6
1625,a1507,20141224,4297,4343,0,0,0,4343,4343,0,0,0,0,6
1626,a1507,20141225,4343,4343,4354,4435,4354,4366,4377,23,34,8,350180,8
1627,a1507,20141226,4366,4377,4374,4380,4374,4380,4377,3,0,4,175080,10
1628,a1507,20141229,4380,4377,4394,4394,4394,4394,4394,17,17,2,87880,12
1629,a1507,20141230,4394,4394,4460,4463,4460,4463,4461,69,67,4,178460,12
1630,a1507,20141231,4463,4461,4455,4455,4455,4455,4455,-6,-6,8,356400,16
1631,a1509,20140317,4263,4263,4203,4405,4203,4278,4302,15,39,34,1463000,8
1632,a1509,20140318,4278,4302,4260,4260,4224,4238,4240,-64,-62,34,1441600,20
1633,a1509,20140319,4238,4240,4238,4252,4238,4252,4248,12,8,18,764680,22
1634,a1509,20140320,4252,4248,4245,4245,4232,4232,4245,-16,-3,14,594320,36
1635,a1509,20140321,4232,4245,4242,4251,4242,4251,4247,6,2,8,339800,34
1636,a1509,20140324,4251,4247,4252,4252,4233,4247,4246,0,-1,18,764400,50
1637,a1509,20140325,4247,4246,4265,4287,4265,4285,4267,39,21,108,4608620,120
1638,a1509,20140326,4285,4267,4269,4282,4265,4274,4273,7,6,74,3162400,150
1639,a1509,20140327,4274,4273,4265,4296,4265,4287,4282,14,9,12,513880,154
1640,a1509,20140328,4287,4282,4284,4299,4276,4276,4286,-6,4,36,1543100,180
1641,a1509,20140331,4276,4286,4276,4282,4259,4261,4273,-25,-13,116,4957180,234
1642,a1509,20140401,4261,4273,4294,4301,4285,4292,4294,19,21,132,5669120,312
1643,a1509,20140402,4292,4294,4306,4306,4287,4287,4296,-7,2,234,10054260,472
1644,a1509,20140403,4287,4296,4282,4282,4264,4272,4276,-24,-20,58,2480380,482
1645,a1509,20140404,4272,4276,4278,4300,4278,4293,4288,17,12,118,5060380,552
1646,a1509,20140408,4293,4288,4292,4313,4292,4305,4300,17,12,26,1118060,570
1647,a1509,20140409,4305,4300,4322,4325,4315,4315,4322,15,22,22,950900,580
1648,a1509,20140410,4315,4322,4322,4322,4311,4312,4315,-10,-7,20,863060,582
1649,a1509,20140411,4312,4315,4301,4304,4297,4297,4300,-18,-15,10,430060,588
1650,a1509,20140414,4297,4300,4325,4350,4325,4345,4339,45,39,140,6075160,638
1651,a1509,20140415,4345,4339,4362,4419,4362,4419,4402,80,63,238,10478180,758
1652,a1509,20140416,4419,4402,4438,4440,4415,4437,4430,35,28,42,1860880,770
1653,a1509,20140417,4437,4430,4446,4466,4435,4456,4453,26,23,148,6590940,794
1654,a1509,20140418,4456,4453,4465,4476,4456,4464,4468,11,15,52,2323820,806
1655,a1509,20140421,4464,4468,4465,4465,4412,4413,4429,-55,-39,114,5049060,838
1656,a1509,20140422,4413,4429,4398,4434,4387,4434,4418,5,-11,130,5743820,914
1657,a1509,20140423,4434,4418,4420,4449,4420,4425,4436,7,18,66,2928240,948
1658,a1509,20140424,4425,4436,4432,4449,4430,4449,4436,13,0,42,1863380,950
1659,a1509,20140425,4449,4436,4453,4498,4453,4480,4489,44,53,380,17060580,1020
1660,a1509,20140428,4480,4489,4515,4530,4482,4490,4494,1,5,132,5932680,1032
1661,a1509,20140429,4490,4494,4463,4496,4457,4481,4473,-13,-21,100,4473440,1008
1662,a1509,20140430,4481,4473,4485,4485,4473,4473,4479,0,6,56,2508580,1010
1663,a1509,20140505,4473,4479,4466,4480,4460,4475,4470,-4,-9,56,2503420,1018
1664,a1509,20140506,4475,4470,4463,4472,4426,4426,4458,-44,-12,164,7312540,1080
1665,a1509,20140507,4426,4458,4429,4453,4415,4425,4426,-33,-32,146,6462700,1096
1666,a1509,20140508,4425,4426,4407,4437,4403,4414,4418,-12,-8,176,7776760,1108
1667,a1509,20140509,4414,4418,4420,4425,4413,4413,4420,-5,2,116,5127840,1108
1668,a1509,20140512,4413,4420,4415,4427,4410,4418,4418,-2,-2,110,4860120,1106
1669,a1509,20140513,4418,4418,4410,4452,4405,4452,4433,34,15,154,6826840,1132
1670,a1509,20140514,4452,4433,4470,4522,4386,4515,4493,82,60,706,31723140,1184
1671,a1509,20140515,4515,4493,4500,4603,4500,4601,4564,108,71,360,16431300,1204
1672,a1509,20140516,4601,4564,4601,4618,4578,4611,4602,47,38,228,10493220,1182
1673,a1509,20140519,4611,4602,4629,4659,4550,4630,4603,28,1,1274,58646400,1666
1674,a1509,20140520,4630,4603,4650,4734,4615,4718,4672,115,69,826,38598220,1964
1675,a1509,20140521,4718,4672,4698,4835,4698,4786,4789,114,117,7580,363042620,6506
1676,a1509,20140522,4786,4789,4818,4843,4778,4795,4805,6,16,2946,141573740,6856
1677,a1509,20140523,4795,4805,4791,4795,4758,4770,4776,-35,-29,1238,59135260,7498
1678,a1509,20140526,4770,4776,4765,4795,4762,4775,4781,-1,5,672,32134860,7672
1679,a1509,20140527,4775,4781,4783,4787,4746,4755,4759,-26,-22,1360,64726420,7814
1680,a1509,20140528,4755,4759,4741,4863,4741,4852,4836,93,77,3914,189317280,9114
1681,a1509,20140529,4852,4836,4845,4863,4833,4833,4843,-3,7,1998,96769440,8910
1682,a1509,20140530,4833,4843,4838,4850,4738,4770,4792,-73,-51,1994,95568620,8776
1683,a1509,20140603,4770,4792,4768,4782,4751,4775,4767,-17,-25,2472,117847460,10040
1684,a1509,20140604,4775,4767,4758,4798,4752,4766,4779,-1,12,1368,65386020,10044
1685,a1509,20140605,4766,4779,4776,4802,4747,4749,4783,-30,4,6530,312372620,13054
1686,a1509,20140606,4749,4783,4742,4753,4688,4693,4722,-90,-61,4610,217716500,14742
1687,a1509,20140609,4693,4722,4698,4743,4698,4728,4722,6,0,5548,262031800,17588
1688,a1509,20140610,4728,4722,4722,4732,4685,4690,4713,-32,-9,2432,114640360,18864
1689,a1509,20140611,4690,4713,4699,4710,4685,4695,4693,-18,-20,1150,53973760,18960
1690,a1509,20140612,4695,4693,4672,4710,4659,4692,4694,-1,1,728,34177400,19108
1691,a1509,20140613,4692,4694,4671,4695,4671,4683,4684,-11,-10,1104,51717600,18980
1692,a1509,20140616,4683,4684,4701,4724,4690,4709,4707,25,23,2732,128612020,19524
1693,a1509,20140617,4709,4707,4694,4705,4671,4673,4688,-34,-19,1940,90955100,19866
1694,a1509,20140618,4673,4688,4658,4685,4658,4668,4673,-20,-15,2308,107870100,19998
1695,a1509,20140619,4668,4673,4650,4683,4650,4674,4677,1,4,1530,71564260,19908
1696,a1509,20140620,4674,4677,4681,4684,4668,4669,4673,-8,-4,216,10095040,19914
1697,a1509,20140623,4669,4673,4673,4697,4673,4693,4684,20,11,354,16583400,19952
1698,a1509,20140624,4693,4684,4677,4680,4662,4669,4673,-15,-11,444,20751040,19962
1699,a1509,20140625,4669,4673,4668,4673,4661,4666,4666,-7,-7,360,16799840,19994
1700,a1509,20140626,4666,4666,4662,4666,4653,4657,4658,-9,-8,282,13137680,20064
1701,a1509,20140627,4657,4658,4675,4676,4650,4658,4660,0,2,326,15194580,20024
1702,a1509,20140630,4658,4660,4655,4655,4626,4626,4636,-34,-24,656,30417280,20182
1703,a1509,20140701,4626,4636,4590,4590,4479,4502,4507,-134,-129,2318,104485260,20312
1704,a1509,20140702,4502,4507,4510,4512,4480,4496,4495,-11,-12,1446,65001500,20730
1705,a1509,20140703,4496,4495,4481,4488,4473,4478,4480,-17,-15,558,25003780,20818
1706,a1509,20140704,4478,4480,4477,4477,4446,4447,4463,-33,-17,920,41064900,20638
1707,a1509,20140707,4447,4463,4443,4450,4421,4427,4433,-36,-30,472,20928440,20690
1708,a1509,20140708,4427,4433,4430,4505,4430,4482,4485,49,52,970,43507020,20776
1709,a1509,20140709,4482,4485,4472,4488,4449,4460,4471,-25,-14,748,33449280,20720
1710,a1509,20140710,4460,4471,4478,4478,4431,4456,4443,-15,-28,736,32704580,20384
1711,a1509,20140711,4456,4443,4434,4455,4422,4450,4444,7,1,434,19290840,20368
1712,a1509,20140714,4450,4444,4410,4463,4410,4460,4444,16,0,228,10132860,20424
1713,a1509,20140715,4460,4444,4458,4466,4451,4452,4455,8,11,184,8198020,20316
1714,a1509,20140716,4452,4455,4453,4474,4453,4470,4465,15,10,222,9914300,20280
1715,a1509,20140717,4470,4465,4470,4473,4453,4454,4462,-11,-3,228,10174540,20348
1716,a1509,20140718,4454,4462,4451,4468,4440,4443,4451,-19,-11,258,11484460,20290
1717,a1509,20140721,4443,4451,4440,4450,4425,4426,4434,-25,-17,718,31837320,20448
1718,a1509,20140722,4426,4434,4430,4452,4425,4446,4441,12,7,1550,68835740,21342
1719,a1509,20140723,4446,4441,4433,4479,4433,4440,4450,-1,9,1114,49576440,21338
1720,a1509,20140724,4440,4450,4452,4455,4426,4435,4442,-15,-8,848,37671360,21180
1721,a1509,20140725,4435,4442,4443,4443,4424,4429,4433,-13,-9,432,19151560,21306
1722,a1509,20140728,4429,4433,4446,4455,4431,4455,4449,22,16,1162,51701340,21256
1723,a1509,20140729,4455,4449,4465,4489,4464,4476,4472,27,23,2934,131211700,22028
1724,a1509,20140730,4476,4472,4456,4460,4435,4460,4446,-12,-26,740,32902120,22186
1725,a1509,20140731,4460,4446,4445,4494,4441,4487,4468,41,22,426,19034800,22188
1726,a1509,20140801,4487,4468,4497,4511,4476,4507,4497,39,29,2654,119361240,21762
1727,a1509,20140804,4507,4497,4518,4578,4507,4570,4533,73,36,2038,92390060,21930
1728,a1509,20140805,4570,4533,4578,4646,4569,4644,4607,111,74,4004,184499640,22460
1729,a1509,20140806,4644,4607,4638,4661,4619,4639,4648,32,41,3782,175793300,22644
1730,a1509,20140807,4639,4648,4639,4667,4634,4648,4647,0,-1,1612,74914660,22724
1731,a1509,20140808,4648,4647,4645,4670,4645,4658,4657,11,10,2094,97527680,23318
1732,a1509,20140811,4658,4657,4668,4717,4668,4697,4693,40,36,3798,178259240,25126
1733,a1509,20140812,4697,4693,4696,4713,4673,4680,4687,-13,-6,2322,108849100,25318
1734,a1509,20140813,4680,4687,4679,4750,4679,4748,4726,61,39,3826,180824640,26148
1735,a1509,20140814,4748,4726,4740,4756,4640,4687,4717,-39,-9,4440,209452840,26176
1736,a1509,20140815,4687,4717,4689,4719,4682,4710,4703,-7,-14,1808,85030400,26316
1737,a1509,20140818,4710,4703,4703,4710,4680,4700,4699,-3,-4,1880,88341580,26566
1738,a1509,20140819,4700,4699,4701,4704,4665,4678,4683,-21,-16,2596,121574320,25848
1739,a1509,20140820,4678,4683,4666,4674,4625,4639,4649,-44,-34,1742,80992000,25838
1740,a1509,20140821,4639,4649,4631,4639,4592,4601,4606,-48,-43,1694,78036600,26004
1741,a1509,20140822,4601,4606,4594,4635,4592,4618,4619,12,13,2626,121304120,27470
1742,a1509,20140825,4618,4619,4620,4622,4602,4621,4609,2,-10,1652,76147940,27548
1743,a1509,20140826,4621,4609,4609,4689,4607,4689,4640,80,31,3302,153238020,28694
1744,a1509,20140827,4689,4640,4690,4704,4671,4693,4686,53,46,5164,241992780,29516
1745,a1509,20140828,4693,4686,4690,4699,4665,4674,4678,-12,-8,3750,175459240,29950
1746,a1509,20140829,4674,4678,4678,4700,4669,4674,4681,-4,3,2360,110495180,29736
1747,a1509,20140901,4674,4681,4660,4689,4660,4689,4680,8,-1,862,40343340,29990
1748,a1509,20140902,4689,4680,4695,4721,4683,4709,4713,29,33,5348,252064980,31496
1749,a1509,20140903,4709,4713,4706,4720,4697,4697,4707,-16,-6,1442,67888560,31718
1750,a1509,20140904,4697,4707,4696,4696,4662,4662,4677,-45,-30,1630,76238040,31630
1751,a1509,20140905,4662,4677,4662,4675,4650,4669,4659,-8,-18,2164,100836140,31484
1752,a1509,20140909,4669,4659,4661,4692,4632,4640,4659,-19,0,2566,119566500,30846
1753,a1509,20140910,4640,4659,4630,4654,4618,4651,4630,-8,-29,1488,68906660,30690
1754,a1509,20140911,4651,4630,4651,4657,4625,4635,4637,5,7,840,38956440,30716
1755,a1509,20140912,4635,4637,4620,4720,4620,4716,4687,79,50,2550,119538200,30728
1756,a1509,20140915,4716,4687,4701,4739,4695,4720,4720,33,33,3756,177303620,31812
1757,a1509,20140916,4720,4720,4706,4775,4692,4713,4738,-7,18,11158,528775380,31782
1758,a1509,20140917,4713,4738,4710,4730,4700,4723,4716,-15,-22,6216,293149520,31384
1759,a1509,20140918,4723,4716,4738,4744,4701,4715,4710,-1,-6,3870,182303180,32064
1760,a1509,20140919,4715,4710,4708,4714,4660,4676,4691,-34,-19,3546,166347940,32408
1761,a1509,20140922,4676,4691,4670,4670,4604,4646,4641,-45,-50,9074,421194900,32812
1762,a1509,20140923,4646,4641,4624,4653,4613,4631,4639,-10,-2,4516,209508200,32744
1763,a1509,20140924,4631,4639,4631,4664,4631,4633,4650,-6,11,5090,236703660,32144
1764,a1509,20140925,4633,4650,4646,4684,4644,4667,4667,17,17,4696,219175620,32784
1765,a1509,20140926,4667,4667,4656,4709,4647,4685,4673,18,6,7704,360063620,33154
1766,a1509,20140929,4685,4673,4700,4733,4672,4685,4697,12,24,4468,209880060,31926
1767,a1509,20140930,4685,4697,4696,4705,4661,4663,4683,-34,-14,3712,173852600,31610
1768,a1509,20141008,4663,4683,4675,4691,4633,4644,4647,-39,-36,6372,296153480,33868
1769,a1509,20141009,4644,4647,4644,4667,4635,4639,4646,-8,-1,5546,257680700,36258
1770,a1509,20141010,4639,4646,4638,4642,4520,4529,4571,-117,-75,16804,768124360,35418
1771,a1509,20141013,4529,4571,4520,4546,4447,4470,4481,-101,-90,17646,790726180,35032
1772,a1509,20141014,4470,4481,4477,4497,4401,4405,4436,-76,-45,35900,1592528880,46386
1773,a1509,20141015,4405,4436,4415,4493,4400,4452,4455,16,19,15864,706893680,40570
1774,a1509,20141016,4452,4455,4452,4454,4385,4412,4407,-43,-48,30356,1337909840,56508
1775,a1509,20141017,4412,4407,4420,4449,4396,4405,4415,-2,8,12824,566281300,59624
1776,a1509,20141020,4405,4415,4399,4399,4330,4358,4353,-57,-62,18612,810345960,63664
1777,a1509,20141021,4358,4353,4360,4410,4342,4353,4383,0,30,16790,736014640,65154
1778,a1509,20141022,4353,4383,4376,4385,4350,4357,4364,-26,-19,16050,700553380,64594
1779,a1509,20141023,4357,4364,4357,4375,4333,4367,4360,3,-4,7838,341781400,64040
1780,a1509,20141024,4367,4360,4385,4417,4365,4380,4388,20,28,17344,761060340,64552
1781,a1509,20141027,4380,4388,4372,4372,4333,4370,4351,-18,-37,11072,481749200,65542
1782,a1509,20141028,4370,4351,4401,4409,4367,4376,4388,25,37,7566,332018480,65050
1783,a1509,20141029,4376,4388,4370,4397,4370,4394,4383,6,-5,7310,320440840,65104
1784,a1509,20141030,4394,4383,4415,4419,4385,4397,4403,14,20,9332,410913240,63944
1785,a1509,20141031,4397,4403,4380,4456,4380,4443,4426,40,23,15168,671481860,60980
1786,a1509,20141103,4443,4426,4445,4484,4421,4440,4457,14,31,15546,692984000,59240
1787,a1509,20141104,4440,4457,4435,4451,4408,4418,4437,-39,-20,8238,365525940,60286
1788,a1509,20141105,4418,4437,4405,4441,4405,4414,4425,-23,-12,4516,199875400,60402
1789,a1509,20141106,4414,4425,4429,4438,4307,4355,4354,-70,-71,21490,935713120,61580
1790,a1509,20141107,4355,4354,4361,4393,4357,4373,4371,19,17,8440,368972540,59090
1791,a1509,20141110,4373,4371,4385,4385,4351,4372,4369,1,-2,5938,259435640,57828
1792,a1509,20141111,4372,4369,4352,4362,4306,4319,4334,-50,-35,5968,258695780,59034
1793,a1509,20141112,4319,4334,4370,4375,4328,4332,4342,-2,8,11732,509500360,57186
1794,a1509,20141113,4332,4342,4328,4378,4311,4372,4347,30,5,12148,528109300,57628
1795,a1509,20141114,4372,4347,4357,4399,4356,4389,4380,42,33,9976,437028080,58378
1796,a1509,20141117,4389,4380,4386,4396,4372,4380,4382,0,2,7522,329654200,60570
1797,a1509,20141118,4380,4382,4389,4394,4351,4374,4364,-8,-18,9162,399883880,58682
1798,a1509,20141119,4374,4364,4377,4377,4342,4351,4353,-13,-11,5082,221237400,57254
1799,a1509,20141120,4351,4353,4341,4376,4313,4373,4355,20,2,8628,375830400,57964
1800,a1509,20141121,4373,4355,4379,4389,4362,4374,4370,19,15,9296,406315280,59314
1801,a1509,20141124,4374,4370,4369,4391,4326,4328,4354,-42,-16,15998,696628980,62416
1802,a1509,20141125,4328,4354,4331,4338,4257,4274,4281,-80,-73,36826,1576848480,72494
1803,a1509,20141126,4274,4281,4261,4285,4251,4256,4266,-25,-15,16380,698830540,76338
1804,a1509,20141127,4256,4266,4254,4316,4253,4307,4279,41,13,22404,958780800,79700
1805,a1509,20141128,4307,4279,4304,4323,4283,4311,4308,32,29,13368,575932960,76804
1806,a1509,20141201,4311,4308,4278,4316,4271,4304,4300,-4,-8,15094,649044400,75960
1807,a1509,20141202,4304,4300,4305,4344,4298,4303,4313,3,13,17096,737384340,80674
1808,a1509,20141203,4303,4313,4290,4301,4262,4290,4281,-23,-32,23970,1026273420,91952
1809,a1509,20141204,4290,4281,4294,4327,4282,4307,4313,26,32,18134,782162700,92546
1810,a1509,20141205,4307,4313,4325,4376,4309,4375,4361,62,48,28416,1239289160,86948
1811,a1509,20141208,4375,4361,4400,4400,4342,4358,4363,-3,2,18230,795551780,91522
1812,a1509,20141209,4358,4363,4359,4360,4326,4331,4335,-32,-28,10620,460435540,94930
1813,a1509,20141210,4331,4335,4335,4388,4329,4376,4367,41,32,24022,1049254500,81928
1814,a1509,20141211,4376,4367,4352,4374,4340,4363,4361,-4,-6,13486,588232080,75640
1815,a1509,20141212,4363,4361,4364,4381,4356,4361,4368,0,7,9128,398724400,72248
1816,a1509,20141215,4361,4368,4370,4375,4349,4372,4365,4,-3,15346,669930600,66912
1817,a1509,20141216,4372,4365,4368,4368,4326,4332,4337,-33,-28,23066,1000453480,64754
1818,a1509,20141217,4332,4337,4326,4350,4318,4324,4327,-13,-10,6970,301614940,65742
1819,a1509,20141218,4324,4327,4327,4336,4302,4329,4324,2,-3,8078,349367480,66290
1820,a1509,20141219,4329,4324,4338,4355,4320,4348,4340,24,16,20500,889842060,64192
1821,a1509,20141222,4348,4340,4348,4348,4330,4340,4339,0,-1,3252,141114720,64764
1822,a1509,20141223,4340,4339,4340,4367,4325,4327,4347,-12,8,13434,584004140,64898
1823,a1509,20141224,4327,4347,4320,4380,4313,4376,4350,29,3,22002,957142180,65330
1824,a1509,20141225,4376,4350,4371,4420,4357,4370,4372,20,22,42678,1865987420,72056
1825,a1509,20141226,4370,4372,4377,4393,4366,4393,4383,21,11,25270,1107748160,73530
1826,a1509,20141229,4393,4383,4393,4472,4381,4469,4443,86,60,57030,2534098760,65904
1827,a1509,20141230,4469,4443,4486,4486,4446,4450,4460,7,17,19440,867091500,67302
1828,a1509,20141231,4450,4460,4438,4463,4426,4442,4442,-18,-18,11910,529104480,68086
1829,a1511,20140519,4563,4563,0,0,0,4580,4580,17,17,0,0,0
1830,a1511,20140520,4580,4580,0,0,0,4600,4600,20,20,0,0,0
1831,a1511,20140521,4600,4600,0,0,0,4633,4633,33,33,0,0,0
1832,a1511,20140522,4633,4633,0,0,0,4701,4701,68,68,0,0,0
1833,a1511,20140523,4701,4701,0,0,0,4701,4701,0,0,0,0,0
1834,a1511,20140526,4701,4701,0,0,0,4701,4701,0,0,0,0,0
1835,a1511,20140527,4701,4701,0,0,0,4701,4701,0,0,0,0,0
1836,a1511,20140528,4701,4701,0,0,0,4778,4778,77,77,0,0,0
1837,a1511,20140529,4778,4778,0,0,0,4778,4778,0,0,0,0,0
1838,a1511,20140530,4778,4778,4735,4795,4735,4750,4775,-28,-3,18,859580,10
1839,a1511,20140603,4750,4775,0,0,0,4775,4775,0,0,0,0,10
1840,a1511,20140604,4775,4775,0,0,0,4775,4775,0,0,0,0,10
1841,a1511,20140605,4775,4775,4726,4795,4724,4764,4764,-11,-11,50,2382320,38
1842,a1511,20140606,4764,4764,4755,4757,4722,4722,4743,-42,-21,22,1043620,40
1843,a1511,20140609,4722,4743,4625,4746,4625,4746,4719,3,-24,30,1415980,54
1844,a1511,20140610,4746,4719,4748,4748,4701,4701,4718,-18,-1,12,566220,52
1845,a1511,20140611,4701,4718,4709,4709,4709,4709,4709,-9,-9,2,94180,52
1846,a1511,20140612,4709,4709,0,0,0,4709,4709,0,0,0,0,52
1847,a1511,20140613,4709,4709,4741,4741,4713,4713,4719,4,10,14,660680,40
1848,a1511,20140616,4713,4719,0,0,0,4730,4730,11,11,0,0,40
1849,a1511,20140617,4730,4730,4727,4727,4707,4707,4713,-23,-17,6,282820,36
1850,a1511,20140618,4707,4713,4696,4701,4696,4700,4698,-13,-15,8,375860,32
1851,a1511,20140619,4700,4698,0,0,0,4698,4698,0,0,0,0,32
1852,a1511,20140620,4698,4698,0,0,0,4698,4698,0,0,0,0,32
1853,a1511,20140623,4698,4698,0,0,0,4705,4705,7,7,0,0,32
1854,a1511,20140624,4705,4705,0,0,0,4705,4705,0,0,0,0,32
1855,a1511,20140625,4705,4705,0,0,0,4705,4705,0,0,0,0,32
1856,a1511,20140626,4705,4705,0,0,0,4705,4705,0,0,0,0,32
1857,a1511,20140627,4705,4705,4728,4728,4630,4630,4679,-75,-26,4,187160,32
1858,a1511,20140630,4630,4679,4650,4650,4650,4650,4650,-29,-29,2,93000,32
1859,a1511,20140701,4650,4650,4564,4564,4468,4505,4516,-145,-134,54,2438660,36
1860,a1511,20140702,4505,4516,0,0,0,4516,4516,0,0,0,0,36
1861,a1511,20140703,4516,4516,0,0,0,4516,4516,0,0,0,0,36
1862,a1511,20140704,4516,4516,0,0,0,4496,4496,-20,-20,0,0,36
1863,a1511,20140707,4496,4496,4460,4460,4460,4460,4460,-36,-36,2,89200,34
1864,a1511,20140708,4460,4460,4468,4500,4468,4480,4486,20,26,18,807540,40
1865,a1511,20140709,4480,4486,4430,4430,4430,4430,4430,-56,-56,2,88600,42
1866,a1511,20140710,4430,4430,0,0,0,4403,4403,-27,-27,0,0,42
1867,a1511,20140711,4403,4403,0,0,0,4403,4403,0,0,0,0,42
1868,a1511,20140714,4403,4403,0,0,0,4403,4403,0,0,0,0,42
1869,a1511,20140715,4403,4403,4456,4480,4428,4428,4454,25,51,6,267280,40
1870,a1511,20140716,4428,4454,4465,4469,4465,4469,4467,15,13,4,178680,42
1871,a1511,20140717,4469,4467,0,0,0,4464,4464,-3,-3,0,0,42
1872,a1511,20140718,4464,4464,0,0,0,4464,4464,0,0,0,0,42
1873,a1511,20140721,4464,4464,0,0,0,4464,4464,0,0,0,0,42
1874,a1511,20140722,4464,4464,0,0,0,4464,4464,0,0,0,0,42
1875,a1511,20140723,4464,4464,0,0,0,4464,4464,0,0,0,0,42
1876,a1511,20140724,4464,4464,0,0,0,4456,4456,-8,-8,0,0,42
1877,a1511,20140725,4456,4456,0,0,0,4447,4447,-9,-9,0,0,42
1878,a1511,20140728,4447,4447,4461,4461,4461,4461,4461,14,14,4,178440,42
1879,a1511,20140729,4461,4461,0,0,0,4467,4467,6,6,0,0,42
1880,a1511,20140730,4467,4467,0,0,0,4467,4467,0,0,0,0,42
1881,a1511,20140731,4467,4467,4469,4490,4469,4490,4477,23,10,10,447720,38
1882,a1511,20140801,4490,4477,4498,4500,4498,4500,4499,23,22,4,179960,40
1883,a1511,20140804,4500,4499,0,0,0,4516,4516,17,17,0,0,40
1884,a1511,20140805,4516,4516,0,0,0,4596,4596,80,80,0,0,40
1885,a1511,20140806,4596,4596,0,0,0,4599,4599,3,3,0,0,40
1886,a1511,20140807,4599,4599,4659,4659,4624,4654,4645,55,46,6,278740,42
1887,a1511,20140808,4654,4645,0,0,0,4654,4654,9,9,0,0,42
1888,a1511,20140811,4654,4654,4676,4687,4675,4675,4679,21,25,22,1029520,36
1889,a1511,20140812,4675,4679,4673,4678,4671,4678,4674,-1,-5,6,280440,32
1890,a1511,20140813,4678,4674,4689,4689,4687,4687,4688,13,14,4,187520,30
1891,a1511,20140814,4687,4688,4604,4604,4604,4604,4604,-84,-84,4,184160,34
1892,a1511,20140815,4604,4604,4675,4688,4671,4671,4676,67,72,8,374100,26
1893,a1511,20140818,4671,4676,0,0,0,4676,4676,0,0,0,0,26
1894,a1511,20140819,4676,4676,0,0,0,4668,4668,-8,-8,0,0,26
1895,a1511,20140820,4668,4668,0,0,0,4641,4641,-27,-27,0,0,26
1896,a1511,20140821,4641,4641,0,0,0,4595,4595,-46,-46,0,0,26
1897,a1511,20140822,4595,4595,4593,4606,4572,4595,4596,0,1,24,1103260,36
1898,a1511,20140825,4595,4596,4595,4600,4595,4600,4598,4,2,8,367900,44
1899,a1511,20140826,4600,4598,4601,4653,4601,4653,4628,55,30,10,462880,50
1900,a1511,20140827,4653,4628,4700,4700,4700,4700,4700,72,72,2,94000,48
1901,a1511,20140828,4700,4700,4675,4720,4673,4720,4697,20,-3,8,375760,48
1902,a1511,20140829,4720,4697,0,0,0,4700,4700,3,3,0,0,48
1903,a1511,20140901,4700,4700,0,0,0,4699,4699,-1,-1,0,0,48
1904,a1511,20140902,4699,4699,4713,4717,4702,4705,4709,6,10,24,1130280,26
1905,a1511,20140903,4705,4709,4712,4712,4712,4712,4712,3,3,2,94240,28
1906,a1511,20140904,4712,4712,4700,4700,4668,4695,4687,-17,-25,6,281260,30
1907,a1511,20140905,4695,4687,0,0,0,4687,4687,0,0,0,0,30
1908,a1511,20140909,4687,4687,0,0,0,4673,4673,-14,-14,0,0,30
1909,a1511,20140910,4673,4673,0,0,0,4644,4644,-29,-29,0,0,30
1910,a1511,20140911,4644,4644,4644,4660,4596,4650,4646,6,2,28,1301120,26
1911,a1511,20140912,4650,4646,0,0,0,4692,4692,46,46,0,0,26
1912,a1511,20140915,4692,4692,4725,4725,4725,4725,4725,33,33,2,94500,26
1913,a1511,20140916,4725,4725,0,0,0,4725,4725,0,0,0,0,26
1914,a1511,20140917,4725,4725,0,0,0,4725,4725,0,0,0,0,26
1915,a1511,20140918,4725,4725,0,0,0,4725,4725,0,0,0,0,26
1916,a1511,20140919,4725,4725,4704,4704,4699,4699,4701,-26,-24,6,282100,24
1917,a1511,20140922,4699,4701,0,0,0,4690,4690,-11,-11,0,0,24
1918,a1511,20140923,4690,4690,0,0,0,4675,4675,-15,-15,0,0,24
1919,a1511,20140924,4675,4675,4616,4616,4616,4616,4616,-59,-59,4,184640,28
1920,a1511,20140925,4616,4616,4668,4689,4652,4679,4671,63,55,12,560580,24
1921,a1511,20140926,4679,4671,4688,4688,4688,4688,4688,17,17,2,93760,22
1922,a1511,20140929,4688,4688,0,0,0,4688,4688,0,0,0,0,22
1923,a1511,20140930,4688,4688,0,0,0,4688,4688,0,0,0,0,22
1924,a1511,20141008,4688,4688,4688,4688,4658,4658,4673,-30,-15,4,186920,24
1925,a1511,20141009,4658,4673,0,0,0,4673,4673,0,0,0,0,24
1926,a1511,20141010,4673,4673,4602,4682,4569,4569,4630,-104,-43,18,833460,24
1927,a1511,20141013,4569,4630,4555,4555,4510,4510,4538,-120,-92,6,272300,20
1928,a1511,20141014,4510,4538,0,0,0,4489,4489,-49,-49,0,0,20
1929,a1511,20141015,4489,4489,4487,4494,4478,4478,4486,-11,-3,6,269180,20
1930,a1511,20141016,4478,4486,0,0,0,4478,4478,-8,-8,0,0,20
1931,a1511,20141017,4478,4478,4390,4440,4390,4440,4415,-38,-63,4,176600,20
1932,a1511,20141020,4440,4415,4378,4385,4378,4379,4381,-36,-34,10,438100,20
1933,a1511,20141021,4379,4381,0,0,0,4381,4381,0,0,0,0,20
1934,a1511,20141022,4381,4381,4377,4377,4377,4377,4377,-4,-4,2,87540,18
1935,a1511,20141023,4377,4377,0,0,0,4377,4377,0,0,0,0,18
1936,a1511,20141024,4377,4377,0,0,0,4377,4377,0,0,0,0,18
1937,a1511,20141027,4377,4377,0,0,0,4377,4377,0,0,0,0,18
1938,a1511,20141028,4377,4377,0,0,0,4377,4377,0,0,0,0,18
1939,a1511,20141029,4377,4377,0,0,0,4373,4373,-4,-4,0,0,18
1940,a1511,20141030,4373,4373,0,0,0,4373,4373,0,0,0,0,18
1941,a1511,20141031,4373,4373,4470,4470,4470,4470,4470,97,97,2,89400,20
1942,a1511,20141103,4470,4470,4499,4499,4487,4487,4493,17,23,4,179720,18
1943,a1511,20141104,4487,4493,0,0,0,4486,4486,-7,-7,0,0,18
1944,a1511,20141105,4486,4486,4468,4477,4438,4477,4455,-9,-31,16,712800,18
1945,a1511,20141106,4477,4455,0,0,0,4445,4445,-10,-10,0,0,18
1946,a1511,20141107,4445,4445,4411,4411,4411,4411,4411,-34,-34,2,88220,20
1947,a1511,20141110,4411,4411,0,0,0,4409,4409,-2,-2,0,0,20
1948,a1511,20141111,4409,4409,0,0,0,4409,4409,0,0,0,0,20
1949,a1511,20141112,4409,4409,0,0,0,4417,4417,8,8,0,0,20
1950,a1511,20141113,4417,4417,0,0,0,4417,4417,0,0,0,0,20
1951,a1511,20141114,4417,4417,0,0,0,4417,4417,0,0,0,0,20
1952,a1511,20141117,4417,4417,0,0,0,4414,4414,-3,-3,0,0,20
1953,a1511,20141118,4414,4414,0,0,0,4412,4412,-2,-2,0,0,20
1954,a1511,20141119,4412,4412,0,0,0,4410,4410,-2,-2,0,0,20
1955,a1511,20141120,4410,4410,4344,4400,4342,4394,4346,-16,-64,108,4693820,112
1956,a1511,20141121,4394,4346,4394,4394,4369,4369,4375,23,29,8,350020,108
1957,a1511,20141124,4369,4375,0,0,0,4358,4358,-17,-17,0,0,108
1958,a1511,20141125,4358,4358,0,0,0,4358,4358,0,0,0,0,108
1959,a1511,20141126,4358,4358,0,0,0,4341,4341,-17,-17,0,0,108
1960,a1511,20141127,4341,4341,0,0,0,4341,4341,0,0,0,0,108
1961,a1511,20141128,4341,4341,0,0,0,4341,4341,0,0,0,0,108
1962,a1511,20141201,4341,4341,4270,4291,4270,4291,4276,-50,-65,20,855260,110
1963,a1511,20141202,4291,4276,4391,4391,4296,4296,4358,20,82,22,958840,110
1964,a1511,20141203,4296,4358,0,0,0,4358,4358,0,0,0,0,110
1965,a1511,20141204,4358,4358,0,0,0,4358,4358,0,0,0,0,110
1966,a1511,20141205,4358,4358,0,0,0,4406,4406,48,48,0,0,110
1967,a1511,20141208,4406,4406,4362,4362,4335,4335,4353,-71,-53,10,435300,110
1968,a1511,20141209,4335,4353,0,0,0,4353,4353,0,0,0,0,110
1969,a1511,20141210,4353,4353,4363,4363,4363,4363,4363,10,10,2,87260,110
1970,a1511,20141211,4363,4363,0,0,0,4359,4359,-4,-4,0,0,110
1971,a1511,20141212,4359,4359,4339,4339,4339,4339,4339,-20,-20,2,86780,110
1972,a1511,20141215,4339,4339,0,0,0,4339,4339,0,0,0,0,110
1973,a1511,20141216,4339,4339,4304,4314,4304,4310,4310,-29,-29,26,1120840,110
1974,a1511,20141217,4310,4310,4317,4345,4313,4345,4324,35,14,14,605460,108
1975,a1511,20141218,4345,4324,0,0,0,4324,4324,0,0,0,0,108
1976,a1511,20141219,4324,4324,4336,4336,4329,4330,4332,6,8,14,606540,108
1977,a1511,20141222,4330,4332,4349,4349,4349,4349,4349,17,17,2,86980,108
1978,a1511,20141223,4349,4349,0,0,0,4342,4342,-7,-7,0,0,108
1979,a1511,20141224,4342,4342,4321,4342,4321,4342,4325,0,-17,26,1124560,128
1980,a1511,20141225,4342,4325,4341,4341,4341,4341,4341,16,16,2,86820,128
1981,a1511,20141226,4341,4341,4358,4358,4358,4358,4358,17,17,2,87160,128
1982,a1511,20141229,4358,4358,4383,4415,4383,4415,4397,57,39,6,263860,128
1983,a1511,20141230,4415,4397,4420,4428,4404,4404,4422,7,25,12,530720,132
1984,a1511,20141231,4404,4422,4422,4422,4422,4422,4422,0,0,2,88440,130
1985,a1601,20140715,4444,4444,0,0,0,4471,4471,27,27,0,0,0
1986,a1601,20140716,4471,4471,4524,4524,4524,4524,4524,53,53,2,90480,2
1987,a1601,20140717,4524,4524,0,0,0,4517,4517,-7,-7,0,0,2
1988,a1601,20140718,4517,4517,4510,4510,4510,4510,4510,-7,-7,2,90200,4
1989,a1601,20140721,4510,4510,0,0,0,4510,4510,0,0,0,0,4
1990,a1601,20140722,4510,4510,0,0,0,4510,4510,0,0,0,0,4
1991,a1601,20140723,4510,4510,0,0,0,4506,4506,-4,-4,0,0,4
1992,a1601,20140724,4506,4506,4465,4465,4465,4465,4465,-41,-41,2,89300,6
1993,a1601,20140725,4465,4465,4584,4584,4453,4453,4507,-12,42,6,270420,6
1994,a1601,20140728,4453,4507,0,0,0,4507,4507,0,0,0,0,6
1995,a1601,20140729,4507,4507,0,0,0,4507,4507,0,0,2,90260,8
1996,a1601,20140730,4507,4507,0,0,0,4507,4507,0,0,0,0,8
1997,a1601,20140731,4507,4507,0,0,0,4507,4507,0,0,0,0,8
1998,a1601,20140801,4507,4507,0,0,0,4507,4507,0,0,0,0,8
1999,a1601,20140804,4507,4507,4559,4564,4559,4564,4561,57,54,4,182460,10
2000,a1601,20140805,4564,4561,4598,4630,4540,4630,4585,69,24,68,3117920,32
2001,a1601,20140806,4630,4585,4638,4645,4629,4635,4637,50,52,48,2226120,58
2002,a1601,20140807,4635,4637,4624,4674,4606,4664,4635,27,-2,64,2966620,56
2003,a1601,20140808,4664,4635,4681,4681,4652,4660,4663,25,28,28,1305880,60
2004,a1601,20140811,4660,4663,4682,4700,4670,4688,4688,25,25,52,2437820,94
2005,a1601,20140812,4688,4688,4681,4692,4671,4680,4677,-8,-11,26,1216240,106
2006,a1601,20140813,4680,4677,4695,4740,4695,4740,4727,63,50,46,2174500,112
2007,a1601,20140814,4740,4727,4731,4756,4665,4672,4701,-55,-26,92,4325680,106
2008,a1601,20140815,4672,4701,4689,4702,4689,4697,4697,-4,-4,18,845460,114
2009,a1601,20140818,4697,4697,4698,4705,4690,4691,4695,-6,-2,20,939160,108
2010,a1601,20140819,4691,4695,4690,4740,4676,4693,4699,-2,4,50,2349500,110
2011,a1601,20140820,4693,4699,4666,4675,4651,4662,4665,-37,-34,50,2332740,108
2012,a1601,20140821,4662,4665,4659,4659,4620,4628,4636,-37,-29,44,2040260,120
2013,a1601,20140822,4628,4636,4617,4656,4617,4645,4643,9,7,20,928600,118
2014,a1601,20140825,4645,4643,4645,4681,4645,4676,4659,33,16,922,42964360,852
2015,a1601,20140826,4676,4659,4666,4747,4659,4739,4710,80,51,802,37780580,1408
2016,a1601,20140827,4739,4710,4735,4760,4724,4749,4748,39,38,684,32477220,1864
2017,a1601,20140828,4749,4748,4749,4750,4729,4734,4736,-14,-12,218,10325520,1902
2018,a1601,20140829,4734,4736,4754,4756,4730,4731,4736,-5,0,178,8431000,1912
2019,a1601,20140901,4731,4736,4722,4738,4709,4738,4729,2,-7,76,3594560,1918
2020,a1601,20140902,4738,4729,4609,4762,4609,4739,4691,10,-38,5696,267207940,4214
2021,a1601,20140903,4739,4691,4741,4756,4719,4734,4737,43,46,556,26338420,4448
2022,a1601,20140904,4734,4737,4731,4738,4713,4718,4724,-19,-13,544,25701400,4324
2023,a1601,20140905,4718,4724,4718,4718,4692,4706,4702,-18,-22,784,36869560,4084
2024,a1601,20140909,4706,4702,4718,4723,4685,4695,4705,-7,3,934,43946400,4194
2025,a1601,20140910,4695,4705,4688,4708,4683,4702,4692,-3,-13,762,35755840,4414
2026,a1601,20140911,4702,4692,4705,4711,4686,4696,4695,4,3,424,19910620,4468
2027,a1601,20140912,4696,4695,4691,4761,4691,4758,4735,63,40,702,33241520,4492
2028,a1601,20140915,4758,4735,4750,4771,4736,4761,4755,26,20,340,16168140,4590
2029,a1601,20140916,4761,4755,4750,4806,4742,4760,4772,5,17,1214,57943000,4560
2030,a1601,20140917,4760,4772,4757,4776,4757,4766,4768,-6,-4,118,5626400,4590
2031,a1601,20140918,4766,4768,4778,4780,4755,4767,4761,-1,-7,190,9047760,4634
2032,a1601,20140919,4767,4761,4761,4762,4730,4738,4745,-23,-16,338,16041280,4738
2033,a1601,20140922,4738,4745,4712,4725,4651,4674,4683,-71,-62,2130,99748140,4176
2034,a1601,20140923,4674,4683,4667,4684,4650,4671,4672,-12,-11,154,7195160,4138
2035,a1601,20140924,4671,4672,4689,4702,4672,4673,4687,1,15,228,10688040,4090
2036,a1601,20140925,4673,4687,4695,4695,4667,4686,4676,-1,-11,594,27777340,4252
2037,a1601,20140926,4686,4676,4686,4726,4678,4708,4708,32,32,632,29754900,4574
2038,a1601,20140929,4708,4708,4723,4741,4710,4720,4721,12,13,130,6137380,4518
2039,a1601,20140930,4720,4721,4737,4738,4700,4701,4711,-20,-10,114,5371180,4474
2040,a1601,20141008,4701,4711,4709,4709,4670,4678,4684,-33,-27,102,4778380,4464
2041,a1601,20141009,4678,4684,4687,4696,4672,4672,4680,-12,-4,82,3837800,4490
2042,a1601,20141010,4672,4680,4673,4677,4574,4587,4610,-93,-70,3668,169122740,3366
2043,a1601,20141013,4587,4610,4577,4600,4502,4526,4560,-84,-50,604,27547540,3572
2044,a1601,20141014,4526,4560,4526,4535,4435,4444,4467,-116,-93,3004,134204960,4036
2045,a1601,20141015,4444,4467,4449,4532,4443,4490,4496,23,29,1376,61871680,3844
2046,a1601,20141016,4490,4496,4487,4487,4421,4445,4460,-51,-36,836,37288720,3348
2047,a1601,20141017,4445,4460,4468,4470,4435,4444,4447,-16,-13,356,15833420,3558
2048,a1601,20141020,4444,4447,4440,4440,4386,4406,4412,-41,-35,3112,137325880,5380
2049,a1601,20141021,4406,4412,4401,4454,4400,4403,4423,-9,11,1322,58481760,5594
2050,a1601,20141022,4403,4423,4427,4427,4391,4398,4404,-25,-19,874,38490960,4996
2051,a1601,20141023,4398,4404,4390,4419,4381,4412,4402,8,-2,606,26678780,5322
2052,a1601,20141024,4412,4402,4449,4455,4413,4425,4430,23,28,806,35713420,5322
2053,a1601,20141027,4425,4430,4396,4409,4382,4408,4391,-22,-39,1138,49969600,5418
2054,a1601,20141028,4408,4391,4427,4435,4410,4414,4418,23,27,312,13787120,5346
2055,a1601,20141029,4414,4418,4419,4433,4416,4433,4424,15,6,226,9998840,5342
2056,a1601,20141030,4433,4424,4463,4463,4425,4440,4439,16,15,304,13497540,5360
2057,a1601,20141031,4440,4439,4432,4488,4432,4488,4469,49,30,330,14750320,5320
2058,a1601,20141103,4488,4469,4471,4517,4469,4480,4495,11,26,116,5215020,5286
2059,a1601,20141104,4480,4495,4471,4487,4450,4458,4474,-37,-21,522,23354780,5358
2060,a1601,20141105,4458,4474,4465,4482,4460,4463,4464,-11,-10,92,4107100,5356
2061,a1601,20141106,4463,4464,4459,4459,4355,4398,4378,-66,-86,976,42731500,5906
2062,a1601,20141107,4398,4378,4401,4438,4401,4419,4422,41,44,78,3449720,5926
2063,a1601,20141110,4419,4422,4433,4433,4399,4416,4411,-6,-11,72,3176160,5916
2064,a1601,20141111,4416,4411,4395,4397,4357,4372,4384,-39,-27,320,14031820,5836
2065,a1601,20141112,4372,4384,4413,4413,4373,4378,4386,-6,2,532,23336160,5908
2066,a1601,20141113,4378,4386,4376,4420,4360,4419,4390,33,4,144,6322660,5864
2067,a1601,20141114,4419,4390,4409,4438,4409,4425,4415,35,25,200,8831900,5750
2068,a1601,20141117,4425,4415,4419,4430,4419,4422,4421,7,6,262,11585400,5570
2069,a1601,20141118,4422,4421,4414,4417,4400,4400,4403,-21,-18,440,19373560,5272
2070,a1601,20141119,4400,4403,4383,4401,4380,4394,4386,-9,-17,144,6316400,5228
2071,a1601,20141120,4394,4386,4375,4399,4375,4399,4395,13,9,108,4746820,5156
2072,a1601,20141121,4399,4395,4409,4409,4387,4409,4397,14,2,124,5452920,5128
2073,a1601,20141124,4409,4397,4403,4403,4352,4352,4384,-45,-13,456,19994880,5380
2074,a1601,20141125,4352,4384,4348,4348,4270,4289,4300,-95,-84,1334,57367480,6072
2075,a1601,20141126,4289,4300,4301,4301,4269,4275,4279,-25,-21,400,17118340,6224
2076,a1601,20141127,4275,4279,4278,4322,4269,4309,4290,30,11,376,16132480,6268
2077,a1601,20141128,4309,4290,4305,4325,4297,4318,4316,28,26,324,13986120,6256
2078,a1601,20141201,4318,4316,4285,4310,4282,4310,4300,-6,-16,244,10493500,6250
2079,a1601,20141202,4310,4300,4337,4340,4300,4310,4314,10,14,292,12598480,6426
2080,a1601,20141203,4310,4314,4281,4299,4244,4270,4265,-44,-49,1396,59544980,7446
2081,a1601,20141204,4270,4265,4280,4315,4280,4302,4298,37,33,2412,103669420,8722
2082,a1601,20141205,4302,4298,4302,4412,4290,4401,4385,103,87,8164,358059040,12906
2083,a1601,20141208,4401,4385,4409,4419,4367,4377,4385,-8,0,674,29561340,13016
2084,a1601,20141209,4377,4385,4372,4372,4343,4354,4356,-31,-29,2656,115713340,13690
2085,a1601,20141210,4354,4356,4364,4404,4364,4398,4387,42,31,152,6668280,13692
2086,a1601,20141211,4398,4387,4398,4398,4382,4385,4388,-2,1,200,8777900,13688
2087,a1601,20141212,4385,4388,4398,4401,4383,4388,4394,0,6,280,12303280,13592
2088,a1601,20141215,4388,4394,4377,4405,4377,4402,4398,8,4,438,19264900,13648
2089,a1601,20141216,4402,4398,4398,4398,4370,4378,4376,-20,-22,712,31163180,13620
2090,a1601,20141217,4378,4376,4374,4382,4363,4369,4368,-7,-8,576,25161120,13626
2091,a1601,20141218,4369,4368,4370,4375,4349,4370,4366,2,-2,534,23319400,13624
2092,a1601,20141219,4370,4366,4370,4389,4368,4389,4382,23,16,594,26034520,13624
2093,a1601,20141222,4389,4382,4380,4380,4371,4380,4378,-2,-4,216,9456940,13552
2094,a1601,20141223,4380,4378,4369,4393,4365,4367,4377,-11,-1,746,32653800,13224
2095,a1601,20141224,4367,4377,4360,4402,4358,4397,4385,20,8,926,40607520,13210
2096,a1601,20141225,4397,4385,4430,4440,4378,4389,4388,4,3,2640,115855320,14404
2097,a1601,20141226,4389,4388,4388,4399,4375,4395,4386,7,-2,1506,66057440,14510
2098,a1601,20141229,4395,4386,4392,4465,4388,4464,4447,78,61,3238,144020020,13628
2099,a1601,20141230,4464,4447,4469,4475,4443,4447,4453,0,6,1788,79625140,13676
2100,a1601,20141231,4447,4453,4447,4457,4432,4440,4442,-13,-11,626,27810140,13654
2101,a1603,20140916,4735,4735,0,0,0,4735,4735,0,0,0,0,0
2102,a1603,20140917,4735,4735,0,0,0,4735,4735,0,0,0,0,0
2103,a1603,20140918,4735,4735,0,0,0,4735,4735,0,0,0,0,0
2104,a1603,20140919,4735,4735,0,0,0,4735,4735,0,0,0,0,0
2105,a1603,20140922,4735,4735,0,0,0,4735,4735,0,0,0,0,0
2106,a1603,20140923,4735,4735,0,0,0,4724,4724,-11,-11,0,0,0
2107,a1603,20140924,4724,4724,4603,4727,4603,4696,4660,-28,-64,16,745620,0
2108,a1603,20140925,4696,4660,0,0,0,4660,4660,0,0,0,0,0
2109,a1603,20140926,4660,4660,0,0,0,4660,4660,0,0,0,0,0
2110,a1603,20140929,4660,4660,0,0,0,4660,4660,0,0,0,0,0
2111,a1603,20140930,4660,4660,0,0,0,4660,4660,0,0,0,0,0
2112,a1603,20141008,4660,4660,0,0,0,4660,4660,0,0,0,0,0
2113,a1603,20141009,4660,4660,0,0,0,4660,4660,0,0,0,0,0
2114,a1603,20141010,4660,4660,0,0,0,4660,4660,0,0,0,0,0
2115,a1603,20141013,4660,4660,0,0,0,4548,4548,-112,-112,0,0,0
2116,a1603,20141014,4548,4548,0,0,0,4503,4503,-45,-45,0,0,0
2117,a1603,20141015,4503,4503,0,0,0,4503,4503,0,0,0,0,0
2118,a1603,20141016,4503,4503,0,0,0,4503,4503,0,0,0,0,0
2119,a1603,20141017,4503,4503,0,0,0,4503,4503,0,0,0,0,0
2120,a1603,20141020,4503,4503,0,0,0,4435,4435,-68,-68,0,0,0
2121,a1603,20141021,4435,4435,0,0,0,4435,4435,0,0,0,0,0
2122,a1603,20141022,4435,4435,0,0,0,4435,4435,0,0,0,0,0
2123,a1603,20141023,4435,4435,0,0,0,4435,4435,0,0,0,0,0
2124,a1603,20141024,4435,4435,0,0,0,4435,4435,0,0,0,0,0
2125,a1603,20141027,4435,4435,0,0,0,4435,4435,0,0,0,0,0
2126,a1603,20141028,4435,4435,0,0,0,4435,4435,0,0,0,0,0
2127,a1603,20141029,4435,4435,0,0,0,4435,4435,0,0,0,0,0
2128,a1603,20141030,4435,4435,0,0,0,4450,4450,15,15,0,0,0
2129,a1603,20141031,4450,4450,0,0,0,4450,4450,0,0,0,0,0
2130,a1603,20141103,4450,4450,0,0,0,4450,4450,0,0,0,0,0
2131,a1603,20141104,4450,4450,0,0,0,4453,4453,3,3,0,0,0
2132,a1603,20141105,4453,4453,0,0,0,4453,4453,0,0,0,0,0
2133,a1603,20141106,4453,4453,0,0,0,4453,4453,0,0,0,0,0
2134,a1603,20141107,4453,4453,0,0,0,4453,4453,0,0,0,0,0
2135,a1603,20141110,4453,4453,0,0,0,4430,4430,-23,-23,0,0,0
2136,a1603,20141111,4430,4430,0,0,0,4402,4402,-28,-28,0,0,0
2137,a1603,20141112,4402,4402,0,0,0,4402,4402,0,0,0,0,0
2138,a1603,20141113,4402,4402,0,0,0,4402,4402,0,0,0,0,0
2139,a1603,20141114,4402,4402,0,0,0,4402,4402,0,0,0,0,0
2140,a1603,20141117,4402,4402,0,0,0,4402,4402,0,0,0,0,0
2141,a1603,20141118,4402,4402,0,0,0,4402,4402,0,0,0,0,0
2142,a1603,20141119,4402,4402,0,0,0,4402,4402,0,0,0,0,0
2143,a1603,20141120,4402,4402,0,0,0,4402,4402,0,0,0,0,0
2144,a1603,20141121,4402,4402,0,0,0,4402,4402,0,0,0,0,0
2145,a1603,20141124,4402,4402,0,0,0,4375,4375,-27,-27,0,0,0
2146,a1603,20141125,4375,4375,0,0,0,4375,4375,0,0,0,0,0
2147,a1603,20141126,4375,4375,0,0,0,4373,4373,-2,-2,0,0,0
2148,a1603,20141127,4373,4373,0,0,0,4373,4373,0,0,0,0,0
2149,a1603,20141128,4373,4373,0,0,0,4373,4373,0,0,0,0,0
2150,a1603,20141201,4373,4373,0,0,0,4373,4373,0,0,0,0,0
2151,a1603,20141202,4373,4373,0,0,0,4373,4373,0,0,0,0,0
2152,a1603,20141203,4373,4373,0,0,0,4293,4293,-80,-80,0,0,0
2153,a1603,20141204,4293,4293,0,0,0,4293,4293,0,0,0,0,0
2154,a1603,20141205,4293,4293,0,0,0,4341,4341,48,48,0,0,0
2155,a1603,20141208,4341,4341,0,0,0,4341,4341,0,0,0,0,0
2156,a1603,20141209,4341,4341,0,0,0,4341,4341,0,0,0,0,0
2157,a1603,20141210,4341,4341,0,0,0,4341,4341,0,0,0,0,0
2158,a1603,20141211,4341,4341,0,0,0,4341,4341,0,0,0,0,0
2159,a1603,20141212,4341,4341,4452,4452,4452,4452,4452,111,111,2,89040,2
2160,a1603,20141215,4452,4452,0,0,0,4456,4456,4,4,0,0,2
2161,a1603,20141216,4456,4456,0,0,0,4434,4434,-22,-22,0,0,2
2162,a1603,20141217,4434,4434,0,0,0,4434,4434,0,0,0,0,2
2163,a1603,20141218,4434,4434,0,0,0,4434,4434,0,0,0,0,2
2164,a1603,20141219,4434,4434,0,0,0,4450,4450,16,16,0,0,2
2165,a1603,20141222,4450,4450,0,0,0,4446,4446,-4,-4,0,0,2
2166,a1603,20141223,4446,4446,0,0,0,4445,4445,-1,-1,0,0,2
2167,a1603,20141224,4445,4445,0,0,0,4453,4453,8,8,0,0,2
2168,a1603,20141225,4453,4453,0,0,0,4456,4456,3,3,0,0,2
2169,a1603,20141226,4456,4456,0,0,0,4454,4454,-2,-2,0,0,2
2170,a1603,20141229,4454,4454,0,0,0,4515,4515,61,61,0,0,2
2171,a1603,20141230,4515,4515,0,0,0,4521,4521,6,6,0,0,2
2172,a1603,20141231,4521,4521,0,0,0,4510,4510,-11,-11,0,0,2
2173,a1605,20141117,4390,4390,0,0,0,4420,4420,30,30,0,0,0
2174,a1605,20141118,4420,4420,0,0,0,4420,4420,0,0,0,0,0
2175,a1605,20141119,4420,4420,0,0,0,4420,4420,0,0,0,0,0
2176,a1605,20141120,4420,4420,0,0,0,4420,4420,0,0,0,0,0
2177,a1605,20141121,4420,4420,0,0,0,4420,4420,0,0,0,0,0
2178,a1605,20141124,4420,4420,0,0,0,4420,4420,0,0,0,0,0
2179,a1605,20141125,4420,4420,0,0,0,4420,4420,0,0,0,0,0
2180,a1605,20141126,4420,4420,0,0,0,4395,4395,-25,-25,0,0,0
2181,a1605,20141127,4395,4395,0,0,0,4355,4355,-40,-40,0,0,0
2182,a1605,20141128,4355,4355,4290,4370,4290,4340,4325,-15,-30,10,432580,4
2183,a1605,20141201,4340,4325,0,0,0,4325,4325,0,0,0,0,4
2184,a1605,20141202,4325,4325,0,0,0,4325,4325,0,0,0,0,4
2185,a1605,20141203,4325,4325,4300,4300,4300,4300,4300,-25,-25,2,86000,4
2186,a1605,20141204,4300,4300,4305,4305,4301,4301,4301,1,1,10,430180,12
2187,a1605,20141205,4301,4301,4350,4404,4286,4399,4357,98,56,74,3224540,56
2188,a1605,20141208,4399,4357,0,0,0,4357,4357,0,0,0,0,56
2189,a1605,20141209,4357,4357,4351,4364,4351,4364,4356,7,-1,8,348540,60
2190,a1605,20141210,4364,4356,0,0,0,4359,4359,3,3,0,0,60
2191,a1605,20141211,4359,4359,4377,4377,4377,4377,4377,18,18,2,87540,58
2192,a1605,20141212,4377,4377,0,0,0,4377,4377,0,0,0,0,58
2193,a1605,20141215,4377,4377,0,0,0,4377,4377,0,0,12,526500,58
2194,a1605,20141216,4377,4377,0,0,0,4377,4377,0,0,0,0,58
2195,a1605,20141217,4377,4377,4403,4403,4353,4353,4378,-24,1,4,175120,58
2196,a1605,20141218,4353,4378,4290,4388,4290,4383,4336,5,-42,22,954020,58
2197,a1605,20141219,4383,4336,0,0,0,4375,4375,39,39,0,0,58
2198,a1605,20141222,4375,4375,0,0,0,4375,4375,0,0,0,0,58
2199,a1605,20141223,4375,4375,4423,4423,4369,4369,4400,-6,25,6,264040,60
2200,a1605,20141224,4369,4400,0,0,0,4400,4400,0,0,2,88180,58
2201,a1605,20141225,4400,4400,0,0,0,4400,4400,0,0,0,0,58
2202,a1605,20141226,4400,4400,4379,4411,4378,4411,4393,11,-7,18,790860,60
2203,a1605,20141229,4411,4393,4463,4488,4449,4488,4466,95,73,18,804000,68
2204,a1605,20141230,4488,4466,4465,4465,4461,4464,4464,-2,-2,18,803520,62
2205,a1605,20141231,4464,4464,4455,4455,4455,4455,4455,-9,-9,2,89100,64
1,a1501,20150105,4670,4665,4665,4711,4660,4690,4697,25,32,8932,419602560,28210
2,a1501,20150106,4690,4697,4699,4715,4685,4709,4707,12,10,4788,225371980,21880
3,a1501,20150107,4709,4707,4685,4690,4680,4687,4686,-20,-21,2280,106858000,19984
4,a1501,20150108,4687,4686,4690,4720,4690,4720,4709,34,23,2612,123022600,17814
5,a1501,20150109,4720,4709,4700,4720,4700,4710,4716,1,7,42,1980780,16794
6,a1501,20150112,4710,4716,4720,4722,4710,4710,4717,-6,1,810,38208600,14300
7,a1501,20150113,4710,4717,4700,4720,4700,4701,4701,-16,-16,534,25103800,9416
8,a1501,20150114,4701,4701,4700,4720,4700,4710,4700,9,-1,912,42869300,6714
9,a1501,20150115,4710,4700,4700,4709,4601,4709,4697,9,-3,1306,61344860,1952
10,a1501,20150116,4709,4697,4599,4599,4599,4599,4700,-98,3,6,275940,0
11,a1503,20150105,4445,4444,4459,4459,4312,4445,4390,1,-54,258,11326520,206
12,a1503,20150106,4445,4390,4423,4495,4423,4495,4463,105,73,22,981860,208
13,a1503,20150107,4495,4463,4630,4630,4498,4510,4542,47,79,82,3724800,192
14,a1503,20150108,4510,4542,4520,4560,4514,4548,4537,6,-5,20,907480,194
15,a1503,20150109,4548,4537,4565,4574,4489,4502,4544,-35,7,158,7179680,228
16,a1503,20150112,4502,4544,4470,4516,4468,4502,4504,-42,-40,52,2342580,258
17,a1503,20150113,4502,4504,4450,4458,4438,4449,4441,-55,-63,136,6039980,138
18,a1503,20150114,4449,4441,4452,4452,4452,4452,4452,11,11,2,89040,136
19,a1503,20150115,4452,4452,0,0,0,4452,4452,0,0,0,0,136
20,a1503,20150116,4452,4452,4460,4478,4426,4450,4450,-2,-2,56,2492180,138
21,a1503,20150119,4450,4450,4415,4477,4415,4469,4453,19,3,6,267220,140
22,a1503,20150120,4469,4453,4421,4459,4421,4440,4435,-13,-18,12,532280,136
23,a1503,20150121,4440,4435,4427,4457,4415,4425,4431,-10,-4,30,1329540,126
24,a1503,20150122,4425,4431,4403,4437,4403,4420,4426,-11,-5,28,1239280,118
25,a1503,20150123,4420,4426,0,0,0,4426,4426,0,0,0,0,118
26,a1503,20150126,4426,4426,4416,4416,4340,4340,4378,-86,-48,4,175120,118
27,a1503,20150127,4340,4378,4408,4408,4350,4350,4379,-28,1,12,525580,122
28,a1503,20150128,4350,4379,4385,4385,4370,4370,4375,-9,-4,12,525000,126
29,a1503,20150129,4370,4375,4350,4367,4307,4354,4343,-21,-32,26,1129420,126
30,a1503,20150130,4354,4343,4353,4360,4330,4330,4341,-13,-2,30,1302460,130
31,a1503,20150202,4330,4341,4339,4339,4311,4330,4324,-11,-17,20,864980,130
32,a1503,20150203,4330,4324,4349,4349,4320,4320,4334,-4,10,4,173380,130
33,a1503,20150204,4320,4334,4335,4380,4280,4285,4319,-49,-15,74,3196220,138
34,a1503,20150205,4285,4319,4310,4321,4300,4321,4311,2,-8,28,1207300,122
35,a1503,20150206,4321,4311,0,0,0,4311,4311,0,0,0,0,122
36,a1503,20150209,4311,4311,4344,4344,4257,4306,4297,-5,-14,56,2406360,120
37,a1503,20150210,4306,4297,4303,4303,4262,4270,4287,-27,-10,20,857520,116
38,a1503,20150211,4270,4287,4260,4280,4255,4260,4266,-27,-21,20,853300,116
39,a1503,20150212,4260,4266,0,0,0,4263,4263,-3,-3,0,0,116
40,a1503,20150213,4263,4263,4269,4269,4211,4240,4240,-23,-23,6,254400,114
41,a1503,20150216,4240,4240,4200,4236,4200,4220,4211,-20,-29,14,589560,110
42,a1503,20150217,4220,4211,4140,4140,4140,4140,4140,-71,-71,2,82800,108
43,a1503,20150225,4140,4140,4005,4180,4000,4000,4022,-140,-118,20,804400,100
44,a1503,20150226,4000,4022,4057,4059,4031,4059,4055,37,33,46,1865560,110
45,a1503,20150227,4059,4055,4059,4217,4057,4150,4081,95,26,86,3510060,90
46,a1503,20150302,4150,4081,4078,4078,4078,4078,4078,-3,-3,82,3343960,2
47,a1503,20150303,4078,4078,0,0,0,4078,4078,0,0,0,0,2
48,a1503,20150304,4078,4078,0,0,0,4078,4078,0,0,0,0,2
49,a1503,20150305,4078,4078,0,0,0,4078,4078,0,0,0,0,2
50,a1503,20150306,4078,4078,4000,4000,4000,4000,4000,-78,-78,2,80000,0
51,a1503,20150309,4000,4000,0,0,0,4000,4000,0,0,0,0,0
52,a1503,20150310,4000,4000,0,0,0,4000,4000,0,0,0,0,0
53,a1503,20150311,4000,4000,0,0,0,4000,4000,0,0,0,0,0
54,a1503,20150312,4000,4000,0,0,0,4000,4000,0,0,0,0,0
55,a1503,20150313,4000,4000,0,0,0,4076,4076,76,76,0,0,0
56,a1505,20150105,4510,4505,4488,4504,4446,4497,4486,-8,-19,72400,3248361220,257298
57,a1505,20150106,4497,4486,4500,4548,4486,4503,4514,17,28,176706,7977943480,257146
58,a1505,20150107,4503,4514,4514,4528,4480,4505,4503,-9,-11,102236,4604083940,259540
59,a1505,20150108,4505,4503,4510,4524,4490,4503,4508,0,5,93610,4220490960,258778
60,a1505,20150109,4503,4508,4508,4519,4486,4509,4502,1,-6,106146,4779244560,257520
61,a1505,20150112,4509,4502,4511,4538,4497,4510,4521,8,19,134590,6084913440,256854
62,a1505,20150113,4510,4521,4501,4504,4465,4483,4482,-38,-39,116956,5242181380,246092
63,a1505,20150114,4483,4482,4485,4487,4452,4467,4469,-15,-13,96432,4310197200,246202
64,a1505,20150115,4467,4469,4456,4504,4456,4497,4482,28,13,96184,4311249760,247480
65,a1505,20150116,4497,4482,4495,4522,4470,4506,4494,24,12,115612,5195739760,242850
66,a1505,20150119,4506,4494,4514,4518,4475,4496,4497,2,3,105682,4753200120,239272
67,a1505,20150120,4496,4497,4500,4515,4457,4458,4478,-39,-19,88182,3949372360,233202
68,a1505,20150121,4458,4478,4457,4496,4408,4460,4456,-18,-22,155502,6929374760,219656
69,a1505,20150122,4460,4456,4452,4472,4434,4441,4453,-15,-3,71814,3198444140,215952
70,a1505,20150123,4441,4453,4445,4454,4416,4426,4432,-27,-21,56848,2519627520,210796
71,a1505,20150126,4426,4432,4421,4445,4391,4391,4414,-41,-18,82258,3630911060,209592
72,a1505,20150127,4391,4414,4395,4465,4393,4440,4429,26,15,65310,2892932700,203284
73,a1505,20150128,4440,4429,4440,4450,4412,4418,4430,-11,1,49192,2179404040,203628
74,a1505,20150129,4418,4430,4415,4421,4350,4364,4371,-66,-59,212272,9279981680,209296
75,a1505,20150130,4364,4371,4355,4386,4340,4349,4366,-22,-5,97866,4273338120,203100
76,a1505,20150202,4349,4366,4350,4408,4349,4403,4382,37,16,112488,4929467000,194300
77,a1505,20150203,4403,4382,4403,4436,4403,4433,4421,51,39,90338,3994318620,184900
78,a1505,20150204,4433,4421,4438,4455,4409,4413,4431,-8,10,72228,3200637660,179178
79,a1505,20150205,4413,4431,4411,4425,4380,4417,4406,-14,-25,67152,2958896400,175700
80,a1505,20150206,4417,4406,4426,4436,4412,4433,4423,27,17,43952,1944338660,178198
81,a1505,20150209,4433,4423,4437,4440,4384,4415,4405,-8,-18,75788,3338863760,175166
82,a1505,20150210,4415,4405,4403,4427,4398,4404,4411,-1,6,37656,1661164560,175410
83,a1505,20150211,4404,4411,4402,4413,4394,4406,4403,-5,-8,27402,1206588300,174202
84,a1505,20150212,4406,4403,4411,4431,4395,4412,4416,9,13,42358,1870620180,172010
85,a1505,20150213,4412,4416,4404,4433,4402,4409,4418,-7,2,55144,2436523200,166090
86,a1505,20150216,4409,4418,4414,4415,4356,4367,4377,-51,-41,86658,3793866460,151852
87,a1505,20150217,4367,4377,4361,4377,4361,4367,4369,-10,-8,24642,1076837680,149446
88,a1505,20150225,4367,4369,4381,4388,4284,4287,4321,-82,-48,72532,3134379160,153108
89,a1505,20150226,4287,4321,4286,4290,4230,4284,4268,-37,-53,122612,5233807500,162036
90,a1505,20150227,4284,4268,4285,4339,4251,4317,4302,49,34,107898,4642308580,155760
91,a1505,20150302,4317,4302,4322,4330,4265,4272,4292,-30,-10,102046,4380122820,172618
92,a1505,20150303,4272,4292,4253,4292,4250,4280,4275,-12,-17,86130,3682768900,170542
93,a1505,20150304,4280,4275,4273,4287,4263,4280,4274,5,-1,43144,1844343200,169030
94,a1505,20150305,4280,4274,4273,4279,4171,4179,4216,-95,-58,153078,6454254960,197828
95,a1505,20150306,4179,4216,4178,4194,4161,4172,4179,-44,-37,70410,2943059280,193814
96,a1505,20150309,4172,4179,4180,4218,4154,4193,4188,14,9,82488,3455033180,184668
97,a1505,20150310,4193,4188,4188,4205,4115,4119,4152,-69,-36,105646,4386803560,204018
98,a1505,20150311,4119,4152,4129,4200,4106,4184,4169,32,17,148358,6186247140,183226
99,a1505,20150312,4184,4169,4190,4190,4157,4170,4173,1,4,40778,1701917000,181136
100,a1505,20150313,4170,4173,4166,4185,4152,4154,4169,-19,-4,42586,1775554040,179448
101,a1505,20150316,4154,4169,4155,4183,4141,4180,4162,11,-7,47218,1965363800,175256
102,a1505,20150317,4180,4162,4177,4228,4166,4169,4192,7,30,67066,2811474940,172268
103,a1505,20150318,4169,4192,4161,4192,4161,4170,4173,-22,-19,70052,2923756800,168440
104,a1505,20150319,4170,4173,4181,4189,4151,4177,4173,4,0,72930,3043376420,163540
105,a1505,20150320,4177,4173,4175,4194,4148,4174,4168,1,-5,74576,3108439140,166846
106,a1505,20150323,4174,4168,4175,4197,4160,4164,4179,-4,11,55042,2300727440,174834
107,a1505,20150324,4164,4179,4166,4191,4111,4161,4151,-18,-28,134338,5576885080,173996
108,a1505,20150325,4161,4151,4161,4161,4070,4074,4109,-77,-42,139516,5733284520,180834
109,a1505,20150326,4074,4109,4074,4090,4004,4060,4044,-49,-65,219736,8887018760,187800
110,a1505,20150327,4060,4044,4053,4058,4027,4032,4043,-12,-1,71974,2910423160,184748
111,a1505,20150330,4032,4043,4031,4043,3985,4028,4005,-15,-38,100360,4019740540,186212
112,a1505,20150331,4028,4005,4020,4031,4008,4016,4019,11,14,45186,1816067140,177466
113,a1505,20150401,4016,4019,4010,4058,4005,4035,4034,16,15,103478,4174550680,167666
114,a1505,20150402,4035,4034,4020,4047,4019,4019,4033,-15,-1,44324,1787947400,160484
115,a1505,20150403,4019,4033,4001,4019,3959,3998,3995,-35,-38,97128,3880768920,153460
116,a1505,20150407,3998,3995,3982,4000,3952,3956,3973,-39,-22,34076,1354149220,154172
117,a1505,20150408,3956,3973,3972,3975,3941,3958,3956,-15,-17,48548,1920841320,151524
118,a1505,20150409,3958,3956,3959,3960,3940,3952,3951,-4,-5,35588,1406133600,147844
119,a1505,20150410,3952,3951,3956,3981,3951,3965,3962,14,11,24410,967263200,144604
120,a1505,20150413,3965,3962,3965,4046,3965,4030,4008,68,46,48098,1927857620,142920
121,a1505,20150414,4030,4008,4030,4165,4010,4161,4102,153,94,96274,3949450640,142612
122,a1505,20150415,4161,4102,4153,4248,4153,4220,4216,118,114,118376,4991010660,143104
123,a1505,20150416,4220,4216,4222,4261,4198,4210,4226,-6,10,72658,3070810920,139332
124,a1505,20150417,4210,4226,4206,4222,4057,4057,4148,-169,-78,84100,3488509640,123030
125,a1505,20150420,4057,4148,4010,4045,3900,3900,3962,-248,-186,70944,2811479200,116494
126,a1505,20150421,3900,3962,3848,3920,3830,3908,3877,-54,-85,73556,2852108680,101342
127,a1505,20150422,3908,3877,3908,4032,3902,4027,3962,150,85,73030,2894149080,59244
128,a1505,20150423,4027,3962,4030,4040,3978,4008,4001,46,39,28136,1125979920,50882
129,a1505,20150424,4008,4001,4016,4072,4005,4059,4035,58,34,23966,967191880,46486
130,a1505,20150427,4059,4035,4056,4120,4056,4098,4083,63,48,25410,1037553700,39640
131,a1505,20150428,4098,4083,4087,4102,4059,4084,4090,1,7,5160,211070640,36236
132,a1505,20150429,4084,4090,4078,4094,4077,4093,4083,3,-7,11722,478659660,31382
133,a1505,20150430,4093,4083,4099,4207,4093,4192,4160,109,77,4600,191405120,28408
134,a1505,20150504,4192,4160,4154,4200,4143,4143,4164,-17,4,1874,78033600,26516
135,a1505,20150505,4143,4164,4145,4185,4145,4185,4159,21,-5,558,23209420,25816
136,a1505,20150506,4185,4159,4140,4226,4140,4226,4151,67,-8,7698,319561920,25796
137,a1505,20150507,4226,4151,4160,4160,4151,4151,4156,0,5,4896,203503960,17236
138,a1505,20150508,4151,4156,4156,4170,4131,4160,4158,4,2,3376,140375300,11454
139,a1505,20150511,4160,4158,4151,4151,4151,4151,4151,-7,-7,10,415100,11464
140,a1505,20150512,4151,4151,4208,4222,4208,4222,4216,71,65,116,4891180,10904
141,a1505,20150513,4222,4216,4222,4281,4222,4281,4251,65,35,8,340120,9630
142,a1505,20150514,4281,4251,4250,4274,4250,4274,4250,23,-1,1342,57035960,5162
143,a1505,20150515,4274,4250,0,0,0,4162,4162,-88,-88,0,0,0
144,a1507,20150105,4455,4455,4450,4457,4450,4457,4451,2,-4,8,356140,20
145,a1507,20150106,4457,4451,4462,4462,4462,4462,4462,11,11,2,89240,18
146,a1507,20150107,4462,4462,4486,4486,4486,4486,4486,24,24,2,89720,20
147,a1507,20150108,4486,4486,4427,4467,4427,4440,4444,-46,-42,6,266680,18
148,a1507,20150109,4440,4444,4435,4460,4435,4460,4447,16,3,4,177900,16
149,a1507,20150112,4460,4447,4515,4515,4457,4466,4483,19,36,10,448320,20
150,a1507,20150113,4466,4483,4434,4482,4408,4435,4436,-48,-47,12,532360,22
151,a1507,20150114,4435,4436,0,0,0,4424,4424,-12,-12,0,0,22
152,a1507,20150115,4424,4424,0,0,0,4436,4436,12,12,0,0,22
153,a1507,20150116,4436,4436,0,0,0,4447,4447,11,11,0,0,22
154,a1507,20150119,4447,4447,4496,4503,4448,4448,4490,1,43,12,538840,24
155,a1507,20150120,4448,4490,4434,4476,4429,4476,4446,-14,-44,6,266780,20
156,a1507,20150121,4476,4446,4421,4421,4421,4421,4421,-25,-25,2,88420,20
157,a1507,20150122,4421,4421,0,0,0,4421,4421,0,0,0,0,20
158,a1507,20150123,4421,4421,0,0,0,4421,4421,0,0,0,0,20
159,a1507,20150126,4421,4421,0,0,0,4396,4396,-25,-25,0,0,20
160,a1507,20150127,4396,4396,0,0,0,4396,4396,0,0,0,0,20
161,a1507,20150128,4396,4396,0,0,0,4396,4396,0,0,0,0,20
162,a1507,20150129,4396,4396,4349,4349,4339,4339,4345,-57,-51,6,260740,20
163,a1507,20150130,4339,4345,0,0,0,4341,4341,-4,-4,0,0,20
164,a1507,20150202,4341,4341,0,0,0,4356,4356,15,15,0,0,20
165,a1507,20150203,4356,4356,0,0,0,4394,4394,38,38,0,0,20
166,a1507,20150204,4394,4394,4393,4393,4393,4393,4393,-1,-1,2,87860,18
167,a1507,20150205,4393,4393,4416,4416,4379,4388,4394,-5,1,6,263660,20
168,a1507,20150206,4388,4394,0,0,0,4410,4410,16,16,0,0,20
169,a1507,20150209,4410,4410,4353,4394,4301,4394,4349,-16,-61,6,260960,18
170,a1507,20150210,4394,4349,4380,4380,4380,4380,4380,31,31,4,175200,18
171,a1507,20150211,4380,4380,0,0,0,4380,4380,0,0,0,0,18
172,a1507,20150212,4380,4380,4388,4388,4388,4388,4388,8,8,2,87760,20
173,a1507,20150213,4388,4388,4383,4383,4383,4383,4383,-5,-5,2,87660,18
174,a1507,20150216,4383,4383,0,0,0,4343,4343,-40,-40,0,0,18
175,a1507,20150217,4343,4343,0,0,0,4336,4336,-7,-7,0,0,18
176,a1507,20150225,4336,4336,0,0,0,4289,4289,-47,-47,0,0,18
177,a1507,20150226,4289,4289,4290,4290,4276,4276,4285,-13,-4,6,257120,12
178,a1507,20150227,4276,4285,0,0,0,4319,4319,34,34,0,0,12
179,a1507,20150302,4319,4319,0,0,0,4309,4309,-10,-10,0,0,12
180,a1507,20150303,4309,4309,4298,4298,4298,4298,4298,-11,-11,2,85960,10
181,a1507,20150304,4298,4298,0,0,0,4298,4298,0,0,0,0,10
182,a1507,20150305,4298,4298,0,0,0,4248,4248,-50,-50,0,0,10
183,a1507,20150306,4248,4248,0,0,0,4240,4240,-8,-8,0,0,10
184,a1507,20150309,4240,4240,0,0,0,4249,4249,9,9,0,0,10
185,a1507,20150310,4249,4249,0,0,0,4213,4213,-36,-36,0,0,10
186,a1507,20150311,4213,4213,0,0,0,4230,4230,17,17,0,0,10
187,a1507,20150312,4230,4230,0,0,0,4234,4234,4,4,0,0,10
188,a1507,20150313,4234,4234,0,0,0,4224,4224,-10,-10,0,0,10
189,a1507,20150316,4224,4224,0,0,0,4224,4224,0,0,0,0,10
190,a1507,20150317,4224,4224,0,0,0,4254,4254,30,30,0,0,10
191,a1507,20150318,4254,4254,4159,4222,4159,4212,4197,-42,-57,6,251860,10
192,a1507,20150319,4212,4197,4228,4228,4228,4228,4228,31,31,2,84560,10
193,a1507,20150320,4228,4228,4218,4226,4207,4211,4216,-17,-12,24,1011940,10
194,a1507,20150323,4211,4216,4223,4223,4223,4223,4223,7,7,2,84460,8
195,a1507,20150324,4223,4223,0,0,0,4223,4223,0,0,0,0,8
196,a1507,20150325,4223,4223,4067,4148,4067,4098,4104,-125,-119,6,246260,8
197,a1507,20150326,4098,4104,0,0,0,4104,4104,0,0,0,0,8
198,a1507,20150327,4104,4104,4087,4087,4087,4087,4087,-17,-17,2,81740,10
199,a1507,20150330,4087,4087,0,0,0,4084,4084,-3,-3,0,0,10
200,a1507,20150331,4084,4084,0,0,0,4084,4084,0,0,0,0,10
201,a1507,20150401,4084,4084,0,0,0,4084,4084,0,0,0,0,10
202,a1507,20150402,4084,4084,0,0,0,4084,4084,0,0,0,0,10
203,a1507,20150403,4084,4084,3995,4059,3995,4041,4035,-43,-49,10,403540,8
204,a1507,20150407,4041,4035,4072,4072,4011,4052,4045,17,10,6,242700,10
205,a1507,20150408,4052,4045,0,0,0,4028,4028,-17,-17,0,0,10
206,a1507,20150409,4028,4028,3974,4036,3973,3979,3992,-49,-36,18,718600,10
207,a1507,20150410,3979,3992,4023,4023,4005,4005,4017,13,25,6,241020,10
208,a1507,20150413,4005,4017,3865,4042,3865,4026,3966,9,-51,10,396680,10
209,a1507,20150414,4026,3966,4053,4119,4048,4097,4079,131,113,28,1142160,12
210,a1507,20150415,4097,4079,4097,4141,4097,4118,4119,39,40,56,2307000,8
211,a1507,20150416,4118,4119,0,0,0,4128,4128,9,9,0,0,8
212,a1507,20150417,4128,4128,4115,4153,4097,4137,4124,9,-4,82,3381760,14
213,a1507,20150420,4137,4124,4036,4050,3960,4050,4029,-74,-95,42,1692420,42
214,a1507,20150421,4050,4029,3955,4019,3954,4014,3968,-15,-61,36,1428720,42
215,a1507,20150422,4014,3968,3888,4101,3888,4055,3994,87,26,90,3595060,28
216,a1507,20150423,4055,3994,4070,4070,4036,4036,4057,42,63,6,243420,28
217,a1507,20150424,4036,4057,4050,4121,4050,4078,4086,21,29,18,735580,26
218,a1507,20150427,4078,4086,4023,4143,4023,4143,4115,57,29,32,1316800,34
219,a1507,20150428,4143,4115,4131,4131,4131,4131,4131,16,16,16,660960,32
220,a1507,20150429,4131,4131,4179,4179,4128,4128,4153,-3,22,4,166140,30
221,a1507,20150430,4128,4153,4238,4280,4176,4280,4225,127,72,12,507000,30
222,a1507,20150504,4280,4225,4160,4230,4158,4215,4201,-10,-24,14,588260,24
223,a1507,20150505,4215,4201,4150,4150,4149,4149,4149,-52,-52,4,165980,26
224,a1507,20150506,4149,4149,4191,4228,4164,4194,4193,45,44,64,2684020,22
225,a1507,20150507,4194,4193,4189,4206,4189,4195,4193,2,0,30,1258100,14
226,a1507,20150508,4195,4193,4213,4213,4184,4184,4194,-9,1,6,251640,12
227,a1507,20150511,4184,4194,0,0,0,4187,4187,-7,-7,0,0,12
228,a1507,20150512,4187,4187,4319,4337,4240,4276,4281,89,94,22,941920,10
229,a1507,20150513,4276,4281,4344,4344,4273,4280,4298,-1,17,28,1203440,6
230,a1507,20150514,4280,4298,0,0,0,4297,4297,-1,-1,0,0,6
231,a1507,20150515,4297,4297,4261,4261,4261,4261,4261,-36,-36,2,85220,6
232,a1507,20150518,4261,4261,4294,4347,4253,4270,4289,9,28,14,600540,6
233,a1507,20150519,4270,4289,4337,4337,4214,4317,4274,28,-15,44,1880640,8
234,a1507,20150520,4317,4274,4240,4278,4170,4170,4229,-104,-45,6,253760,8
235,a1507,20150521,4170,4229,4225,4280,4184,4279,4257,50,28,22,936660,20
236,a1507,20150522,4279,4257,4268,4368,4267,4354,4303,97,46,24,1032800,10
237,a1507,20150525,4354,4303,4462,4462,4348,4359,4386,56,83,38,1666920,10
238,a1507,20150526,4359,4386,4420,4420,4318,4329,4357,-57,-29,10,435760,10
239,a1507,20150527,4329,4357,0,0,0,4357,4357,0,0,0,0,10
240,a1507,20150528,4357,4357,4417,4417,4325,4325,4361,-32,4,34,1482980,8
241,a1507,20150529,4325,4361,4347,4347,4293,4339,4313,-22,-48,10,431340,10
242,a1507,20150601,4339,4313,4375,4375,4375,4375,4375,62,62,2,87500,8
243,a1507,20150602,4375,4375,0,0,0,4375,4375,0,0,0,0,8
244,a1507,20150603,4375,4375,4282,4363,4257,4348,4320,-27,-55,10,432040,8
245,a1507,20150604,4348,4320,4284,4321,4205,4311,4265,-9,-55,24,1023640,8
246,a1507,20150605,4311,4265,4433,4433,4161,4161,4363,-104,98,8,349040,4
247,a1507,20150608,4161,4363,0,0,0,4363,4363,0,0,0,0,4
248,a1507,20150609,4363,4363,4537,4537,4189,4199,4261,-164,-102,60,2556600,16
249,a1507,20150610,4199,4261,4237,4267,4237,4267,4252,6,-9,8,340160,8
250,a1507,20150611,4267,4252,4248,4422,4167,4167,4286,-85,34,10,428660,4
251,a1507,20150612,4167,4286,4249,4457,4115,4115,4192,-171,-94,28,1174000,12
252,a1507,20150615,4115,4192,4350,4350,4081,4088,4163,-104,-29,20,832640,10
253,a1507,20150616,4088,4163,4245,4304,4073,4096,4179,-67,16,8,334360,10
254,a1507,20150617,4096,4179,0,0,0,4179,4179,0,0,0,0,10
255,a1507,20150618,4179,4179,0,0,0,4179,4179,0,0,0,0,10
256,a1507,20150619,4179,4179,4333,4333,4016,4016,4201,-163,22,12,504140,10
257,a1507,20150623,4016,4201,4300,4300,4037,4121,4145,-80,-56,22,912020,14
258,a1507,20150624,4121,4145,4285,4310,3980,4189,4174,44,29,26,1085420,20
259,a1507,20150625,4189,4174,4170,4250,4082,4134,4133,-40,-41,50,2066960,20
260,a1507,20150626,4134,4133,4130,4130,4070,4070,4106,-63,-27,50,2053000,22
261,a1507,20150629,4070,4106,4098,4098,4018,4020,4055,-86,-51,40,1622380,28
262,a1507,20150630,4020,4055,4035,4217,3893,3971,4075,-84,20,80,3260200,22
263,a1507,20150701,3971,4075,4245,4245,4245,4245,4245,170,170,2,84900,20
264,a1507,20150702,4245,4245,0,0,0,4220,4220,-25,-25,0,0,10
265,a1507,20150703,4220,4220,0,0,0,4180,4180,-40,-40,0,0,10
266,a1507,20150706,4180,4180,4020,4020,4020,4020,4020,-160,-160,2,80400,12
267,a1507,20150707,4020,4020,3980,3980,3980,3980,3980,-40,-40,2,79600,2
268,a1507,20150708,3980,3980,0,0,0,3980,3980,0,0,0,0,2
269,a1507,20150709,3980,3980,0,0,0,3980,3980,0,0,0,0,2
270,a1507,20150710,3980,3980,0,0,0,3980,3980,0,0,0,0,2
271,a1507,20150713,3980,3980,0,0,0,3980,3980,0,0,0,0,2
272,a1507,20150714,3980,3980,0,0,0,4081,4081,101,101,2,81620,0
273,a1509,20150105,4442,4442,4410,4435,4385,4433,4425,-9,-17,10920,483218560,67760
274,a1509,20150106,4433,4425,4437,4475,4427,4443,4450,18,25,20078,893547560,66150
275,a1509,20150107,4443,4450,4454,4465,4424,4441,4443,-9,-7,10520,467424800,65282
276,a1509,20150108,4441,4443,4444,4450,4428,4437,4440,-6,-3,12362,548978060,64012
277,a1509,20150109,4437,4440,4435,4457,4426,4439,4442,-1,2,15374,683039980,64318
278,a1509,20150112,4439,4442,4440,4460,4433,4438,4450,-4,8,9726,432816880,63566
279,a1509,20150113,4438,4450,4440,4440,4393,4410,4408,-40,-42,7722,340460400,64870
280,a1509,20150114,4410,4408,4385,4416,4381,4391,4398,-17,-10,11582,509475160,65246
281,a1509,20150115,4391,4398,4420,4424,4384,4417,4404,19,6,12020,529392280,65168
282,a1509,20150116,4417,4404,4418,4443,4396,4421,4416,17,12,13870,612501920,64896
283,a1509,20150119,4421,4416,4420,4440,4401,4418,4419,2,3,13120,579889000,66330
284,a1509,20150120,4418,4419,4420,4515,4390,4391,4412,-28,-7,12764,563193120,68568
285,a1509,20150121,4391,4412,4391,4414,4350,4380,4387,-32,-25,19256,844883600,67976
286,a1509,20150122,4380,4387,4380,4393,4361,4367,4374,-20,-13,12010,525396760,67638
287,a1509,20150123,4367,4374,4382,4382,4345,4349,4356,-25,-18,11154,485903420,67986
288,a1509,20150126,4349,4356,4344,4370,4317,4325,4340,-31,-16,15736,682974260,68610
289,a1509,20150127,4325,4340,4325,4380,4323,4364,4357,24,17,15976,696163100,65274
290,a1509,20150128,4364,4357,4359,4375,4343,4354,4361,-3,4,9574,417616420,65226
291,a1509,20150129,4354,4361,4345,4364,4308,4331,4325,-30,-36,30966,1339423120,67838
292,a1509,20150130,4331,4325,4326,4343,4318,4318,4331,-7,6,13986,605837680,65722
293,a1509,20150202,4318,4331,4330,4359,4321,4355,4340,24,9,20110,872888700,66306
294,a1509,20150203,4355,4340,4359,4386,4358,4383,4371,43,31,14102,616515260,64334
295,a1509,20150204,4383,4371,4321,4398,4321,4377,4384,6,13,11528,505408360,62034
296,a1509,20150205,4377,4384,4383,4383,4346,4371,4366,-13,-18,6406,279699440,61890
297,a1509,20150206,4371,4366,4373,4392,4369,4380,4379,14,13,6462,283004280,61058
298,a1509,20150209,4380,4379,4380,4385,4347,4369,4359,-10,-20,8782,382862120,61576
299,a1509,20150210,4369,4359,4364,4375,4344,4348,4356,-11,-3,5856,255140320,62594
300,a1509,20150211,4348,4356,4354,4363,4343,4363,4352,7,-4,4684,203872340,62106
301,a1509,20150212,4363,4352,4353,4378,4351,4364,4363,12,11,5864,255875940,61226
302,a1509,20150213,4364,4363,4365,4377,4360,4364,4369,1,6,12336,539023860,58636
303,a1509,20150216,4364,4369,4361,4373,4320,4327,4340,-42,-29,12644,548808060,58396
304,a1509,20150217,4327,4340,4328,4342,4321,4340,4331,0,-9,5664,245315560,58778
305,a1509,20150225,4340,4331,4349,4355,4289,4292,4315,-39,-16,16188,698540420,60446
306,a1509,20150226,4292,4315,4295,4298,4256,4288,4279,-27,-36,29290,1253446580,66524
307,a1509,20150227,4288,4279,4292,4335,4265,4319,4304,40,25,31448,1353654420,63746
308,a1509,20150302,4319,4304,4325,4342,4306,4325,4323,21,19,35860,1550557380,66934
309,a1509,20150303,4325,4323,4325,4332,4294,4318,4316,-5,-7,26386,1138826140,67488
310,a1509,20150304,4318,4316,4321,4325,4303,4317,4316,1,0,11090,478752040,66012
311,a1509,20150305,4317,4316,4304,4317,4236,4239,4263,-77,-53,51724,2205161640,80120
312,a1509,20150306,4239,4263,4235,4255,4225,4226,4239,-37,-24,28562,1210831980,83880
313,a1509,20150309,4226,4239,4225,4254,4210,4235,4233,-4,-6,34192,1447681780,82110
314,a1509,20150310,4235,4233,4233,4255,4180,4181,4212,-52,-21,50302,2118901680,98708
315,a1509,20150311,4181,4212,4188,4255,4171,4241,4223,29,11,57902,2445755880,85200
316,a1509,20150312,4241,4223,4241,4244,4221,4234,4233,11,10,18750,793726400,83262
317,a1509,20150313,4234,4233,4233,4247,4210,4215,4225,-18,-8,28712,1213126480,84978
318,a1509,20150316,4215,4225,4201,4236,4194,4231,4215,6,-10,32548,1372068960,82388
319,a1509,20150317,4231,4215,4238,4280,4224,4225,4248,10,33,28888,1227227400,82044
320,a1509,20150318,4225,4248,4220,4248,4213,4215,4227,-33,-21,29422,1243831220,84178
321,a1509,20150319,4215,4227,4221,4236,4203,4215,4220,-12,-7,32680,1379127620,89514
322,a1509,20150320,4215,4220,4202,4220,4191,4206,4205,-14,-15,34488,1450460240,94754
323,a1509,20150323,4206,4205,4206,4232,4200,4210,4219,5,14,32920,1388895160,94414
324,a1509,20150324,4210,4219,4214,4236,4147,4212,4195,-7,-24,102380,4295325360,99368
325,a1509,20150325,4212,4195,4203,4212,4143,4145,4172,-50,-23,69736,2909861600,111320
326,a1509,20150326,4145,4172,4135,4163,4122,4152,4142,-20,-30,91886,3806472260,121606
327,a1509,20150327,4152,4142,4138,4158,4132,4136,4143,-6,1,40228,1666859220,121064
328,a1509,20150330,4136,4143,4132,4141,4087,4134,4111,-9,-32,67804,2787685380,123730
329,a1509,20150331,4134,4111,4127,4136,4106,4110,4117,-1,6,38682,1592873060,122934
330,a1509,20150401,4110,4117,4105,4156,4104,4132,4134,15,17,50332,2081078000,119308
331,a1509,20150402,4132,4134,4139,4152,4102,4102,4126,-32,-8,47784,1971941840,124314
332,a1509,20150403,4102,4126,4092,4116,4050,4084,4081,-42,-45,69132,2821617380,133212
333,a1509,20150407,4084,4081,4078,4092,4041,4043,4058,-38,-23,46884,1902902000,147266
334,a1509,20150408,4043,4058,4020,4043,4011,4027,4026,-31,-32,69238,2787807700,154046
335,a1509,20150409,4027,4026,4030,4035,3991,3995,4009,-31,-17,72656,2913117920,161072
336,a1509,20150410,3995,4009,3992,4038,3992,4006,4010,-3,1,61318,2459252360,155070
337,a1509,20150413,4006,4010,4014,4057,4005,4048,4032,38,22,101382,4088592800,145654
338,a1509,20150414,4048,4032,4045,4096,4040,4085,4069,53,37,141336,5751788700,165560
339,a1509,20150415,4085,4069,4089,4131,4078,4098,4102,29,33,138756,5692921680,153606
340,a1509,20150416,4098,4102,4093,4118,4085,4092,4099,-10,-3,70984,2910241360,155802
341,a1509,20150417,4092,4099,4099,4099,4038,4040,4065,-59,-34,171152,6958920580,184052
342,a1509,20150420,4040,4065,4038,4059,3966,4000,4005,-65,-60,387608,15525899800,194694
343,a1509,20150421,4000,4005,3996,4069,3983,4060,4037,55,32,177818,7180137140,197532
344,a1509,20150422,4060,4037,4060,4181,4054,4160,4108,123,71,290722,11945633700,197214
345,a1509,20150423,4160,4108,4152,4179,4124,4154,4151,46,43,177206,7356350100,197462
346,a1509,20150424,4154,4151,4168,4218,4152,4217,4191,66,40,229592,9622915680,205414
347,a1509,20150427,4217,4191,4217,4250,4194,4226,4221,35,30,205434,8673090140,195272
348,a1509,20150428,4226,4221,4226,4235,4190,4220,4218,-1,-3,115740,4882635260,189742
349,a1509,20150429,4220,4218,4228,4238,4209,4225,4222,7,4,91586,3867487320,185758
350,a1509,20150430,4225,4222,4223,4335,4221,4320,4296,98,74,257472,11062435060,189604
351,a1509,20150504,4320,4296,4302,4308,4256,4272,4272,-24,-24,123328,5269786400,170686
352,a1509,20150505,4272,4272,4272,4296,4232,4272,4273,0,1,105224,4496442380,161102
353,a1509,20150506,4272,4273,4277,4331,4261,4306,4296,33,23,127526,5479352740,158448
354,a1509,20150507,4306,4296,4307,4315,4265,4293,4291,-3,-5,86592,3716475740,157760
355,a1509,20150508,4293,4291,4293,4298,4243,4280,4268,-11,-23,104380,4455877220,157466
356,a1509,20150511,4280,4268,4287,4365,4272,4362,4330,94,62,209584,9075482940,175828
357,a1509,20150512,4362,4330,4352,4386,4343,4361,4360,31,30,157564,6870039380,175470
358,a1509,20150513,4361,4360,4366,4377,4344,4367,4362,7,2,129932,5667963600,172936
359,a1509,20150514,4367,4362,4375,4382,4321,4359,4351,-3,-11,114750,4993419360,165500
360,a1509,20150515,4359,4351,4360,4374,4351,4362,4359,11,8,70112,3056848300,163424
361,a1509,20150518,4362,4359,4361,4369,4335,4358,4352,-1,-7,78180,3402702680,160410
362,a1509,20150519,4358,4352,4367,4367,4321,4322,4342,-30,-10,70084,3043075480,157178
363,a1509,20150520,4322,4342,4320,4329,4270,4295,4295,-47,-47,139968,6012170540,147242
364,a1509,20150521,4295,4295,4295,4328,4275,4295,4305,0,10,100330,4319777720,140030
365,a1509,20150522,4295,4305,4295,4475,4289,4447,4393,142,88,339348,14909064640,169896
366,a1509,20150525,4447,4393,4447,4463,4402,4416,4431,23,38,236628,10486847920,160274
367,a1509,20150526,4416,4431,4426,4450,4406,4415,4424,-16,-7,117050,5179161320,158210
368,a1509,20150527,4415,4424,4406,4424,4371,4388,4395,-36,-29,121044,5320807480,147186
369,a1509,20150528,4388,4395,4392,4440,4377,4393,4411,-2,16,137656,6072178420,145280
370,a1509,20150529,4393,4411,4400,4412,4372,4409,4390,-2,-21,83516,3666602720,142738
371,a1509,20150601,4409,4390,4412,4419,4308,4323,4370,-67,-20,129076,5641852420,140206
372,a1509,20150602,4323,4370,4325,4370,4321,4351,4344,-19,-26,87606,3805608560,132726
373,a1509,20150603,4351,4344,4359,4387,4349,4360,4366,16,22,77534,3385903160,130696
374,a1509,20150604,4360,4366,4357,4365,4302,4327,4329,-39,-37,90724,3928068500,124978
375,a1509,20150605,4327,4329,4322,4337,4252,4256,4293,-73,-36,92178,3957368000,122172
376,a1509,20150608,4256,4293,4251,4284,4240,4248,4263,-45,-30,76236,3250578880,119098
377,a1509,20150609,4248,4263,4251,4295,4244,4246,4272,-17,9,85082,3634933860,116982
378,a1509,20150610,4246,4272,4250,4272,4240,4262,4257,-10,-15,68302,2907873320,113828
379,a1509,20150611,4262,4257,4275,4284,4245,4256,4264,-1,7,61360,2616977080,114468
380,a1509,20150612,4256,4264,4245,4260,4147,4162,4190,-102,-74,169804,7115904760,98898
381,a1509,20150615,4162,4190,4176,4190,4141,4148,4165,-42,-25,72524,3021142780,90668
382,a1509,20150616,4148,4165,4145,4218,4135,4193,4184,28,19,93544,3914474660,75454
383,a1509,20150617,4193,4184,4195,4255,4164,4244,4221,60,37,98140,4143280160,71322
384,a1509,20150618,4244,4221,4238,4295,4236,4250,4263,29,42,101838,4341486940,65562
385,a1509,20150619,4250,4263,4250,4260,4206,4237,4231,-26,-32,75214,3183013520,66814
386,a1509,20150623,4237,4231,4250,4290,4249,4264,4265,33,34,58438,2492752600,70724
387,a1509,20150624,4264,4265,4252,4262,4208,4226,4230,-39,-35,77402,3274204120,68640
388,a1509,20150625,4226,4230,4233,4257,4207,4221,4229,-9,-1,55178,2333727580,67324
389,a1509,20150626,4221,4229,4233,4258,4182,4191,4225,-38,-4,94360,3986762560,64146
390,a1509,20150629,4191,4225,4212,4227,4151,4173,4178,-52,-47,87582,3660038220,62754
391,a1509,20150630,4173,4178,4173,4188,4130,4136,4153,-42,-25,64084,2661810760,57012
392,a1509,20150701,4136,4153,4137,4244,4106,4174,4179,21,26,112474,4700553500,61480
393,a1509,20150702,4174,4179,4174,4180,4138,4154,4155,-25,-24,51470,2138754000,51868
394,a1509,20150703,4154,4155,4151,4163,4125,4131,4146,-24,-9,52506,2177098500,55808
395,a1509,20150706,4131,4146,4140,4140,4057,4077,4096,-69,-50,68748,2816378480,52860
396,a1509,20150707,4077,4096,4093,4093,4040,4053,4060,-43,-36,54192,2200579740,50100
397,a1509,20150708,4053,4060,4053,4053,3898,3910,3943,-150,-117,134730,5312618600,41974
398,a1509,20150709,3910,3943,3923,4100,3910,4100,4032,157,89,109362,4410319660,36840
399,a1509,20150710,4100,4032,4116,4240,4115,4198,4196,166,164,146080,6130215400,42724
400,a1509,20150713,4198,4196,4220,4220,4146,4182,4178,-14,-18,50178,2096490400,40254
401,a1509,20150714,4182,4178,4178,4208,4155,4183,4186,5,8,37210,1557728120,38488
402,a1509,20150715,4183,4186,4175,4187,4126,4141,4158,-45,-28,19312,803068580,36806
403,a1509,20150716,4141,4158,4136,4150,4058,4113,4101,-45,-57,22898,939177540,35890
404,a1509,20150717,4113,4101,4121,4148,4083,4115,4114,14,13,20452,841437740,34758
405,a1509,20150720,4115,4114,4100,4122,4050,4062,4082,-52,-32,16966,692577720,32686
406,a1509,20150721,4062,4082,4060,4089,4052,4059,4071,-23,-11,7322,298082060,32996
407,a1509,20150722,4059,4071,4068,4068,4015,4047,4043,-24,-28,17424,704517780,35238
408,a1509,20150723,4047,4043,4020,4062,4003,4047,4032,4,-11,33856,1365157920,36908
409,a1509,20150724,4047,4032,4059,4080,4035,4061,4058,29,26,10754,436419240,34794
410,a1509,20150727,4061,4058,4055,4073,4019,4024,4044,-34,-14,9888,399921840,32894
411,a1509,20150728,4024,4044,4013,4064,3975,4064,4028,20,-16,13512,544340160,33614
412,a1509,20150729,4064,4028,4069,4131,4059,4129,4107,101,79,19030,781627040,30172
413,a1509,20150730,4129,4107,4124,4175,4115,4135,4148,28,41,22384,928519280,31190
414,a1509,20150731,4135,4148,4141,4162,4128,4155,4144,7,-4,8690,360188340,30908
415,a1509,20150803,4155,4144,4152,4167,4096,4130,4132,-14,-12,10050,415320080,30128
416,a1509,20150804,4130,4132,4127,4159,4110,4154,4140,22,8,8730,361491620,30334
417,a1509,20150805,4154,4140,4160,4166,4132,4144,4148,4,8,6628,274959480,30130
418,a1509,20150806,4144,4148,4155,4229,4145,4212,4189,64,41,25900,1085043260,24648
419,a1509,20150807,4212,4189,4210,4222,4173,4211,4195,22,6,10464,439019460,22834
420,a1509,20150810,4211,4195,4198,4255,4198,4233,4228,38,33,11202,473655420,21344
421,a1509,20150811,4233,4228,4207,4268,4207,4249,4251,21,23,9264,393825880,20352
422,a1509,20150812,4249,4251,4240,4266,4230,4262,4247,11,-4,5846,248280220,19240
423,a1509,20150813,4262,4247,4270,4295,4179,4230,4238,-17,-9,8540,361991660,18238
424,a1509,20150814,4230,4238,4228,4261,4220,4250,4239,12,1,3818,161878800,17636
425,a1509,20150817,4250,4239,4250,4278,4247,4261,4261,22,22,2670,113778480,17376
426,a1509,20150818,4261,4261,4274,4279,4202,4226,4241,-35,-20,3506,148722660,17572
427,a1509,20150819,4226,4241,4220,4224,4186,4199,4199,-42,-42,7202,302431740,17848
428,a1509,20150820,4199,4199,4210,4211,4150,4168,4176,-31,-23,2358,98490460,17168
429,a1509,20150821,4168,4176,4163,4197,4157,4167,4170,-9,-6,1600,66724000,16328
430,a1509,20150824,4167,4170,4162,4162,4069,4082,4104,-88,-66,6582,270163000,15236
431,a1509,20150825,4082,4104,4050,4129,4045,4095,4095,-9,-9,3824,156620020,12330
432,a1509,20150826,4095,4095,4159,4159,4085,4086,4112,-9,17,638,26236280,12254
433,a1509,20150827,4086,4112,4112,4112,4050,4091,4072,-21,-40,6430,261843640,11058
434,a1509,20150828,4091,4072,4090,4132,4050,4057,4079,-15,7,3192,130204180,9604
435,a1509,20150831,4057,4079,4057,4130,4046,4062,4063,-17,-16,2686,109141440,7594
436,a1509,20150901,4062,4063,4050,4073,4050,4059,4062,-4,-1,1014,41198280,560
437,a1509,20150902,4059,4062,4060,4060,4050,4050,4058,-12,-4,234,9497720,544
438,a1509,20150907,4050,4058,4029,4045,4008,4008,4032,-50,-26,20,806400,554
439,a1509,20150908,4008,4032,3996,4012,3995,4012,3996,-20,-36,46,1838360,570
440,a1509,20150909,4012,3996,4014,4014,4014,4014,4014,18,18,58,2328580,558
441,a1509,20150910,4014,4014,4016,4028,4006,4012,4015,-2,1,288,11566020,518
442,a1509,20150911,4012,4015,0,0,0,4038,4038,23,23,0,0,518
443,a1509,20150914,4038,4038,0,0,0,4027,4027,-11,-11,0,0,518
444,a1509,20150915,4027,4027,0,0,0,4022,4022,-5,-5,0,0,518
445,a1509,20150916,4022,4022,0,0,0,4050,4050,28,28,0,0,0
446,a1511,20150105,4422,4422,4390,4405,4390,4405,4395,-17,-27,6,263700,128
447,a1511,20150106,4405,4395,0,0,0,4395,4395,0,0,0,0,128
448,a1511,20150107,4395,4395,4450,4450,4399,4399,4416,4,21,8,353280,128
449,a1511,20150108,4399,4416,0,0,0,4414,4414,-2,-2,0,0,128
450,a1511,20150109,4414,4414,0,0,0,4415,4415,1,1,0,0,128
451,a1511,20150112,4415,4415,4423,4424,4376,4401,4402,-14,-13,28,1232720,128
452,a1511,20150113,4401,4402,0,0,0,4398,4398,-4,-4,0,0,128
453,a1511,20150114,4398,4398,0,0,0,4385,4385,-13,-13,0,0,128
454,a1511,20150115,4385,4385,0,0,0,4385,4385,0,0,0,0,128
455,a1511,20150116,4385,4385,4378,4380,4377,4377,4378,-8,-7,16,700560,130
456,a1511,20150119,4377,4378,4400,4400,4364,4364,4382,-14,4,4,175280,130
457,a1511,20150120,4364,4382,4360,4360,4359,4359,4359,-23,-23,8,348760,130
458,a1511,20150121,4359,4359,4306,4330,4303,4312,4310,-47,-49,18,775840,128
459,a1511,20150122,4312,4310,0,0,0,4298,4298,-12,-12,0,0,128
460,a1511,20150123,4298,4298,0,0,0,4281,4281,-17,-17,0,0,128
461,a1511,20150126,4281,4281,4286,4286,4214,4252,4250,-29,-31,10,425060,128
462,a1511,20150127,4252,4250,0,0,0,4271,4271,21,21,0,0,128
463,a1511,20150128,4271,4271,4280,4280,4280,4280,4280,9,9,2,85600,128
464,a1511,20150129,4280,4280,4200,4264,4200,4264,4250,-16,-30,12,510080,128
465,a1511,20150130,4264,4250,4264,4264,4264,4264,4264,14,14,2,85280,128
466,a1511,20150202,4264,4264,0,0,0,4264,4264,0,0,0,0,128
467,a1511,20150203,4264,4264,0,0,0,4309,4309,45,45,0,0,128
468,a1511,20150204,4309,4309,4317,4321,4317,4318,4318,9,9,8,345500,128
469,a1511,20150205,4318,4318,0,0,0,4300,4300,-18,-18,0,0,128
470,a1511,20150206,4300,4300,4316,4321,4308,4321,4313,21,13,26,1121420,134
471,a1511,20150209,4321,4313,0,0,0,4313,4313,0,0,0,0,134
472,a1511,20150210,4313,4313,4307,4308,4300,4308,4302,-5,-11,16,688420,134
473,a1511,20150211,4308,4302,0,0,0,4302,4302,0,0,0,0,134
474,a1511,20150212,4302,4302,4299,4299,4287,4295,4293,-7,-9,6,257620,132
475,a1511,20150213,4295,4293,4296,4296,4292,4292,4295,-1,2,8,343600,130
476,a1511,20150216,4292,4295,4295,4298,4288,4288,4292,-7,-3,8,343380,128
477,a1511,20150217,4288,4292,4267,4268,4237,4268,4259,-24,-33,16,681540,128
478,a1511,20150225,4268,4259,4249,4249,4249,4249,4249,-10,-10,2,84980,128
479,a1511,20150226,4249,4249,4204,4251,4201,4246,4224,-3,-25,32,1351780,134
480,a1511,20150227,4246,4224,4257,4281,4252,4252,4262,28,38,8,341000,132
481,a1511,20150302,4252,4262,4296,4308,4279,4308,4291,46,29,64,2746840,134
482,a1511,20150303,4308,4291,4269,4283,4269,4283,4272,-8,-19,8,341800,134
483,a1511,20150304,4283,4272,4317,4317,4303,4303,4310,31,38,4,172400,136
484,a1511,20150305,4303,4310,4268,4268,4201,4259,4242,-51,-68,16,678720,134
485,a1511,20150306,4259,4242,4231,4248,4231,4248,4239,6,-3,4,169580,134
486,a1511,20150309,4248,4239,4256,4256,4256,4256,4256,17,17,2,85120,134
487,a1511,20150310,4256,4256,4264,4264,4239,4239,4243,-17,-13,22,933600,136
488,a1511,20150311,4239,4243,4285,4324,4266,4266,4289,23,46,14,600540,128
489,a1511,20150312,4266,4289,0,0,0,4299,4299,10,10,0,0,128
490,a1511,20150313,4299,4299,4293,4293,4269,4269,4281,-30,-18,12,513720,126
491,a1511,20150316,4269,4281,0,0,0,4281,4281,0,0,0,0,126
492,a1511,20150317,4281,4281,4286,4286,4285,4285,4285,4,4,12,514280,122
493,a1511,20150318,4285,4285,0,0,0,4285,4285,0,0,0,0,122
494,a1511,20150319,4285,4285,0,0,0,4285,4285,0,0,0,0,122
495,a1511,20150320,4285,4285,0,0,0,4255,4255,-30,-30,0,0,122
496,a1511,20150323,4255,4255,4263,4277,4262,4277,4267,22,12,6,256040,126
497,a1511,20150324,4277,4267,4258,4258,4258,4258,4258,-9,-9,2,85160,124
498,a1511,20150325,4258,4258,4256,4256,4256,4256,4256,-2,-2,2,85120,126
499,a1511,20150326,4256,4256,4228,4228,4188,4220,4204,-36,-52,20,840940,132
500,a1511,20150327,4220,4204,0,0,0,4205,4205,1,1,0,0,132
501,a1511,20150330,4205,4205,4244,4244,4172,4235,4209,30,4,12,505080,134
502,a1511,20150331,4235,4209,0,0,0,4215,4215,6,6,0,0,134
503,a1511,20150401,4215,4215,4232,4283,4227,4245,4251,30,36,16,680220,134
504,a1511,20150402,4245,4251,4240,4240,4239,4239,4239,-12,-12,28,1187160,160
505,a1511,20150403,4239,4239,4144,4158,4144,4158,4151,-81,-88,4,166040,160
506,a1511,20150407,4158,4151,4194,4194,4130,4130,4147,-21,-4,14,580680,152
507,a1511,20150408,4130,4147,4119,4119,4073,4080,4091,-67,-56,50,2045500,144
508,a1511,20150409,4080,4091,0,0,0,4058,4058,-33,-33,0,0,144
509,a1511,20150410,4058,4058,4025,4062,4025,4062,4044,4,-14,30,1213260,128
510,a1511,20150413,4062,4044,0,0,0,4087,4087,43,43,0,0,128
511,a1511,20150414,4087,4087,4111,4135,4111,4135,4129,48,42,10,412960,130
512,a1511,20150415,4135,4129,4113,4180,4113,4151,4139,22,10,36,1490340,132
513,a1511,20150416,4151,4139,0,0,0,4136,4136,-3,-3,0,0,132
514,a1511,20150417,4136,4136,4118,4149,4076,4148,4120,12,-16,16,659220,136
515,a1511,20150420,4148,4120,4077,4085,4030,4085,4069,-35,-51,14,569680,134
516,a1511,20150421,4085,4069,0,0,0,4101,4101,32,32,0,0,134
517,a1511,20150422,4101,4101,4167,4264,4167,4264,4198,163,97,34,1427500,156
518,a1511,20150423,4264,4198,4249,4249,4093,4207,4175,9,-23,60,2505080,134
519,a1511,20150424,4207,4175,4215,4250,4215,4218,4234,43,59,34,1439840,124
520,a1511,20150427,4218,4234,4230,4248,4230,4248,4239,14,5,4,169560,122
521,a1511,20150428,4248,4239,0,0,0,4236,4236,-3,-3,0,0,122
522,a1511,20150429,4236,4236,4253,4259,4204,4251,4238,15,2,26,1102020,128
523,a1511,20150430,4251,4238,4297,4347,4294,4347,4311,109,73,22,948620,134
524,a1511,20150504,4347,4311,4290,4298,4290,4296,4294,-15,-17,24,1030760,158
525,a1511,20150505,4296,4294,4320,4323,4301,4320,4318,26,24,24,1036420,174
526,a1511,20150506,4320,4318,4310,4346,4310,4346,4328,28,10,6,259700,172
527,a1511,20150507,4346,4328,4312,4330,4311,4330,4317,2,-11,56,2417700,126
528,a1511,20150508,4330,4317,4312,4312,4305,4305,4308,-12,-9,4,172340,124
529,a1511,20150511,4305,4308,4316,4383,4305,4383,4339,75,31,46,1996000,120
530,a1511,20150512,4383,4339,4379,4419,4364,4400,4391,61,52,26,1141840,120
531,a1511,20150513,4400,4391,4410,4410,4400,4400,4407,9,16,8,352600,122
532,a1511,20150514,4400,4407,4414,4429,4385,4394,4405,-13,-2,78,3436100,120
533,a1511,20150515,4394,4405,4398,4400,4398,4400,4398,-5,-7,6,263920,120
534,a1511,20150518,4400,4398,4393,4393,4393,4393,4393,-5,-5,2,87860,122
535,a1511,20150519,4393,4393,0,0,0,4383,4383,-10,-10,0,0,122
536,a1511,20150520,4383,4383,4361,4365,4353,4353,4359,-30,-24,6,261580,124
537,a1511,20150521,4353,4359,0,0,0,4369,4369,10,10,0,0,124
538,a1511,20150522,4369,4369,0,0,0,4458,4458,89,89,0,0,124
539,a1511,20150525,4458,4458,4451,4496,4451,4496,4476,38,18,6,268600,124
540,a1511,20150526,4496,4476,4489,4490,4450,4454,4472,-22,-4,12,536720,120
541,a1511,20150527,4454,4472,0,0,0,4443,4443,-29,-29,0,0,120
542,a1511,20150528,4443,4443,0,0,0,4459,4459,16,16,0,0,120
543,a1511,20150529,4459,4459,0,0,0,4438,4438,-21,-21,0,0,120
544,a1511,20150601,4438,4438,0,0,0,4418,4418,-20,-20,0,0,120
545,a1511,20150602,4418,4418,0,0,0,4392,4392,-26,-26,0,0,120
546,a1511,20150603,4392,4392,4408,4408,4408,4408,4408,16,16,2,88160,122
547,a1511,20150604,4408,4408,0,0,0,4371,4371,-37,-37,0,0,122
548,a1511,20150605,4371,4371,4403,4403,4340,4340,4373,-31,2,8,349900,122
549,a1511,20150608,4340,4373,0,0,0,4343,4343,-30,-30,0,0,122
550,a1511,20150609,4343,4343,4308,4317,4296,4300,4305,-43,-38,26,1119480,128
551,a1511,20150610,4300,4305,4303,4310,4253,4268,4291,-37,-14,48,2059780,122
552,a1511,20150611,4268,4291,0,0,0,4298,4298,7,7,0,0,122
553,a1511,20150612,4298,4298,4235,4262,4182,4182,4237,-116,-61,20,847460,116
554,a1511,20150615,4182,4237,4201,4201,4201,4201,4201,-36,-36,2,84020,114
555,a1511,20150616,4201,4201,4164,4203,4164,4203,4189,2,-12,6,251360,118
556,a1511,20150617,4203,4189,4228,4243,4228,4243,4230,54,41,16,676800,118
557,a1511,20150618,4243,4230,4254,4254,4235,4254,4247,24,17,6,254860,118
558,a1511,20150619,4254,4247,4219,4219,4181,4211,4204,-36,-43,16,672680,118
559,a1511,20150623,4211,4204,4311,4311,4251,4251,4271,47,67,6,256260,120
560,a1511,20150624,4251,4271,4221,4221,4221,4221,4221,-50,-50,2,84420,118
561,a1511,20150625,4221,4221,4176,4251,4176,4222,4211,1,-10,12,505400,118
562,a1511,20150626,4222,4211,4199,4257,4199,4209,4221,-2,10,6,253300,120
563,a1511,20150629,4209,4221,4159,4210,4159,4210,4189,-11,-32,6,251360,120
564,a1511,20150630,4210,4189,4199,4199,4110,4135,4149,-54,-40,22,912900,118
565,a1511,20150701,4135,4149,4111,4221,4111,4178,4161,29,12,22,915560,120
566,a1511,20150702,4178,4161,4280,4280,4112,4154,4150,-7,-11,20,830100,120
567,a1511,20150703,4154,4150,4148,4170,4127,4140,4150,-10,0,26,1079180,118
568,a1511,20150706,4140,4150,4110,4124,4060,4078,4094,-72,-56,60,2456760,116
569,a1511,20150707,4078,4094,4068,4072,4053,4053,4063,-41,-31,12,487600,112
570,a1511,20150708,4053,4063,3972,3972,3901,3917,3935,-146,-128,28,1101840,112
571,a1511,20150709,3917,3935,3979,4092,3969,4058,4044,123,109,126,5096660,128
572,a1511,20150710,4058,4044,4099,4196,4041,4153,4132,109,88,196,8098840,136
573,a1511,20150713,4153,4132,4167,4168,4082,4162,4162,30,30,134,5577680,176
574,a1511,20150714,4162,4162,4154,4197,4154,4180,4168,18,6,28,1167220,174
575,a1511,20150715,4180,4168,4150,4168,4147,4148,4150,-20,-18,18,747060,180
576,a1511,20150716,4148,4150,4107,4126,4060,4126,4091,-24,-59,16,654680,174
577,a1511,20150717,4126,4091,4138,4139,4070,4113,4110,22,19,32,1315420,164
578,a1511,20150720,4113,4110,4096,4115,4072,4080,4095,-30,-15,14,573320,158
579,a1511,20150721,4080,4095,4110,4110,4051,4051,4080,-44,-15,4,163220,158
580,a1511,20150722,4051,4080,4063,4076,4026,4051,4056,-29,-24,12,486740,152
581,a1511,20150723,4051,4056,0,0,0,4056,4056,0,0,0,0,152
582,a1511,20150724,4056,4056,4066,4110,4066,4075,4087,19,31,26,1062620,154
583,a1511,20150727,4075,4087,4104,4112,4023,4062,4069,-25,-18,62,2523020,150
584,a1511,20150728,4062,4069,4085,4090,4082,4090,4085,21,16,22,898900,130
585,a1511,20150729,4090,4085,4137,4178,4137,4169,4166,84,81,14,583340,120
586,a1511,20150730,4169,4166,4244,4245,4168,4212,4212,46,46,100,4212420,122
587,a1511,20150731,4212,4212,4213,4221,4213,4221,4219,9,7,10,421940,116
588,a1511,20150803,4221,4219,4186,4229,4186,4202,4208,-17,-11,12,505020,118
589,a1511,20150804,4202,4208,0,0,0,4208,4208,0,0,0,0,118
590,a1511,20150805,4208,4208,0,0,0,4208,4208,0,0,0,0,118
591,a1511,20150806,4208,4208,4160,4289,4160,4242,4224,34,16,62,2619280,116
592,a1511,20150807,4242,4224,4246,4252,4215,4215,4240,-9,16,20,848080,116
593,a1511,20150810,4215,4240,4240,4297,4211,4274,4247,34,7,146,6201980,116
594,a1511,20150811,4274,4247,4292,4320,4265,4300,4297,53,50,54,2320760,118
595,a1511,20150812,4300,4297,4294,4299,4271,4299,4289,2,-8,14,600540,120
596,a1511,20150813,4299,4289,4302,4335,4213,4256,4281,-33,-8,20,856360,122
597,a1511,20150814,4256,4281,4257,4330,4243,4281,4275,0,-6,44,1881320,120
598,a1511,20150817,4281,4275,0,0,0,4297,4297,22,22,0,0,120
599,a1511,20150818,4297,4297,4299,4299,4294,4294,4296,-3,-1,4,171860,120
600,a1511,20150819,4294,4296,4212,4276,4212,4267,4244,-29,-52,16,679060,120
601,a1511,20150820,4267,4244,4182,4182,4182,4182,4182,-62,-62,2,83640,122
602,a1511,20150821,4182,4182,4235,4235,4200,4205,4213,23,31,14,589920,122
603,a1511,20150824,4205,4213,4190,4190,4190,4190,4190,-23,-23,4,167600,120
604,a1511,20150825,4190,4190,4258,4258,4123,4123,4179,-67,-11,10,417900,122
605,a1511,20150826,4123,4179,4241,4241,4175,4176,4208,-3,29,12,505000,122
606,a1511,20150827,4176,4208,4158,4158,4158,4158,4158,-50,-50,2,83160,120
607,a1511,20150828,4158,4158,4169,4169,4111,4140,4145,-18,-13,10,414560,118
608,a1511,20150831,4140,4145,4103,4147,4103,4147,4122,2,-23,8,329780,116
609,a1511,20150901,4147,4122,0,0,0,4148,4148,26,26,0,0,116
610,a1511,20150902,4148,4148,0,0,0,4148,4148,0,0,0,0,116
611,a1511,20150907,4148,4148,4056,4150,4056,4088,4105,-60,-43,12,492640,114
612,a1511,20150908,4088,4105,4057,4057,4050,4050,4053,-55,-52,4,162140,114
613,a1511,20150909,4050,4053,4169,4169,4022,4145,4091,92,38,14,572740,114
614,a1511,20150910,4145,4091,4057,4099,4057,4099,4078,8,-13,4,163120,114
615,a1511,20150911,4099,4078,4089,4089,4089,4089,4089,11,11,2,81780,114
616,a1511,20150914,4089,4089,4156,4174,4042,4065,4082,-24,-7,84,3429180,118
617,a1511,20150915,4065,4082,4133,4133,4061,4066,4096,-16,14,28,1146980,114
618,a1511,20150916,4066,4096,0,0,0,4096,4096,0,0,0,0,114
619,a1511,20150917,4096,4096,4123,4123,4056,4059,4080,-37,-16,20,816020,116
620,a1511,20150918,4059,4080,4068,4070,4068,4070,4069,-10,-11,4,162760,116
621,a1511,20150921,4070,4069,4052,4080,3972,4006,4012,-63,-57,44,1765360,118
622,a1511,20150922,4006,4012,3976,4059,3976,4059,4028,47,16,12,483400,112
623,a1511,20150923,4059,4028,4001,4062,3970,3970,4003,-58,-25,28,1120860,106
624,a1511,20150924,3970,4003,3990,4024,3875,3981,3968,-22,-35,12,476180,108
625,a1511,20150925,3981,3968,3939,3959,3938,3954,3950,-14,-18,12,474080,106
626,a1511,20150928,3954,3950,3908,3959,3908,3932,3933,-18,-17,6,235980,106
627,a1511,20150929,3932,3933,4008,4008,3931,3984,3958,51,25,16,633360,106
628,a1511,20150930,3984,3958,3984,4129,3984,3984,4008,26,50,22,881960,106
629,a1511,20151008,3984,4008,3901,3951,3806,3806,3885,-202,-123,20,777000,110
630,a1511,20151009,3806,3885,3806,3850,3775,3796,3804,-89,-81,48,1826040,108
631,a1511,20151012,3796,3804,3794,3862,3792,3854,3816,50,12,56,2137340,108
632,a1511,20151013,3854,3816,3829,3859,3827,3859,3843,43,27,36,1383600,110
633,a1511,20151014,3859,3843,3881,3930,3875,3900,3903,57,60,36,1405280,108
634,a1511,20151015,3900,3903,0,0,0,3903,3903,0,0,0,0,108
635,a1511,20151016,3903,3903,3940,3962,3851,3874,3904,-29,1,20,780860,112
636,a1511,20151019,3874,3904,3819,3880,3819,3823,3850,-81,-54,8,308040,110
637,a1511,20151020,3823,3850,3811,3940,3811,3818,3857,-32,7,34,1311440,114
638,a1511,20151021,3818,3857,3818,3930,3818,3839,3875,-18,18,42,1627760,114
639,a1511,20151022,3839,3875,3839,3902,3839,3902,3870,27,-5,4,154820,112
640,a1511,20151023,3902,3870,3868,3935,3856,3879,3894,9,24,42,1635820,112
641,a1511,20151026,3879,3894,3876,3897,3825,3825,3868,-69,-26,72,2785440,112
642,a1511,20151027,3825,3868,3800,3826,3780,3780,3800,-88,-68,42,1596120,112
643,a1511,20151028,3780,3800,3781,3781,3780,3780,3780,-20,-20,4,151220,112
644,a1511,20151029,3780,3780,3768,3800,3768,3800,3791,20,11,8,303300,114
645,a1511,20151030,3800,3791,3802,3880,3755,3770,3846,-21,55,224,8616880,40
646,a1511,20151102,3770,3846,0,0,0,3846,3846,0,0,0,0,0
647,a1511,20151103,3846,3846,0,0,0,3846,3846,0,0,0,0,0
648,a1511,20151104,3846,3846,0,0,0,3846,3846,0,0,0,0,0
649,a1511,20151105,3846,3846,0,0,0,3846,3846,0,0,0,0,0
650,a1511,20151106,3846,3846,0,0,0,3846,3846,0,0,0,0,0
651,a1511,20151109,3846,3846,0,0,0,3846,3846,0,0,0,0,0
652,a1511,20151110,3846,3846,0,0,0,3846,3846,0,0,0,0,0
653,a1511,20151111,3846,3846,0,0,0,3846,3846,0,0,0,0,0
654,a1511,20151112,3846,3846,0,0,0,3846,3846,0,0,0,0,0
655,a1511,20151113,3846,3846,0,0,0,3846,3846,0,0,0,0,0
656,a1601,20150105,4440,4442,4401,4435,4390,4435,4424,-7,-18,290,12830280,13664
657,a1601,20150106,4435,4424,4439,4475,4436,4444,4449,20,25,1010,44934900,13744
658,a1601,20150107,4444,4449,4451,4455,4432,4443,4443,-6,-6,398,17686140,13750
659,a1601,20150108,4443,4443,4451,4451,4432,4440,4438,-3,-5,658,29206760,13772
660,a1601,20150109,4440,4438,4436,4453,4431,4435,4439,-3,1,230,10211400,13730
661,a1601,20150112,4435,4439,4450,4455,4432,4439,4444,0,5,188,8355460,13744
662,a1601,20150113,4439,4444,4421,4430,4397,4409,4408,-35,-36,310,13667440,13786
663,a1601,20150114,4409,4408,4399,4417,4389,4393,4402,-15,-6,788,34687840,13802
664,a1601,20150115,4393,4402,4400,4415,4384,4415,4399,13,-3,1534,67489200,12982
665,a1601,20150116,4415,4399,4417,4427,4393,4410,4406,11,7,334,14716800,12956
666,a1601,20150119,4410,4406,4417,4418,4376,4392,4398,-14,-8,862,37912720,13216
667,a1601,20150120,4392,4398,4400,4400,4351,4353,4359,-45,-39,2704,117893580,15084
668,a1601,20150121,4353,4359,4331,4366,4313,4340,4346,-19,-13,1658,72068700,14780
669,a1601,20150122,4340,4346,4340,4350,4318,4321,4327,-25,-19,596,25792860,15108
670,a1601,20150123,4321,4327,4325,4325,4304,4309,4315,-18,-12,358,15450080,15114
671,a1601,20150126,4309,4315,4315,4325,4290,4295,4305,-20,-10,2100,90423680,16670
672,a1601,20150127,4295,4305,4295,4337,4295,4322,4317,17,12,274,11831100,16684
673,a1601,20150128,4322,4317,4316,4329,4311,4326,4322,9,5,232,10027800,16720
674,a1601,20150129,4326,4322,4324,4331,4278,4320,4299,-2,-23,3178,136633220,18786
675,a1601,20150130,4320,4299,4320,4337,4316,4320,4325,21,26,1150,49743760,18730
676,a1601,20150202,4320,4325,4317,4349,4311,4348,4325,23,0,1436,62112960,18606
677,a1601,20150203,4348,4325,4352,4372,4345,4359,4357,34,32,964,42002740,18086
678,a1601,20150204,4359,4357,4362,4382,4358,4358,4371,1,14,166,7255860,18050
679,a1601,20150205,4358,4371,4354,4376,4337,4346,4348,-25,-23,1180,51314300,18202
680,a1601,20150206,4346,4348,4346,4366,4346,4361,4359,13,11,186,8108480,18128
681,a1601,20150209,4361,4359,4387,4387,4337,4353,4345,-6,-14,266,11558580,18134
682,a1601,20150210,4353,4345,4350,4354,4333,4333,4340,-12,-5,218,9462960,18066
683,a1601,20150211,4333,4340,4331,4345,4331,4338,4337,-2,-3,140,6071920,18046
684,a1601,20150212,4338,4337,4340,4355,4332,4349,4346,12,9,730,31726880,17592
685,a1601,20150213,4349,4346,4348,4398,4345,4380,4382,34,36,1590,69683100,16938
686,a1601,20150216,4380,4382,4375,4389,4342,4348,4358,-34,-24,688,29983160,16710
687,a1601,20150217,4348,4358,4348,4358,4341,4358,4349,0,-9,352,15310700,16490
688,a1601,20150225,4358,4349,4365,4365,4320,4320,4333,-29,-16,934,40479360,16870
689,a1601,20150226,4320,4333,4343,4343,4291,4317,4302,-16,-31,1692,72802980,17822
690,a1601,20150227,4317,4302,4330,4353,4297,4345,4315,43,13,1552,66976780,18102
691,a1601,20150302,4345,4315,4320,4357,4320,4355,4345,40,30,958,41632200,18016
692,a1601,20150303,4355,4345,4357,4365,4336,4347,4348,2,3,2060,89580040,17544
693,a1601,20150304,4347,4348,4355,4355,4338,4346,4345,-2,-3,332,14428500,17566
694,a1601,20150305,4346,4345,4345,4345,4281,4291,4301,-54,-44,3316,142636800,19024
695,a1601,20150306,4291,4301,4300,4306,4283,4283,4293,-18,-8,992,42590040,19168
696,a1601,20150309,4283,4293,4281,4313,4280,4288,4288,-5,-5,2076,89034520,19582
697,a1601,20150310,4288,4288,4293,4302,4248,4252,4268,-36,-20,4886,208549800,23314
698,a1601,20150311,4252,4268,4252,4314,4235,4296,4276,28,8,5362,229314720,24026
699,a1601,20150312,4296,4276,4293,4300,4277,4290,4286,14,10,1580,67728680,23856
700,a1601,20150313,4290,4286,4268,4297,4266,4273,4283,-13,-3,1066,45659180,23690
701,a1601,20150316,4273,4283,4273,4285,4255,4279,4271,-4,-12,1082,46222780,23740
702,a1601,20150317,4279,4271,4286,4327,4276,4276,4296,5,25,802,34455960,23788
703,a1601,20150318,4276,4296,4276,4295,4265,4265,4273,-31,-23,826,35299040,23744
704,a1601,20150319,4265,4273,4276,4283,4255,4267,4269,-6,-4,778,33214300,23726
705,a1601,20150320,4267,4269,4264,4270,4251,4256,4256,-13,-13,3212,136714400,25200
706,a1601,20150323,4256,4256,4251,4275,4251,4262,4269,6,13,2306,98454760,24984
707,a1601,20150324,4262,4269,4258,4284,4208,4269,4254,0,-15,6632,282176280,25350
708,a1601,20150325,4269,4254,4268,4268,4214,4214,4233,-40,-21,6596,279260200,29206
709,a1601,20150326,4214,4233,4211,4234,4202,4225,4218,-8,-15,16930,714185200,39440
710,a1601,20150327,4225,4218,4220,4230,4213,4220,4219,2,1,4660,196636960,41292
711,a1601,20150330,4220,4219,4210,4221,4179,4220,4197,1,-22,10754,451426520,43226
712,a1601,20150331,4220,4197,4220,4221,4190,4191,4204,-6,7,1784,75005180,43280
713,a1601,20150401,4191,4204,4188,4231,4188,4210,4212,6,8,3988,168002660,42406
714,a1601,20150402,4210,4212,4212,4228,4192,4192,4209,-20,-3,4550,191554400,44986
715,a1601,20150403,4192,4209,4191,4191,4149,4157,4159,-52,-50,8092,336610940,47632
716,a1601,20150407,4157,4159,4155,4164,4121,4122,4140,-37,-19,5150,213253200,50678
717,a1601,20150408,4122,4140,4102,4123,4082,4103,4101,-37,-39,5646,231593480,50758
718,a1601,20150409,4103,4101,4098,4106,4062,4069,4076,-32,-25,5344,217864820,52028
719,a1601,20150410,4069,4076,4068,4105,4062,4069,4075,-7,-1,2592,105630860,52142
720,a1601,20150413,4069,4075,4078,4143,4071,4129,4112,54,37,11296,464507300,53742
721,a1601,20150414,4129,4112,4117,4171,4111,4163,4152,51,40,17890,742866960,53046
722,a1601,20150415,4163,4152,4163,4189,4160,4167,4177,15,25,17556,733406860,51118
723,a1601,20150416,4167,4177,4166,4182,4156,4164,4165,-13,-12,7716,321447460,51646
724,a1601,20150417,4164,4165,4165,4165,4112,4115,4135,-50,-30,6928,286506860,50300
725,a1601,20150420,4115,4135,4107,4131,4048,4083,4084,-52,-51,15178,619995500,51528
726,a1601,20150421,4083,4084,4073,4151,4071,4150,4128,66,44,13910,574323840,52506
727,a1601,20150422,4150,4128,4137,4260,4137,4242,4190,114,62,28586,1197927060,54258
728,a1601,20150423,4242,4190,4238,4255,4203,4232,4228,42,38,19404,820448420,53354
729,a1601,20150424,4232,4228,4245,4308,4232,4300,4280,72,52,27662,1183967900,52558
730,a1601,20150427,4300,4280,4304,4329,4277,4312,4302,32,22,15514,667535240,52764
731,a1601,20150428,4312,4302,4311,4321,4282,4310,4310,8,8,15508,668539420,54286
732,a1601,20150429,4310,4310,4332,4332,4302,4315,4314,5,4,16062,692958120,56492
733,a1601,20150430,4315,4314,4311,4421,4311,4405,4384,91,70,27740,1216312360,62656
734,a1601,20150504,4405,4384,4398,4398,4345,4361,4364,-23,-20,12866,561531960,65800
735,a1601,20150505,4361,4364,4361,4384,4320,4360,4361,-4,-3,11902,519107740,65694
736,a1601,20150506,4360,4361,4375,4416,4352,4397,4389,36,28,16314,716126060,66886
737,a1601,20150507,4397,4389,4398,4405,4361,4385,4383,-4,-6,8648,379101800,68314
738,a1601,20150508,4385,4383,4385,4392,4335,4370,4359,-13,-24,12026,524221940,68314
739,a1601,20150511,4370,4359,4377,4454,4365,4451,4420,92,61,29430,1300924900,74158
740,a1601,20150512,4451,4420,4450,4469,4431,4452,4449,32,29,21632,962621420,77058
741,a1601,20150513,4452,4449,4451,4466,4439,4460,4454,11,5,14620,651217640,77220
742,a1601,20150514,4460,4454,4464,4472,4419,4453,4445,-1,-9,18422,818867520,75590
743,a1601,20150515,4453,4445,4453,4465,4443,4454,4451,9,6,10238,455705540,74522
744,a1601,20150518,4454,4451,4454,4458,4428,4452,4444,1,-7,9008,400326340,74392
745,a1601,20150519,4452,4444,4456,4459,4421,4421,4437,-23,-7,10310,457551280,74408
746,a1601,20150520,4421,4437,4415,4424,4367,4391,4394,-46,-43,17518,769865880,75360
747,a1601,20150521,4391,4394,4395,4426,4301,4397,4402,3,8,15998,704364380,76650
748,a1601,20150522,4397,4402,4400,4571,4391,4547,4498,145,96,58842,2646973460,79412
749,a1601,20150525,4547,4498,4532,4560,4493,4509,4518,11,20,44038,1989674560,72782
750,a1601,20150526,4509,4518,4517,4534,4498,4498,4510,-20,-8,21276,959673980,70552
751,a1601,20150527,4498,4510,4488,4510,4462,4480,4485,-30,-25,20308,910892980,71414
752,a1601,20150528,4480,4485,4481,4526,4473,4493,4496,8,11,31548,1418480380,77514
753,a1601,20150529,4493,4496,4498,4510,4439,4504,4489,8,-7,12748,572281880,75826
754,a1601,20150601,4504,4489,4496,4514,4415,4429,4469,-60,-20,28392,1269004400,80416
755,a1601,20150602,4429,4469,4429,4468,4423,4457,4450,-12,-19,14706,654498280,80014
756,a1601,20150603,4457,4450,4467,4487,4458,4472,4472,22,22,14664,655891420,78408
757,a1601,20150604,4472,4472,4469,4472,4415,4439,4437,-33,-35,20328,901987520,76604
758,a1601,20150605,4439,4437,4431,4445,4355,4365,4393,-72,-44,31526,1385120340,76098
759,a1601,20150608,4365,4393,4365,4394,4347,4358,4375,-35,-18,23178,1014082600,79322
760,a1601,20150609,4358,4375,4361,4406,4360,4365,4384,-10,9,29648,1299986840,87990
761,a1601,20150610,4365,4384,4367,4393,4357,4379,4373,-5,-11,14220,621961520,88032
762,a1601,20150611,4379,4373,4382,4402,4362,4370,4380,-3,7,18092,792549320,88922
763,a1601,20150612,4370,4380,4360,4373,4256,4259,4296,-121,-84,63798,2741180460,97284
764,a1601,20150615,4259,4296,4271,4279,4224,4232,4252,-64,-44,31136,1324084720,101460
765,a1601,20150616,4232,4252,4231,4304,4221,4275,4267,23,15,45244,1930599800,110516
766,a1601,20150617,4275,4267,4273,4332,4250,4325,4304,58,37,35988,1549062940,113258
767,a1601,20150618,4325,4304,4320,4368,4311,4326,4333,22,29,42310,1833517600,114622
768,a1601,20150619,4326,4333,4308,4335,4291,4321,4311,-12,-22,27446,1183449240,108670
769,a1601,20150623,4321,4311,4367,4370,4332,4350,4345,39,34,20452,888837160,106696
770,a1601,20150624,4350,4345,4343,4349,4288,4308,4315,-37,-30,32990,1423797600,108406
771,a1601,20150625,4308,4315,4308,4344,4291,4303,4312,-12,-3,22680,978156760,108272
772,a1601,20150626,4303,4312,4313,4335,4270,4280,4309,-32,-3,37568,1619064380,107938
773,a1601,20150629,4280,4309,4306,4317,4241,4261,4270,-48,-39,39734,1696961120,106508
774,a1601,20150630,4261,4270,4262,4278,4206,4212,4233,-58,-37,30164,1277048880,104380
775,a1601,20150701,4212,4233,4209,4331,4187,4270,4265,37,32,66492,2836096720,105818
776,a1601,20150702,4270,4265,4266,4270,4227,4241,4246,-24,-19,25006,1061924180,105052
777,a1601,20150703,4241,4246,4241,4255,4223,4231,4240,-15,-6,31150,1320837460,107192
778,a1601,20150706,4231,4240,4239,4239,4156,4170,4188,-70,-52,47150,1974913880,107610
779,a1601,20150707,4170,4188,4169,4180,4122,4127,4151,-61,-37,38010,1578000540,105818
780,a1601,20150708,4127,4151,4125,4126,3985,3986,4022,-165,-129,94778,3812589080,114646
781,a1601,20150709,3986,4022,3986,4182,3986,4166,4105,144,83,88100,3616519920,110460
782,a1601,20150710,4166,4105,4176,4269,4169,4265,4251,160,146,88428,3759816400,111618
783,a1601,20150713,4265,4251,4269,4290,4222,4261,4253,10,2,81614,3471441760,112206
784,a1601,20150714,4261,4253,4253,4294,4236,4269,4269,16,16,88602,3782884140,114890
785,a1601,20150715,4269,4269,4267,4275,4214,4230,4247,-39,-22,53104,2255795380,115898
786,a1601,20150716,4230,4247,4225,4236,4142,4206,4189,-41,-58,84654,3546258260,116106
787,a1601,20150717,4206,4189,4208,4243,4174,4202,4207,13,18,72928,3068513640,117994
788,a1601,20150720,4202,4207,4191,4214,4124,4147,4168,-60,-39,58284,2429730860,116700
789,a1601,20150721,4147,4168,4141,4178,4136,4147,4154,-21,-14,47456,1971714300,118158
790,a1601,20150722,4147,4154,4146,4156,4101,4141,4130,-13,-24,73762,3046641220,123154
791,a1601,20150723,4141,4130,4129,4164,4105,4150,4133,20,3,103328,4271276360,126258
792,a1601,20150724,4150,4133,4151,4187,4137,4163,4162,30,29,94288,3924709460,127696
793,a1601,20150727,4163,4162,4158,4177,4119,4127,4146,-35,-16,83930,3480349380,135142
794,a1601,20150728,4127,4146,4121,4173,4074,4170,4124,24,-22,139216,5741975440,129064
795,a1601,20150729,4170,4124,4179,4238,4170,4234,4212,110,88,153390,6461039860,125886
796,a1601,20150730,4234,4212,4234,4278,4220,4232,4249,20,37,170986,7266010400,125398
797,a1601,20150731,4232,4249,4245,4260,4227,4248,4243,-1,-6,128384,5448229180,127492
798,a1601,20150803,4248,4243,4255,4267,4186,4222,4230,-21,-13,122470,5180560260,127732
799,a1601,20150804,4222,4230,4225,4257,4201,4255,4241,25,11,125318,5315009900,132580
800,a1601,20150805,4255,4241,4260,4270,4231,4249,4251,8,10,91916,3907597980,133980
801,a1601,20150806,4249,4251,4265,4345,4252,4331,4300,80,49,246188,10586400300,153382
802,a1601,20150807,4331,4300,4330,4347,4283,4325,4313,25,13,187696,8097113060,154042
803,a1601,20150810,4325,4313,4313,4381,4313,4361,4350,48,37,149176,6489405280,161470
804,a1601,20150811,4361,4350,4355,4396,4351,4379,4379,29,29,139000,6087922100,160636
805,a1601,20150812,4379,4379,4367,4392,4352,4388,4372,9,-7,99746,4361866620,155758
806,a1601,20150813,4388,4372,4402,4420,4299,4344,4358,-28,-14,171362,7468624380,146682
807,a1601,20150814,4344,4358,4337,4375,4333,4359,4354,1,-4,88358,3847642480,148494
808,a1601,20150817,4359,4354,4355,4396,4347,4372,4372,18,18,86388,3777535400,150500
809,a1601,20150818,4372,4372,4374,4394,4312,4313,4358,-59,-14,127630,5562340060,149878
810,a1601,20150819,4313,4358,4316,4343,4292,4325,4315,-33,-43,149810,6465687800,139240
811,a1601,20150820,4325,4315,4331,4340,4259,4279,4299,-36,-16,131020,5632764300,138608
812,a1601,20150821,4279,4299,4277,4315,4269,4281,4292,-18,-7,114694,4923281420,132990
813,a1601,20150824,4281,4292,4278,4284,4172,4197,4225,-95,-67,166944,7054649040,127524
814,a1601,20150825,4197,4225,4175,4245,4156,4210,4208,-15,-17,135454,5700851440,122334
815,a1601,20150826,4210,4208,4242,4270,4196,4204,4229,-4,21,102434,4332819640,117352
816,a1601,20150827,4204,4229,4210,4229,4166,4219,4203,-10,-26,124986,5253409540,115836
817,a1601,20150828,4219,4203,4218,4265,4141,4156,4195,-47,-8,273034,11454130240,144090
818,a1601,20150831,4156,4195,4148,4191,4130,4160,4159,-35,-36,180586,7512155160,141276
819,a1601,20150901,4160,4159,4158,4199,4145,4181,4182,22,23,138606,5796870360,135294
820,a1601,20150902,4181,4182,4170,4203,4162,4189,4185,7,3,97438,4078467140,132080
821,a1601,20150907,4189,4185,4180,4188,4125,4128,4144,-57,-41,87746,3636526100,143656
822,a1601,20150908,4128,4144,4126,4155,4094,4147,4122,3,-22,152362,6281469580,140366
823,a1601,20150909,4147,4122,4157,4173,4121,4123,4148,1,26,133404,5534819580,143374
824,a1601,20150910,4123,4148,4120,4165,4111,4158,4138,10,-10,122668,5076785760,138428
825,a1601,20150911,4158,4138,4142,4198,4133,4170,4170,32,32,116204,4846605800,132208
826,a1601,20150914,4170,4170,4169,4186,4141,4144,4168,-26,-2,92810,3868890220,132074
827,a1601,20150915,4144,4168,4143,4175,4134,4139,4158,-29,-10,106860,4444105980,127894
828,a1601,20150916,4139,4158,4139,4168,4115,4165,4136,7,-22,123058,5089919880,123148
829,a1601,20150917,4165,4136,4165,4172,4145,4150,4158,14,22,81576,3392169040,121674
830,a1601,20150918,4150,4158,4142,4169,4122,4128,4146,-30,-12,99056,4107809640,126840
831,a1601,20150921,4128,4146,4124,4136,4048,4099,4083,-47,-63,173326,7077173520,136054
832,a1601,20150922,4099,4083,4099,4108,4056,4071,4078,-12,-5,112778,4599762980,137266
833,a1601,20150923,4071,4078,4057,4074,4032,4064,4053,-14,-25,100340,4067465480,135406
834,a1601,20150924,4064,4053,4065,4083,4037,4045,4056,-8,3,99952,4054741420,136174
835,a1601,20150925,4045,4056,4039,4065,3997,4027,4035,-29,-21,208118,8399300520,131620
836,a1601,20150928,4027,4035,4047,4055,4007,4014,4024,-21,-11,51964,2091177300,132856
837,a1601,20150929,4014,4024,4014,4075,3982,4073,4034,49,10,167052,6740081240,126916
838,a1601,20150930,4073,4034,4079,4097,4041,4047,4066,13,32,134822,5482954100,115326
839,a1601,20151008,4047,4066,4056,4064,3870,3903,3946,-163,-120,289110,11408552880,153154
840,a1601,20151009,3903,3946,3898,3945,3842,3888,3889,-58,-57,572602,22271424280,154898
841,a1601,20151012,3888,3889,3897,3962,3870,3956,3916,67,27,374446,14664159800,147646
842,a1601,20151013,3956,3916,3949,3963,3923,3952,3942,36,26,281438,11094762720,148050
843,a1601,20151014,3952,3942,3952,3999,3944,3984,3973,42,31,278330,11060125360,133608
844,a1601,20151015,3984,3973,3988,3999,3962,3971,3978,-2,5,168512,6703455300,134480
845,a1601,20151016,3971,3978,3966,3969,3926,3945,3944,-33,-34,226762,8945085640,146902
846,a1601,20151019,3945,3944,3936,3954,3916,3939,3936,-5,-8,154736,6091732900,145770
847,a1601,20151020,3939,3936,3926,3951,3903,3930,3928,-6,-8,176582,6936273400,149322
848,a1601,20151021,3930,3928,3930,3946,3907,3910,3925,-18,-3,115160,4520203000,148996
849,a1601,20151022,3910,3925,3911,3983,3898,3969,3940,44,15,212442,8370864700,134004
850,a1601,20151023,3969,3940,3976,3985,3930,3965,3951,25,11,169676,6704227500,120346
851,a1601,20151026,3965,3951,3969,3975,3866,3905,3910,-46,-41,267988,10478440440,132390
852,a1601,20151027,3905,3910,3905,3913,3869,3912,3890,2,-20,167042,6498855740,128074
853,a1601,20151028,3912,3890,3908,3918,3875,3879,3894,-11,4,114280,4450839200,132162
854,a1601,20151029,3879,3894,3880,3908,3870,3885,3888,-9,-6,118276,4599361640,132096
855,a1601,20151030,3885,3888,3880,3892,3855,3881,3876,-7,-12,145762,5650110900,131102
856,a1601,20151102,3881,3876,3884,3892,3870,3875,3878,-1,2,86936,3372240940,128404
857,a1601,20151103,3875,3878,3870,3887,3860,3878,3873,0,-5,82820,3207654980,125600
858,a1601,20151104,3878,3873,3875,3898,3865,3887,3881,14,8,136458,5296052520,111242
859,a1601,20151105,3887,3881,3882,3889,3836,3876,3873,-5,-8,93480,3620831280,113132
860,a1601,20151106,3876,3873,3875,3885,3844,3884,3867,11,-6,112198,4339298800,112500
861,a1601,20151109,3884,3867,3877,3898,3850,3861,3870,-6,3,98762,3822928220,114844
862,a1601,20151110,3861,3870,3863,3867,3838,3853,3853,-17,-17,71340,2748832620,114966
863,a1601,20151111,3853,3853,3847,3879,3813,3867,3845,14,-8,108122,4157618460,109802
864,a1601,20151112,3867,3845,3867,3894,3860,3887,3876,42,31,85736,3323291580,97092
865,a1601,20151113,3887,3876,3880,3891,3865,3868,3878,-8,2,54624,2118731160,92988
866,a1601,20151116,3868,3878,3878,3878,3764,3766,3810,-112,-68,111220,4238231520,94152
867,a1601,20151117,3766,3810,3780,3780,3707,3770,3745,-40,-65,158962,5954063280,80864
868,a1601,20151118,3770,3745,3766,3789,3764,3780,3777,35,32,57358,2166537780,83300
869,a1601,20151119,3780,3777,3787,3794,3756,3784,3776,7,-1,73212,2764766520,79534
870,a1601,20151120,3784,3776,3771,3850,3771,3846,3824,70,48,63976,2446472340,81362
871,a1601,20151123,3846,3824,3838,3912,3838,3901,3882,77,58,61258,2378300960,68836
872,a1601,20151124,3901,3882,3886,3906,3876,3890,3892,8,10,32942,1282116720,64942
873,a1601,20151125,3890,3892,3888,3900,3857,3895,3885,3,-7,24340,945710500,63996
874,a1601,20151126,3895,3885,3888,3914,3880,3890,3896,5,11,23524,916638220,61482
875,a1601,20151127,3890,3896,3883,3926,3880,3915,3901,19,5,17114,667744480,58238
876,a1601,20151130,3915,3901,3911,3928,3901,3918,3913,17,12,12996,508644720,52772
877,a1601,20151201,3918,3913,3918,3926,3910,3918,3918,5,5,7030,275461160,49936
878,a1601,20151202,3918,3918,3924,3934,3865,3893,3896,-25,-22,21514,838229960,43560
879,a1601,20151203,3893,3896,3885,3912,3885,3901,3904,5,8,10312,402587580,41386
880,a1601,20151204,3901,3904,3910,3910,3865,3888,3899,-16,-5,9730,379445660,39080
881,a1601,20151207,3888,3899,3888,3895,3862,3871,3876,-28,-23,10806,418913300,38752
882,a1601,20151208,3871,3876,3871,3873,3820,3822,3835,-54,-41,12456,477751100,36162
883,a1601,20151209,3822,3835,3827,3889,3827,3831,3857,-4,22,16990,655466180,32810
884,a1601,20151210,3831,3857,3832,3867,3827,3850,3851,-7,-6,3932,151457240,32346
885,a1601,20151211,3850,3851,3853,3864,3838,3847,3848,-4,-3,5346,205748160,30986
886,a1601,20151214,3847,3848,3838,3858,3835,3837,3847,-11,-1,6252,240543000,30624
887,a1601,20151215,3837,3847,3847,3849,3829,3840,3837,-7,-10,5698,218684540,30250
888,a1601,20151216,3840,3837,3846,3858,3838,3855,3849,18,12,1696,65295240,29470
889,a1601,20151217,3855,3849,3850,3887,3850,3884,3875,35,26,2782,107813540,28628
890,a1601,20151218,3884,3875,3870,3888,3860,3873,3872,-2,-3,2760,106874180,26704
891,a1601,20151221,3873,3872,3875,3878,3871,3871,3874,-1,2,2022,78342600,24944
892,a1601,20151222,3871,3874,3870,3878,3870,3873,3873,-1,-1,782,30292680,24490
893,a1601,20151223,3873,3873,3873,3878,3865,3875,3872,2,-1,974,37715560,23890
894,a1601,20151224,3875,3872,3875,3878,3860,3868,3872,-4,0,1450,56144160,22628
895,a1601,20151225,3868,3872,3871,3875,3858,3860,3868,-12,-4,1772,68541460,22304
896,a1601,20151228,3860,3868,3865,3875,3863,3869,3869,1,1,1528,59121980,21142
897,a1601,20151229,3869,3869,3871,3875,3864,3865,3869,-4,0,8054,311629180,13876
898,a1601,20151230,3865,3869,3863,3870,3742,3841,3844,-28,-25,2954,113575380,11826
899,a1601,20151231,3841,3844,3844,3870,3779,3815,3826,-29,-18,8668,331674960,7960
900,a1603,20150105,4510,4510,0,0,0,4507,4507,-3,-3,0,0,2
901,a1603,20150106,4507,4507,0,0,0,4532,4532,25,25,0,0,2
902,a1603,20150107,4532,4532,4395,4539,4395,4539,4491,7,-41,6,269460,4
903,a1603,20150108,4539,4491,4414,4414,4414,4414,4414,-77,-77,4,176560,0
904,a1603,20150109,4414,4414,0,0,0,4414,4414,0,0,0,0,0
905,a1603,20150112,4414,4414,0,0,0,4414,4414,0,0,0,0,0
906,a1603,20150113,4414,4414,0,0,0,4414,4414,0,0,0,0,0
907,a1603,20150114,4414,4414,0,0,0,4414,4414,0,0,0,0,0
908,a1603,20150115,4414,4414,0,0,0,4414,4414,0,0,0,0,0
909,a1603,20150116,4414,4414,0,0,0,4414,4414,0,0,0,0,0
910,a1603,20150119,4414,4414,0,0,0,4414,4414,0,0,0,0,0
911,a1603,20150120,4414,4414,0,0,0,4414,4414,0,0,0,0,0
912,a1603,20150121,4414,4414,0,0,0,4414,4414,0,0,0,0,0
913,a1603,20150122,4414,4414,0,0,0,4414,4414,0,0,0,0,0
914,a1603,20150123,4414,4414,0,0,0,4414,4414,0,0,0,0,0
915,a1603,20150126,4414,4414,0,0,0,4375,4375,-39,-39,0,0,0
916,a1603,20150127,4375,4375,0,0,0,4375,4375,0,0,0,0,0
917,a1603,20150128,4375,4375,0,0,0,4375,4375,0,0,0,0,0
918,a1603,20150129,4375,4375,0,0,0,4375,4375,0,0,0,0,0
919,a1603,20150130,4375,4375,0,0,0,4375,4375,0,0,0,0,0
920,a1603,20150202,4375,4375,0,0,0,4375,4375,0,0,0,0,0
921,a1603,20150203,4375,4375,0,0,0,4375,4375,0,0,0,0,0
922,a1603,20150204,4375,4375,0,0,0,4375,4375,0,0,0,0,0
923,a1603,20150205,4375,4375,0,0,0,4375,4375,0,0,0,0,0
924,a1603,20150206,4375,4375,0,0,0,4375,4375,0,0,0,0,0
925,a1603,20150209,4375,4375,4317,4466,4317,4333,4395,-42,20,8,351640,0
926,a1603,20150210,4333,4395,0,0,0,4395,4395,0,0,0,0,0
927,a1603,20150211,4395,4395,0,0,0,4395,4395,0,0,0,0,0
928,a1603,20150212,4395,4395,0,0,0,4395,4395,0,0,0,0,0
929,a1603,20150213,4395,4395,0,0,0,4395,4395,0,0,0,0,0
930,a1603,20150216,4395,4395,0,0,0,4395,4395,0,0,0,0,0
931,a1603,20150217,4395,4395,0,0,0,4395,4395,0,0,0,0,0
932,a1603,20150225,4395,4395,0,0,0,4395,4395,0,0,0,0,0
933,a1603,20150226,4395,4395,4402,4402,4402,4402,4402,7,7,60,2641200,60
934,a1603,20150227,4402,4402,4351,4425,4351,4400,4391,-2,-11,8,351300,62
935,a1603,20150302,4400,4391,0,0,0,4391,4391,0,0,0,0,62
936,a1603,20150303,4391,4391,0,0,0,4391,4391,0,0,0,0,62
937,a1603,20150304,4391,4391,4392,4392,4390,4390,4391,-1,0,4,175640,62
938,a1603,20150305,4390,4391,0,0,0,4391,4391,0,0,0,0,62
939,a1603,20150306,4391,4391,0,0,0,4378,4378,-13,-13,0,0,62
940,a1603,20150309,4378,4378,0,0,0,4378,4378,0,0,0,0,62
941,a1603,20150310,4378,4378,4336,4336,4336,4336,4336,-42,-42,2,86720,62
942,a1603,20150311,4336,4336,4351,4351,4351,4351,4351,15,15,2,87020,64
943,a1603,20150312,4351,4351,0,0,0,4351,4351,0,0,0,0,64
944,a1603,20150313,4351,4351,4385,4387,4344,4344,4367,-7,16,14,611460,66
945,a1603,20150316,4344,4367,0,0,0,4367,4367,0,0,0,0,66
946,a1603,20150317,4367,4367,0,0,0,4392,4392,25,25,0,0,66
947,a1603,20150318,4392,4392,0,0,0,4381,4381,-11,-11,0,0,66
948,a1603,20150319,4381,4381,4406,4406,4286,4360,4351,-21,-30,14,609180,70
949,a1603,20150320,4360,4351,4330,4330,4301,4302,4307,-49,-44,32,1378520,86
950,a1603,20150323,4302,4307,4356,4368,4325,4335,4340,28,33,62,2691260,118
951,a1603,20150324,4335,4340,4351,4351,4290,4307,4331,-33,-9,54,2339000,132
952,a1603,20150325,4307,4331,4310,4310,4310,4310,4310,-21,-21,2,86200,134
953,a1603,20150326,4310,4310,4270,4320,4252,4252,4280,-58,-30,22,941720,138
954,a1603,20150327,4252,4280,4282,4309,4282,4309,4292,29,12,10,429280,142
955,a1603,20150330,4309,4292,4288,4288,4273,4273,4282,-19,-10,10,428200,138
956,a1603,20150331,4273,4282,4269,4269,4269,4269,4269,-13,-13,4,170760,134
957,a1603,20150401,4269,4269,4280,4289,4280,4289,4284,20,15,8,342760,138
958,a1603,20150402,4289,4284,4289,4290,4289,4290,4289,6,5,32,1372520,138
959,a1603,20150403,4290,4289,4231,4231,4231,4231,4231,-58,-58,8,338480,138
960,a1603,20150407,4231,4231,4226,4230,4216,4216,4224,-15,-7,6,253440,138
961,a1603,20150408,4216,4224,4194,4194,4170,4180,4182,-44,-42,22,920040,144
962,a1603,20150409,4180,4182,4163,4163,4138,4141,4142,-41,-40,38,1574120,126
963,a1603,20150410,4141,4142,0,0,0,4142,4142,0,0,0,0,126
964,a1603,20150413,4142,4142,4170,4170,4170,4170,4170,28,28,2,83400,126
965,a1603,20150414,4170,4170,0,0,0,4171,4171,1,1,0,0,126
966,a1603,20150415,4171,4171,0,0,0,4196,4196,25,25,0,0,126
967,a1603,20150416,4196,4196,0,0,0,4196,4196,0,0,0,0,126
968,a1603,20150417,4196,4196,4207,4224,4119,4119,4202,-77,6,54,2269320,126
969,a1603,20150420,4119,4202,4171,4187,4122,4161,4160,-41,-42,32,1331380,128
970,a1603,20150421,4161,4160,4188,4245,4185,4213,4202,53,42,32,1344740,118
971,a1603,20150422,4213,4202,4260,4299,4260,4263,4271,61,69,18,768800,118
972,a1603,20150423,4263,4271,4271,4271,4271,4271,4271,0,0,2,85420,118
973,a1603,20150424,4271,4271,4317,4349,4317,4349,4336,78,65,32,1387700,116
974,a1603,20150427,4349,4336,4377,4377,4377,4377,4377,41,41,2,87540,116
975,a1603,20150428,4377,4377,0,0,0,4377,4377,0,0,0,0,116
976,a1603,20150429,4377,4377,4376,4376,4371,4371,4374,-6,-3,12,524900,114
977,a1603,20150430,4371,4374,4446,4446,4446,4446,4446,72,72,2,88920,114
978,a1603,20150504,4446,4446,4430,4430,4416,4418,4419,-28,-27,14,618760,116
979,a1603,20150505,4418,4419,4415,4415,4415,4415,4415,-4,-4,2,88300,116
980,a1603,20150506,4415,4415,4421,4421,4421,4421,4421,6,6,6,265260,116
981,a1603,20150507,4421,4421,4425,4448,4412,4445,4427,24,6,20,885440,112
982,a1603,20150508,4445,4427,4399,4399,4399,4399,4399,-28,-28,4,175960,112
983,a1603,20150511,4399,4399,0,0,0,4460,4460,61,61,0,0,112
984,a1603,20150512,4460,4460,4474,4501,4474,4482,4484,22,24,16,717540,110
985,a1603,20150513,4482,4484,4526,4526,4500,4500,4516,16,32,8,361320,110
986,a1603,20150514,4500,4516,4500,4500,4500,4500,4500,-16,-16,2,90000,110
987,a1603,20150515,4500,4500,4500,4500,4500,4500,4500,0,0,2,90000,110
988,a1603,20150518,4500,4500,4490,4513,4471,4513,4490,13,-10,62,2783900,108
989,a1603,20150519,4513,4490,4493,4493,4470,4470,4487,-20,-3,10,448780,108
990,a1603,20150520,4470,4487,4464,4464,4464,4464,4464,-23,-23,6,267840,102
991,a1603,20150521,4464,4464,4472,4472,4472,4472,4472,8,8,6,268320,102
992,a1603,20150522,4472,4472,0,0,0,4569,4569,97,97,0,0,102
993,a1603,20150525,4569,4569,4565,4565,4565,4565,4565,-4,-4,4,182600,106
994,a1603,20150526,4565,4565,4566,4577,4530,4530,4563,-35,-2,12,547620,106
995,a1603,20150527,4530,4563,4561,4561,4561,4561,4561,-2,-2,12,547320,106
996,a1603,20150528,4561,4561,0,0,0,4572,4572,11,11,0,0,106
997,a1603,20150529,4572,4572,0,0,0,4565,4565,-7,-7,0,0,106
998,a1603,20150601,4565,4565,4574,4574,4555,4555,4564,-10,-1,12,547740,106
999,a1603,20150602,4555,4564,0,0,0,4545,4545,-19,-19,0,0,106
1000,a1603,20150603,4545,4545,0,0,0,4567,4567,22,22,0,0,106
1001,a1603,20150604,4567,4567,0,0,0,4532,4532,-35,-35,0,0,106
1002,a1603,20150605,4532,4532,0,0,0,4488,4488,-44,-44,0,0,106
1003,a1603,20150608,4488,4488,4445,4450,4437,4450,4444,-38,-44,12,533320,102
1004,a1603,20150609,4450,4444,4470,4470,4446,4446,4455,2,11,14,623720,104
1005,a1603,20150610,4446,4455,4462,4462,4444,4454,4451,-1,-4,22,979380,108
1006,a1603,20150611,4454,4451,0,0,0,4458,4458,7,7,0,0,108
1007,a1603,20150612,4458,4458,4437,4437,4359,4363,4394,-95,-64,38,1669860,110
1008,a1603,20150615,4363,4394,4360,4360,4356,4356,4358,-38,-36,12,522960,110
1009,a1603,20150616,4356,4358,4347,4374,4342,4356,4353,-2,-5,10,435380,110
1010,a1603,20150617,4356,4353,4420,4423,4389,4390,4409,37,56,12,529080,112
1011,a1603,20150618,4390,4409,4410,4421,4406,4409,4414,0,5,24,1059560,118
1012,a1603,20150619,4409,4414,4370,4370,4370,4370,4370,-44,-44,2,87400,118
1013,a1603,20150623,4370,4370,4424,4435,4415,4435,4424,65,54,10,442440,112
1014,a1603,20150624,4435,4424,0,0,0,4394,4394,-30,-30,0,0,112
1015,a1603,20150625,4394,4394,0,0,0,4391,4391,-3,-3,0,0,112
1016,a1603,20150626,4391,4391,4401,4415,4359,4359,4397,-32,6,12,527680,108
1017,a1603,20150629,4359,4397,0,0,0,4358,4358,-39,-39,0,0,108
1018,a1603,20150630,4358,4358,0,0,0,4321,4321,-37,-37,0,0,108
1019,a1603,20150701,4321,4321,4273,4376,4273,4350,4322,29,1,8,345780,110
1020,a1603,20150702,4350,4322,4317,4317,4317,4317,4317,-5,-5,2,86340,110
1021,a1603,20150703,4317,4317,4318,4318,4302,4302,4309,-15,-8,6,258540,110
1022,a1603,20150706,4302,4309,4263,4299,4140,4254,4256,-55,-53,30,1276920,112
1023,a1603,20150707,4254,4256,4246,4283,4200,4200,4243,-56,-13,26,1103300,106
1024,a1603,20150708,4200,4243,4111,4116,4074,4075,4080,-168,-163,26,1060920,88
1025,a1603,20150709,4075,4080,4116,4183,4116,4183,4138,103,58,22,910540,74
1026,a1603,20150710,4183,4138,4282,4303,4282,4303,4298,165,160,20,859760,70
1027,a1603,20150713,4303,4298,4326,4380,4260,4327,4319,29,21,76,3282500,70
1028,a1603,20150714,4327,4319,4326,4326,4291,4300,4309,-19,-10,20,861940,58
1029,a1603,20150715,4300,4309,4303,4303,4300,4300,4301,-9,-8,6,258060,58
1030,a1603,20150716,4300,4301,0,0,0,4243,4243,-58,-58,0,0,58
1031,a1603,20150717,4243,4243,4303,4303,4208,4248,4257,5,14,12,510900,58
1032,a1603,20150720,4248,4257,4213,4273,4213,4258,4248,1,-9,6,254880,58
1033,a1603,20150721,4258,4248,4217,4221,4212,4221,4216,-27,-32,6,253000,58
1034,a1603,20150722,4221,4216,4194,4206,4194,4197,4198,-19,-18,20,839720,58
1035,a1603,20150723,4197,4198,0,0,0,4201,4201,3,3,0,0,58
1036,a1603,20150724,4201,4201,4162,4247,4162,4247,4206,46,5,16,673000,60
1037,a1603,20150727,4247,4206,0,0,0,4191,4191,-15,-15,0,0,60
1038,a1603,20150728,4191,4191,4183,4186,4183,4186,4184,-5,-7,4,167380,60
1039,a1603,20150729,4186,4184,4245,4278,4245,4278,4261,94,77,4,170460,58
1040,a1603,20150730,4278,4261,0,0,0,4298,4298,37,37,0,0,58
1041,a1603,20150731,4298,4298,4322,4322,4322,4322,4322,24,24,2,86440,58
1042,a1603,20150803,4322,4322,4319,4319,4319,4319,4319,-3,-3,2,86380,60
1043,a1603,20150804,4319,4319,4316,4317,4302,4314,4311,-5,-8,46,1983400,64
1044,a1603,20150805,4314,4311,0,0,0,4311,4311,0,0,0,0,64
1045,a1603,20150806,4311,4311,4336,4386,4336,4386,4365,75,54,8,349220,60
1046,a1603,20150807,4386,4365,0,0,0,4365,4365,0,0,0,0,60
1047,a1603,20150810,4365,4365,0,0,0,4368,4368,3,3,0,0,60
1048,a1603,20150811,4368,4368,4500,4500,4401,4435,4438,67,70,28,1242880,60
1049,a1603,20150812,4435,4438,0,0,0,4438,4438,0,0,0,0,60
1050,a1603,20150813,4438,4438,4422,4422,4386,4386,4404,-52,-34,4,176160,58
1051,a1603,20150814,4386,4404,0,0,0,4400,4400,-4,-4,0,0,58
1052,a1603,20150817,4400,4400,0,0,0,4418,4418,18,18,0,0,58
1053,a1603,20150818,4418,4418,0,0,0,4404,4404,-14,-14,0,0,58
1054,a1603,20150819,4404,4404,0,0,0,4361,4361,-43,-43,0,0,58
1055,a1603,20150820,4361,4361,0,0,0,4345,4345,-16,-16,0,0,58
1056,a1603,20150821,4345,4345,4316,4316,4315,4315,4315,-30,-30,4,172620,58
1057,a1603,20150824,4315,4315,4232,4232,4211,4211,4225,-104,-90,6,253500,64
1058,a1603,20150825,4211,4225,4233,4348,4166,4266,4272,41,47,84,3589260,60
1059,a1603,20150826,4266,4272,0,0,0,4293,4293,21,21,0,0,60
1060,a1603,20150827,4293,4293,4265,4265,4263,4263,4264,-30,-29,6,255860,58
1061,a1603,20150828,4263,4264,4163,4213,4163,4213,4188,-51,-76,4,167520,58
1062,a1603,20150831,4213,4188,0,0,0,4190,4190,2,2,0,0,58
1063,a1603,20150901,4190,4190,0,0,0,4213,4213,23,23,0,0,58
1064,a1603,20150902,4213,4213,4218,4236,4215,4219,4220,6,7,44,1857060,72
1065,a1603,20150907,4219,4220,0,0,0,4179,4179,-41,-41,0,0,72
1066,a1603,20150908,4179,4179,4177,4211,4154,4154,4178,-25,-1,10,417840,72
1067,a1603,20150909,4154,4178,4195,4195,4133,4133,4175,-45,-3,10,417500,74
1068,a1603,20150910,4133,4175,4134,4150,4134,4150,4137,-25,-38,276,11420680,346
1069,a1603,20150911,4150,4137,4163,4163,4163,4163,4163,26,26,4,166520,346
1070,a1603,20150914,4163,4163,4151,4151,4151,4151,4151,-12,-12,4,166040,346
1071,a1603,20150915,4151,4151,4169,4169,4123,4123,4146,-28,-5,4,165840,346
1072,a1603,20150916,4123,4146,4120,4177,4120,4136,4138,-10,-8,8,331060,344
1073,a1603,20150917,4136,4138,4145,4145,4145,4145,4145,7,7,2,82900,344
1074,a1603,20150918,4145,4145,4134,4134,4134,4134,4134,-11,-11,4,165360,344
1075,a1603,20150921,4134,4134,4105,4124,4065,4124,4092,-10,-42,174,7121160,188
1076,a1603,20150922,4124,4092,4063,4120,4063,4112,4108,20,16,76,3122400,124
1077,a1603,20150923,4112,4108,4095,4098,4090,4090,4091,-18,-17,22,900060,102
1078,a1603,20150924,4090,4091,4114,4114,4114,4114,4114,23,23,4,164560,98
1079,a1603,20150925,4114,4114,4060,4090,4060,4070,4079,-44,-35,66,2692180,40
1080,a1603,20150928,4070,4079,4040,4040,4040,4040,4040,-39,-39,2,80800,38
1081,a1603,20150929,4040,4040,0,0,0,4050,4050,10,10,0,0,38
1082,a1603,20150930,4050,4050,0,0,0,4082,4082,32,32,0,0,38
1083,a1603,20151008,4082,4082,4040,4040,3951,3951,3964,-131,-118,22,872100,38
1084,a1603,20151009,3951,3964,3909,3909,3909,3909,3909,-55,-55,2,78180,38
1085,a1603,20151012,3909,3909,0,0,0,3909,3909,0,0,0,0,38
1086,a1603,20151013,3909,3909,0,0,0,3909,3909,0,0,0,0,38
1087,a1603,20151014,3909,3909,3959,4004,3836,3952,3946,43,37,20,789380,38
1088,a1603,20151015,3952,3946,3868,3951,3868,3943,3909,-3,-37,72,2814600,54
1089,a1603,20151016,3943,3909,3922,3941,3903,3910,3927,1,18,28,1099560,38
1090,a1603,20151019,3910,3927,0,0,0,3927,3927,0,0,0,0,38
1091,a1603,20151020,3927,3927,3886,3904,3885,3900,3895,-27,-32,32,1246620,24
1092,a1603,20151021,3900,3895,3915,3915,3915,3915,3915,20,20,2,78300,22
1093,a1603,20151022,3915,3915,3950,3950,3950,3950,3950,35,35,2,79000,22
1094,a1603,20151023,3950,3950,3951,3951,3917,3917,3934,-33,-16,4,157360,22
1095,a1603,20151026,3917,3934,3914,3917,3914,3917,3916,-17,-18,10,391600,18
1096,a1603,20151027,3917,3916,3813,3878,3813,3878,3845,-38,-71,20,769100,18
1097,a1603,20151028,3878,3845,3865,3892,3832,3892,3863,47,18,46,1777380,52
1098,a1603,20151029,3892,3863,3853,3853,3850,3850,3851,-13,-12,4,154060,54
1099,a1603,20151030,3850,3851,3806,3836,3806,3810,3813,-41,-38,18,686440,62
1100,a1603,20151102,3810,3813,3804,3804,3804,3804,3804,-9,-9,2,76080,60
1101,a1603,20151103,3804,3804,3805,3825,3805,3825,3820,21,16,8,305600,54
1102,a1603,20151104,3825,3820,3808,3830,3808,3830,3819,10,-1,4,152760,56
1103,a1603,20151105,3830,3819,3841,3841,3819,3819,3830,0,11,4,153200,54
1104,a1603,20151106,3819,3830,3798,3840,3738,3840,3806,10,-24,12,456760,52
1105,a1603,20151109,3840,3806,0,0,0,3806,3806,0,0,0,0,52
1106,a1603,20151110,3806,3806,3792,3816,3792,3816,3801,10,-5,6,228080,52
1107,a1603,20151111,3816,3801,3773,3784,3773,3784,3778,-17,-23,4,151140,52
1108,a1603,20151112,3784,3778,3784,3845,3784,3785,3814,7,36,8,305180,50
1109,a1603,20151113,3785,3814,3817,3820,3696,3813,3810,-1,-4,56,2133880,72
1110,a1603,20151116,3813,3810,3782,3782,3660,3709,3696,-101,-114,130,4805880,66
1111,a1603,20151117,3709,3696,3673,3688,3585,3688,3648,-8,-48,6,218920,68
1112,a1603,20151118,3688,3648,3613,3690,3613,3657,3667,9,19,24,880140,76
1113,a1603,20151119,3657,3667,3654,3654,3654,3654,3654,-13,-13,2,73080,76
1114,a1603,20151120,3654,3654,3636,3690,3573,3690,3635,36,-19,28,1017800,76
1115,a1603,20151123,3690,3635,3618,3699,3601,3686,3651,51,16,8,292080,76
1116,a1603,20151124,3686,3651,3741,3742,3741,3742,3741,91,90,6,224500,72
1117,a1603,20151125,3742,3741,3676,3700,3676,3700,3698,-41,-43,64,2367040,128
1118,a1603,20151126,3700,3698,3677,3678,3656,3674,3667,-24,-31,54,1980440,160
1119,a1603,20151127,3674,3667,3654,3660,3607,3629,3634,-38,-33,56,2035420,160
1120,a1603,20151130,3629,3634,3607,3655,3607,3645,3627,11,-7,32,1160780,172
1121,a1603,20151201,3645,3627,3629,3633,3614,3626,3628,-1,1,58,2104720,208
1122,a1603,20151202,3626,3628,3645,3645,3618,3628,3631,0,3,98,3558900,222
1123,a1603,20151203,3628,3631,3629,3636,3621,3636,3631,5,0,100,3631640,290
1124,a1603,20151204,3636,3631,3634,3659,3631,3647,3645,16,14,218,7948260,446
1125,a1603,20151207,3647,3645,3640,3658,3630,3658,3647,13,2,82,2991120,522
1126,a1603,20151208,3658,3647,3636,3647,3632,3635,3642,-12,-5,118,4297680,546
1127,a1603,20151209,3635,3642,3636,3640,3635,3637,3637,-5,-5,62,2255220,562
1128,a1603,20151210,3637,3637,3634,3635,3622,3635,3631,-2,-6,26,944240,568
1129,a1603,20151211,3635,3631,3635,3642,3631,3641,3634,10,3,24,872260,576
1130,a1603,20151214,3641,3634,0,0,0,3634,3634,0,0,0,0,576
1131,a1603,20151215,3634,3634,3601,3628,3581,3581,3605,-53,-29,16,576920,574
1132,a1603,20151216,3581,3605,3613,3613,3613,3613,3613,8,8,2,72260,572
1133,a1603,20151217,3613,3613,0,0,0,3613,3613,0,0,0,0,572
1134,a1603,20151218,3613,3613,3655,3660,3619,3637,3636,24,23,22,800040,574
1135,a1603,20151221,3637,3636,3630,3665,3630,3641,3648,5,12,42,1532380,588
1136,a1603,20151222,3641,3648,3636,3653,3630,3647,3643,-1,-5,50,1821560,618
1137,a1603,20151223,3647,3643,3625,3632,3612,3629,3622,-14,-21,68,2463280,654
1138,a1603,20151224,3629,3622,3625,3625,3595,3595,3620,-27,-2,12,434400,654
1139,a1603,20151225,3595,3620,3622,3629,3477,3553,3578,-67,-42,156,5581760,772
1140,a1603,20151228,3553,3578,3559,3579,3481,3519,3540,-59,-38,36,1274740,776
1141,a1603,20151229,3519,3540,3550,3550,3492,3500,3507,-40,-33,104,3647380,852
1142,a1603,20151230,3500,3507,3505,3505,3462,3483,3493,-24,-14,302,10549300,1018
1143,a1603,20151231,3483,3493,3484,3493,3470,3474,3482,-19,-11,16362,569826520,1116
1144,a1605,20150105,4455,4455,4455,4457,4440,4440,4449,-15,-6,8,355940,64
1145,a1605,20150106,4440,4449,4458,4458,4451,4451,4454,2,5,4,178180,66
1146,a1605,20150107,4451,4454,0,0,0,4457,4457,3,3,0,0,66
1147,a1605,20150108,4457,4457,0,0,0,4457,4457,0,0,0,0,66
1148,a1605,20150109,4457,4457,0,0,0,4457,4457,0,0,0,0,66
1149,a1605,20150112,4457,4457,4460,4480,4460,4460,4466,3,9,8,357320,70
1150,a1605,20150113,4460,4466,4442,4445,4420,4420,4433,-46,-33,14,620660,72
1151,a1605,20150114,4420,4433,4416,4437,4416,4418,4425,-15,-8,18,796560,76
1152,a1605,20150115,4418,4425,4408,4439,4408,4439,4420,14,-5,16,707220,82
1153,a1605,20150116,4439,4420,0,0,0,4420,4420,0,0,0,0,82
1154,a1605,20150119,4420,4420,4439,4440,4398,4413,4416,-7,-4,28,1236700,72
1155,a1605,20150120,4413,4416,4400,4400,4375,4376,4390,-40,-26,16,702520,78
1156,a1605,20150121,4376,4390,4361,4380,4359,4380,4367,-10,-23,24,1048080,88
1157,a1605,20150122,4380,4367,4344,4345,4338,4338,4342,-29,-25,6,260540,90
1158,a1605,20150123,4338,4342,4323,4323,4317,4319,4319,-23,-23,26,1123040,106
1159,a1605,20150126,4319,4319,4305,4334,4305,4312,4315,-7,-4,38,1639740,106
1160,a1605,20150127,4312,4315,4326,4343,4326,4343,4332,28,17,10,433280,96
1161,a1605,20150128,4343,4332,4341,4341,4339,4339,4340,7,8,6,260420,96
1162,a1605,20150129,4339,4340,4321,4366,4316,4364,4354,24,14,202,8795520,210
1163,a1605,20150130,4364,4354,4375,4375,4375,4375,4378,21,24,22,963280,202
1164,a1605,20150202,4375,4378,4363,4380,4363,4380,4375,2,-3,30,1312580,190
1165,a1605,20150203,4380,4375,4383,4398,4383,4391,4387,16,12,38,1667160,172
1166,a1605,20150204,4391,4387,4406,4406,4396,4396,4401,9,14,4,176040,172
1167,a1605,20150205,4396,4401,4379,4398,4378,4380,4385,-21,-16,16,701680,168
1168,a1605,20150206,4380,4385,4385,4397,4385,4397,4391,12,6,20,878340,164
1169,a1605,20150209,4397,4391,4388,4388,4380,4384,4384,-7,-7,6,263040,164
1170,a1605,20150210,4384,4384,4380,4380,4380,4380,4380,-4,-4,2,87600,166
1171,a1605,20150211,4380,4380,0,0,0,4380,4380,0,0,0,0,166
1172,a1605,20150212,4380,4380,0,0,0,4380,4380,0,0,2,87820,166
1173,a1605,20150213,4380,4380,4398,4426,4206,4206,4337,-174,-43,84,3643900,210
1174,a1605,20150216,4206,4337,4206,4397,4206,4367,4367,30,30,152,6638460,174
1175,a1605,20150217,4367,4367,0,0,0,4367,4367,0,0,0,0,174
1176,a1605,20150225,4367,4367,4358,4358,4354,4354,4354,-13,-13,24,1045040,198
1177,a1605,20150226,4354,4354,4352,4360,4348,4358,4351,4,-3,60,2610720,240
1178,a1605,20150227,4358,4351,4375,4399,4365,4391,4382,40,31,62,2717340,256
1179,a1605,20150302,4391,4382,4404,4410,4388,4401,4400,19,18,88,3872640,286
1180,a1605,20150303,4401,4400,4413,4413,4386,4400,4400,0,0,88,3872780,242
1181,a1605,20150304,4400,4400,4405,4405,4405,4405,4405,5,5,2,88100,244
1182,a1605,20150305,4405,4405,4402,4404,4362,4367,4380,-38,-25,104,4555260,298
1183,a1605,20150306,4367,4380,4367,4367,4365,4365,4366,-15,-14,4,174640,298
1184,a1605,20150309,4365,4366,4357,4374,4355,4365,4366,-1,0,44,1921180,300
1185,a1605,20150310,4365,4366,4373,4375,4322,4338,4343,-28,-23,186,8079120,462
1186,a1605,20150311,4338,4343,4326,4364,4325,4364,4351,21,8,66,2871700,450
1187,a1605,20150312,4364,4351,4364,4368,4356,4357,4362,6,11,18,785240,458
1188,a1605,20150313,4357,4362,4350,4350,4344,4344,4347,-18,-15,4,173880,458
1189,a1605,20150316,4344,4347,4349,4352,4331,4331,4338,-16,-9,28,1214780,480
1190,a1605,20150317,4331,4338,4355,4355,4355,4355,4355,17,17,2,87100,480
1191,a1605,20150318,4355,4355,4354,4354,4340,4340,4348,-15,-7,6,260880,480
1192,a1605,20150319,4340,4348,4349,4369,4339,4350,4354,2,6,144,6270740,600
1193,a1605,20150320,4350,4354,4345,4358,4339,4348,4345,-6,-9,230,9995280,806
1194,a1605,20150323,4348,4345,4351,4365,4348,4351,4357,6,12,72,3137560,836
1195,a1605,20150324,4351,4357,4353,4363,4303,4342,4338,-15,-19,182,7896900,968
1196,a1605,20150325,4342,4338,4330,4354,4310,4310,4325,-28,-13,228,9862840,1174
1197,a1605,20150326,4310,4325,4319,4328,4300,4304,4308,-21,-17,374,16113180,1434
1198,a1605,20150327,4304,4308,4305,4328,4305,4320,4311,12,3,116,5001160,1444
1199,a1605,20150330,4320,4311,4311,4320,4286,4320,4294,9,-17,216,9276840,1632
1200,a1605,20150331,4320,4294,4299,4302,4296,4302,4299,8,5,12,515940,1630
1201,a1605,20150401,4302,4299,4320,4337,4320,4321,4324,22,25,22,951480,1636
1202,a1605,20150402,4321,4324,4320,4332,4304,4304,4317,-20,-7,24,1036100,1650
1203,a1605,20150403,4304,4317,4252,4285,4252,4278,4274,-39,-43,248,10599800,1870
1204,a1605,20150407,4278,4274,4271,4271,4247,4247,4256,-27,-18,62,2638860,1904
1205,a1605,20150408,4247,4256,4234,4234,4193,4200,4209,-56,-47,104,4377460,1940
1206,a1605,20150409,4200,4209,4202,4205,4166,4167,4173,-42,-36,204,8514820,2000
1207,a1605,20150410,4167,4173,4197,4197,4168,4173,4181,0,8,126,5269180,1986
1208,a1605,20150413,4173,4181,4182,4247,4181,4235,4213,54,32,182,7668500,2108
1209,a1605,20150414,4235,4213,4247,4271,4241,4271,4247,58,34,114,4842480,2152
1210,a1605,20150415,4271,4247,4266,4288,4259,4259,4272,12,25,62,2648780,2158
1211,a1605,20150416,4259,4272,4266,4280,4266,4266,4270,-6,-2,18,768600,2160
1212,a1605,20150417,4266,4270,4256,4264,4225,4225,4239,-45,-31,864,36626320,2596
1213,a1605,20150420,4225,4239,4233,4233,4160,4196,4192,-43,-47,200,8384860,2598
1214,a1605,20150421,4196,4192,4203,4245,4203,4240,4231,48,39,614,25979060,2322
1215,a1605,20150422,4240,4231,4264,4338,4261,4338,4296,107,65,864,37121240,2236
1216,a1605,20150423,4338,4296,4332,4351,4305,4328,4327,32,31,600,25966560,2364
1217,a1605,20150424,4328,4327,4355,4407,4355,4387,4390,60,63,72,3160820,2386
1218,a1605,20150427,4387,4390,4387,4414,4376,4399,4394,9,4,38,1669720,2390
1219,a1605,20150428,4399,4394,4400,4406,4379,4400,4394,6,0,48,2109200,2392
1220,a1605,20150429,4400,4394,4414,4414,4384,4403,4396,9,2,112,4924140,2330
1221,a1605,20150430,4403,4396,4457,4478,4413,4478,4455,82,59,702,31274660,2154
1222,a1605,20150504,4478,4455,4437,4443,4434,4442,4443,-13,-12,38,1688480,2148
1223,a1605,20150505,4442,4443,4442,4462,4411,4439,4448,-4,5,66,2935800,2152
1224,a1605,20150506,4439,4448,4449,4489,4434,4463,4463,15,15,180,8034980,2124
1225,a1605,20150507,4463,4463,4451,4461,4438,4461,4456,-2,-7,42,1871860,2132
1226,a1605,20150508,4461,4456,4442,4452,4420,4452,4438,-4,-18,44,1952820,2140
1227,a1605,20150511,4452,4438,4467,4515,4445,4508,4494,70,56,224,10067700,2188
1228,a1605,20150512,4508,4494,4502,4528,4494,4512,4503,18,9,336,15131220,2134
1229,a1605,20150513,4512,4503,4503,4529,4500,4523,4523,20,20,868,39264740,2510
1230,a1605,20150514,4523,4523,4524,4544,4500,4533,4527,10,4,564,25533180,2762
1231,a1605,20150515,4533,4527,4532,4536,4523,4532,4529,5,2,120,5435980,2782
1232,a1605,20150518,4532,4529,4520,4520,4492,4514,4503,-15,-26,708,31882420,3144
1233,a1605,20150519,4514,4503,4516,4529,4510,4511,4519,8,16,890,40222920,3656
1234,a1605,20150520,4511,4519,4505,4514,4470,4485,4494,-34,-25,1504,67604140,4704
1235,a1605,20150521,4485,4494,4486,4516,4472,4493,4492,-1,-2,970,43573380,5086
1236,a1605,20150522,4493,4492,4500,4651,4500,4629,4594,137,102,3698,169902680,7490
1237,a1605,20150525,4629,4594,4639,4646,4596,4615,4618,21,24,3280,151477780,8952
1238,a1605,20150526,4615,4618,4607,4640,4606,4608,4621,-10,3,1258,58144200,9608
1239,a1605,20150527,4608,4621,4611,4625,4580,4583,4594,-38,-27,634,29127440,9778
1240,a1605,20150528,4583,4594,4606,4627,4586,4602,4611,8,17,1426,65761080,10452
1241,a1605,20150529,4602,4611,4606,4618,4591,4605,4603,-6,-8,682,31393140,10446
1242,a1605,20150601,4605,4603,4608,4615,4535,4546,4583,-57,-20,1146,52523940,10796
1243,a1605,20150602,4546,4583,4542,4575,4532,4570,4560,-13,-23,680,31011120,10962
1244,a1605,20150603,4570,4560,4574,4601,4574,4584,4587,24,27,1658,76066320,10886
1245,a1605,20150604,4584,4587,4584,4584,4536,4555,4556,-32,-31,552,25153860,10754
1246,a1605,20150605,4555,4556,4555,4557,4476,4479,4508,-77,-48,950,42829400,10712
1247,a1605,20150608,4479,4508,4490,4508,4467,4472,4489,-36,-19,892,40046100,10602
1248,a1605,20150609,4472,4489,4480,4523,4478,4478,4501,-11,12,704,31691380,10584
1249,a1605,20150610,4478,4501,4489,4510,4479,4486,4496,-15,-5,812,36512640,10394
1250,a1605,20150611,4486,4496,4505,4506,4483,4486,4493,-10,-3,802,36035360,10378
1251,a1605,20150612,4486,4493,4487,4487,4380,4380,4423,-113,-70,1550,68568140,10436
1252,a1605,20150615,4380,4423,4399,4399,4351,4353,4378,-70,-45,1002,43872280,10612
1253,a1605,20150616,4353,4378,4358,4424,4350,4386,4394,8,16,1108,48688280,10760
1254,a1605,20150617,4386,4394,4386,4445,4377,4425,4417,31,23,1130,49917460,10798
1255,a1605,20150618,4425,4417,4446,4468,4415,4428,4447,11,30,834,37094780,10918
1256,a1605,20150619,4428,4447,4435,4437,4403,4427,4415,-20,-32,384,16956240,10778
1257,a1605,20150623,4427,4415,4465,4477,4431,4445,4445,30,30,832,36985820,11062
1258,a1605,20150624,4445,4445,4445,4445,4400,4416,4418,-29,-27,430,18999360,11018
1259,a1605,20150625,4416,4418,4416,4444,4402,4410,4416,-8,-2,550,24289820,11016
1260,a1605,20150626,4410,4416,4418,4433,4371,4383,4410,-33,-6,1222,53892060,11190
1261,a1605,20150629,4383,4410,4415,4434,4351,4375,4378,-35,-32,1022,44746280,11298
1262,a1605,20150630,4375,4378,4375,4375,4314,4318,4341,-60,-37,678,29432480,11146
1263,a1605,20150701,4318,4341,4318,4436,4297,4385,4380,44,39,1950,85425940,11192
1264,a1605,20150702,4385,4380,4372,4384,4353,4370,4365,-10,-15,874,38156460,11156
1265,a1605,20150703,4370,4365,4362,4390,4362,4377,4381,12,16,1374,60198820,11138
1266,a1605,20150706,4377,4381,4351,4365,4316,4330,4339,-51,-42,1292,56070400,11138
1267,a1605,20150707,4330,4339,4323,4345,4300,4303,4321,-36,-18,1256,54278980,11274
1268,a1605,20150708,4303,4321,4295,4295,4149,4181,4199,-140,-122,6078,255263320,10936
1269,a1605,20150709,4181,4199,4202,4366,4184,4352,4280,153,81,4112,176025340,11200
1270,a1605,20150710,4352,4280,4352,4450,4350,4416,4402,136,122,4274,188159000,11766
1271,a1605,20150713,4416,4402,4419,4429,4363,4398,4392,-4,-10,2102,92327320,11352
1272,a1605,20150714,4398,4392,4398,4418,4379,4398,4397,6,5,2768,121723800,11538
1273,a1605,20150715,4398,4397,4397,4401,4350,4360,4368,-37,-29,618,26995220,11488
1274,a1605,20150716,4360,4368,4353,4369,4285,4347,4332,-21,-36,2112,91496180,11586
1275,a1605,20150717,4347,4332,4372,4372,4312,4339,4340,7,8,988,42887200,11546
1276,a1605,20150720,4339,4340,4338,4339,4270,4288,4306,-52,-34,1378,59346880,11910
1277,a1605,20150721,4288,4306,4277,4317,4277,4296,4298,-10,-8,572,24585960,12036
1278,a1605,20150722,4296,4298,4288,4300,4259,4284,4275,-14,-23,2260,96632260,12442
1279,a1605,20150723,4284,4275,4280,4306,4259,4296,4285,21,10,1554,66589320,12216
1280,a1605,20150724,4296,4285,4296,4324,4281,4300,4304,15,19,2896,124667300,12704
1281,a1605,20150727,4300,4304,4290,4308,4262,4268,4278,-36,-26,2218,94890880,12866
1282,a1605,20150728,4268,4278,4230,4305,4227,4303,4267,25,-11,1990,84926780,13036
1283,a1605,20150729,4303,4267,4320,4371,4308,4371,4347,104,80,5670,246498320,15432
1284,a1605,20150730,4371,4347,4361,4403,4357,4361,4376,14,29,1670,73095540,15296
1285,a1605,20150731,4361,4376,4375,4390,4355,4376,4370,0,-6,1418,61969920,15698
1286,a1605,20150803,4376,4370,4380,4388,4310,4340,4342,-30,-28,1988,86330160,15686
1287,a1605,20150804,4340,4342,4341,4376,4329,4375,4358,33,16,1746,76094160,15882
1288,a1605,20150805,4375,4358,4381,4390,4356,4370,4370,12,12,1630,71240400,15846
1289,a1605,20150806,4370,4370,4381,4454,4366,4445,4417,75,47,7966,351887520,18630
1290,a1605,20150807,4445,4417,4433,4454,4397,4435,4421,18,4,5248,232038620,20156
1291,a1605,20150810,4435,4421,4435,4482,4430,4471,4460,50,39,5246,234006760,22368
1292,a1605,20150811,4471,4460,4474,4497,4460,4485,4485,25,25,5810,260602160,24476
1293,a1605,20150812,4485,4485,4477,4496,4462,4494,4480,9,-5,2850,127704940,24412
1294,a1605,20150813,4494,4480,4499,4527,4390,4449,4455,-31,-25,4086,182035800,24332
1295,a1605,20150814,4449,4455,4453,4477,4440,4461,4461,6,6,2696,120284460,25646
1296,a1605,20150817,4461,4461,4471,4485,4453,4476,4470,15,9,4274,191065360,27054
1297,a1605,20150818,4476,4470,4478,4491,4421,4421,4455,-49,-15,6044,269277880,26592
1298,a1605,20150819,4421,4455,4421,4445,4401,4429,4422,-26,-33,7816,345629240,26126
1299,a1605,20150820,4429,4422,4440,4447,4395,4412,4431,-10,9,13574,601582320,29220
1300,a1605,20150821,4412,4431,4413,4450,4409,4422,4429,-9,-2,9420,417220600,30606
1301,a1605,20150824,4422,4429,4423,4424,4319,4337,4361,-92,-68,13454,586791560,29724
1302,a1605,20150825,4337,4361,4300,4377,4293,4343,4346,-18,-15,13582,590373060,28860
1303,a1605,20150826,4343,4346,4366,4400,4332,4339,4361,-7,15,13840,603630620,30740
1304,a1605,20150827,4339,4361,4340,4355,4296,4339,4330,-22,-31,10008,433372680,28296
1305,a1605,20150828,4339,4330,4339,4371,4266,4275,4308,-55,-22,19642,846277380,31868
1306,a1605,20150831,4275,4308,4273,4310,4254,4281,4282,-27,-26,16298,697960320,32484
1307,a1605,20150901,4281,4282,4275,4319,4269,4309,4302,27,20,15160,652302580,35394
1308,a1605,20150902,4309,4302,4300,4324,4290,4316,4308,14,6,5832,251269180,35694
1309,a1605,20150907,4316,4308,4302,4305,4257,4262,4275,-46,-33,6304,269550040,35104
1310,a1605,20150908,4262,4275,4266,4288,4240,4281,4259,6,-16,8210,349710960,35962
1311,a1605,20150909,4281,4259,4275,4310,4259,4263,4288,4,29,10694,458601140,36240
1312,a1605,20150910,4263,4288,4275,4298,4251,4290,4273,2,-15,7640,326507920,36298
1313,a1605,20150911,4290,4273,4273,4336,4271,4303,4305,30,32,12814,551730920,36880
1314,a1605,20150914,4303,4305,4300,4316,4276,4280,4301,-25,-4,8026,345265420,37454
1315,a1605,20150915,4280,4301,4282,4307,4270,4275,4293,-26,-8,9666,414984300,37678
1316,a1605,20150916,4275,4293,4256,4301,4251,4300,4273,7,-20,11370,485858020,36450
1317,a1605,20150917,4300,4273,4300,4307,4280,4281,4292,8,19,8732,374785800,36274
1318,a1605,20150918,4281,4292,4278,4300,4260,4262,4280,-30,-12,7638,326918840,36296
1319,a1605,20150921,4262,4280,4260,4270,4195,4230,4217,-50,-63,20894,881274020,38786
1320,a1605,20150922,4230,4217,4232,4239,4189,4198,4208,-19,-9,10258,431710620,38990
1321,a1605,20150923,4198,4208,4197,4199,4168,4187,4183,-21,-25,11582,484543180,39822
1322,a1605,20150924,4187,4183,4190,4208,4164,4170,4181,-13,-2,13652,570807080,43054
1323,a1605,20150925,4170,4181,4166,4198,4134,4164,4171,-17,-10,27244,1136496780,44406
1324,a1605,20150928,4164,4171,4178,4192,4144,4151,4160,-20,-11,11154,464086580,44120
1325,a1605,20150929,4151,4160,4152,4204,4119,4203,4166,43,6,22974,957203200,43288
1326,a1605,20150930,4203,4166,4199,4225,4182,4189,4202,23,36,17464,733880500,43654
1327,a1605,20151008,4189,4202,4194,4205,4020,4042,4093,-160,-109,47622,1949478020,46164
1328,a1605,20151009,4042,4093,4050,4084,3976,4030,4028,-63,-65,80860,3257209460,47442
1329,a1605,20151012,4030,4028,4038,4094,4007,4089,4050,61,22,39138,1585397620,47002
1330,a1605,20151013,4089,4050,4082,4083,4051,4064,4065,14,15,39852,1620358720,50732
1331,a1605,20151014,4064,4065,4062,4081,4011,4040,4046,-25,-19,61302,2480845640,59220
1332,a1605,20151015,4040,4046,4055,4075,4042,4056,4057,10,11,23394,949173900,58648
1333,a1605,20151016,4056,4057,4047,4058,3960,3966,3997,-91,-60,65382,2613897860,75492
1334,a1605,20151019,3966,3997,3958,3971,3925,3939,3947,-58,-50,45062,1779004180,83842
1335,a1605,20151020,3939,3947,3918,3953,3893,3919,3923,-28,-24,51198,2008742420,93144
1336,a1605,20151021,3919,3923,3925,3935,3904,3906,3918,-17,-5,34666,1358402520,91904
1337,a1605,20151022,3906,3918,3902,3952,3875,3943,3914,25,-4,74884,2931552940,92786
1338,a1605,20151023,3943,3914,3940,3992,3888,3937,3924,23,10,61112,2398331280,87742
1339,a1605,20151026,3937,3924,3950,3952,3853,3879,3898,-45,-26,68042,2652913120,103918
1340,a1605,20151027,3879,3898,3880,3881,3822,3861,3845,-37,-53,64776,2491046320,109376
1341,a1605,20151028,3861,3845,3863,3874,3818,3827,3844,-18,-1,34962,1344197600,110900
1342,a1605,20151029,3827,3844,3822,3845,3803,3822,3826,-22,-18,43542,1666115420,112584
1343,a1605,20151030,3822,3826,3814,3847,3804,3821,3819,-5,-7,62288,2379213320,121152
1344,a1605,20151102,3821,3819,3819,3841,3819,3830,3830,11,11,27240,1043460340,122240
1345,a1605,20151103,3830,3830,3827,3844,3811,3830,3825,0,-5,31334,1198807800,125328
1346,a1605,20151104,3830,3825,3826,3895,3826,3873,3868,48,43,81780,3163877020,119180
1347,a1605,20151105,3873,3868,3861,3874,3842,3848,3859,-20,-9,33788,1303894640,121478
1348,a1605,20151106,3848,3859,3848,3862,3808,3860,3835,1,-24,51936,1991996460,123744
1349,a1605,20151109,3860,3835,3859,3889,3821,3848,3855,13,20,62646,2415625120,123770
1350,a1605,20151110,3848,3855,3844,3855,3824,3836,3836,-19,-19,36134,1386161440,125250
1351,a1605,20151111,3836,3836,3836,3860,3775,3838,3814,2,-22,100396,3829406220,136102
1352,a1605,20151112,3838,3814,3843,3872,3834,3861,3854,47,40,63370,2442795780,139854
1353,a1605,20151113,3861,3854,3851,3894,3850,3873,3874,19,20,71120,2755760900,139138
1354,a1605,20151116,3873,3874,3854,3883,3766,3767,3817,-107,-57,119724,4570519220,162382
1355,a1605,20151117,3767,3817,3777,3783,3731,3754,3759,-63,-58,142882,5371681020,188138
1356,a1605,20151118,3754,3759,3756,3790,3750,3766,3770,7,11,98602,3717969160,198544
1357,a1605,20151119,3766,3770,3767,3771,3670,3678,3714,-92,-56,190854,7090082760,211938
1358,a1605,20151120,3678,3714,3675,3696,3650,3653,3674,-61,-40,121378,4460600920,212408
1359,a1605,20151123,3653,3674,3650,3722,3642,3692,3690,18,16,189190,6982901500,220588
1360,a1605,20151124,3692,3690,3696,3753,3675,3745,3722,55,32,139250,5184018120,219458
1361,a1605,20151125,3745,3722,3745,3758,3703,3718,3729,-4,7,152714,5695652520,216906
1362,a1605,20151126,3718,3729,3710,3775,3704,3757,3749,28,20,115274,4322138500,207178
1363,a1605,20151127,3757,3749,3750,3765,3709,3727,3734,-22,-15,97476,3640260100,210150
1364,a1605,20151130,3727,3734,3727,3768,3703,3758,3735,24,1,117168,4376670260,209228
1365,a1605,20151201,3758,3735,3756,3782,3747,3768,3763,33,28,109872,4135238340,204566
1366,a1605,20151202,3768,3763,3776,3820,3730,3744,3776,-19,13,226670,8559466740,195926
1367,a1605,20151203,3744,3776,3743,3793,3717,3787,3755,11,-21,173874,6530036020,187054
1368,a1605,20151204,3787,3755,3788,3808,3772,3780,3789,25,34,123458,4678477740,180952
1369,a1605,20151207,3780,3789,3784,3815,3762,3799,3792,10,3,89570,3396978120,181308
1370,a1605,20151208,3799,3792,3803,3803,3737,3747,3763,-45,-29,147062,5533981420,187380
1371,a1605,20151209,3747,3763,3750,3755,3728,3739,3742,-24,-21,97774,3659491380,183660
1372,a1605,20151210,3739,3742,3743,3749,3712,3730,3731,-12,-11,106738,3983091620,179902
1373,a1605,20151211,3730,3731,3727,3738,3696,3730,3714,-1,-17,117402,4361118880,177732
1374,a1605,20151214,3730,3714,3725,3743,3674,3677,3701,-37,-13,145634,5390824880,196244
1375,a1605,20151215,3677,3701,3668,3689,3646,3651,3667,-50,-34,166030,6089578940,228172
1376,a1605,20151216,3651,3667,3646,3695,3644,3681,3670,14,3,122280,4488771060,208500
1377,a1605,20151217,3681,3670,3680,3720,3673,3700,3699,30,29,138740,5132335200,183156
1378,a1605,20151218,3700,3699,3700,3730,3684,3726,3705,27,6,85408,3164592920,176864
1379,a1605,20151221,3726,3705,3726,3757,3725,3749,3742,44,37,90036,3369355140,167264
1380,a1605,20151222,3749,3742,3749,3763,3705,3706,3738,-36,-4,92394,3454142560,170598
1381,a1605,20151223,3706,3738,3708,3720,3689,3713,3703,-25,-35,113010,4185263240,171656
1382,a1605,20151224,3713,3703,3713,3719,3692,3701,3706,-2,3,64164,2378354160,169784
1383,a1605,20151225,3701,3706,3697,3733,3661,3668,3697,-38,-9,134840,4985238940,185548
1384,a1605,20151228,3668,3697,3668,3676,3580,3599,3619,-98,-78,256660,9290125080,217654
1385,a1605,20151229,3599,3619,3609,3635,3589,3622,3610,3,-9,192072,6934563280,209538
1386,a1605,20151230,3622,3610,3620,3658,3612,3631,3633,21,23,147836,5371991880,197838
1387,a1605,20151231,3631,3633,3626,3632,3602,3620,3615,-13,-18,174314,6301764800,197982
1388,a1607,20150119,4420,4420,0,0,0,4420,4420,0,0,0,0,0
1389,a1607,20150120,4420,4420,4584,4584,4388,4390,4440,-30,20,8,355240,6
1390,a1607,20150121,4390,4440,0,0,0,4420,4420,-20,-20,0,0,6
1391,a1607,20150122,4420,4420,0,0,0,4395,4395,-25,-25,0,0,6
1392,a1607,20150123,4395,4395,4390,4390,4390,4390,4390,-5,-5,2,87800,8
1393,a1607,20150126,4390,4390,0,0,0,4390,4390,0,0,0,0,8
1394,a1607,20150127,4390,4390,0,0,0,4407,4407,17,17,0,0,8
1395,a1607,20150128,4407,4407,0,0,0,4399,4399,-8,-8,0,0,8
1396,a1607,20150129,4399,4399,0,0,0,4413,4413,14,14,0,0,8
1397,a1607,20150130,4413,4413,0,0,0,4413,4413,0,0,0,0,8
1398,a1607,20150202,4413,4413,0,0,0,4413,4413,0,0,0,0,8
1399,a1607,20150203,4413,4413,0,0,0,4413,4413,0,0,0,0,8
1400,a1607,20150204,4413,4413,0,0,0,4413,4413,0,0,0,0,8
1401,a1607,20150205,4413,4413,0,0,0,4413,4413,0,0,0,0,8
1402,a1607,20150206,4413,4413,4385,4430,4385,4430,4407,17,-6,4,176300,8
1403,a1607,20150209,4430,4407,0,0,0,4407,4407,0,0,0,0,8
1404,a1607,20150210,4407,4407,4380,4380,4380,4380,4380,-27,-27,2,87600,6
1405,a1607,20150211,4380,4380,0,0,0,4380,4380,0,0,0,0,6
1406,a1607,20150212,4380,4380,0,0,0,4380,4380,0,0,0,0,6
1407,a1607,20150213,4380,4380,4318,4499,4318,4381,4399,1,19,8,351940,6
1408,a1607,20150216,4381,4399,0,0,0,4399,4399,0,0,0,0,6
1409,a1607,20150217,4399,4399,4421,4421,4421,4421,4421,22,22,2,88420,6
1410,a1607,20150225,4421,4421,0,0,0,4421,4421,0,0,0,0,6
1411,a1607,20150226,4421,4421,0,0,0,4421,4421,0,0,0,0,6
1412,a1607,20150227,4421,4421,0,0,0,4421,4421,0,0,0,0,6
1413,a1607,20150302,4421,4421,0,0,0,4421,4421,0,0,0,0,6
1414,a1607,20150303,4421,4421,0,0,0,4421,4421,0,0,0,0,6
1415,a1607,20150304,4421,4421,0,0,0,4421,4421,0,0,0,0,6
1416,a1607,20150305,4421,4421,0,0,0,4421,4421,0,0,0,0,6
1417,a1607,20150306,4421,4421,0,0,0,4421,4421,0,0,0,0,6
1418,a1607,20150309,4421,4421,0,0,0,4421,4421,0,0,0,0,6
1419,a1607,20150310,4421,4421,0,0,0,4421,4421,0,0,0,0,6
1420,a1607,20150311,4421,4421,4399,4442,4392,4419,4411,-2,-10,18,793980,8
1421,a1607,20150312,4419,4411,0,0,0,4411,4411,0,0,0,0,8
1422,a1607,20150313,4411,4411,0,0,0,4411,4411,0,0,0,0,8
1423,a1607,20150316,4411,4411,0,0,0,4411,4411,0,0,0,0,8
1424,a1607,20150317,4411,4411,0,0,0,4428,4428,17,17,0,0,8
1425,a1607,20150318,4428,4428,0,0,0,4428,4428,0,0,0,0,8
1426,a1607,20150319,4428,4428,0,0,0,4434,4434,6,6,0,0,8
1427,a1607,20150320,4434,4434,0,0,0,4434,4434,0,0,0,0,8
1428,a1607,20150323,4434,4434,0,0,0,4446,4446,12,12,0,0,8
1429,a1607,20150324,4446,4446,4381,4390,4381,4390,4385,-56,-61,4,175420,6
1430,a1607,20150325,4390,4385,0,0,0,4385,4385,0,0,0,0,6
1431,a1607,20150326,4385,4385,0,0,0,4385,4385,0,0,0,0,6
1432,a1607,20150327,4385,4385,0,0,0,4388,4388,3,3,0,0,6
1433,a1607,20150330,4388,4388,0,0,0,4388,4388,0,0,0,0,6
1434,a1607,20150331,4388,4388,0,0,0,4393,4393,5,5,0,0,6
1435,a1607,20150401,4393,4393,0,0,0,4393,4393,0,0,0,0,6
1436,a1607,20150402,4393,4393,0,0,0,4386,4386,-7,-7,0,0,6
1437,a1607,20150403,4386,4386,0,0,0,4386,4386,0,0,0,0,6
1438,a1607,20150407,4386,4386,0,0,0,4375,4375,-11,-11,0,0,6
1439,a1607,20150408,4375,4375,4305,4305,4305,4305,4305,-70,-70,2,86100,6
1440,a1607,20150409,4305,4305,0,0,0,4295,4295,-10,-10,0,0,6
1441,a1607,20150410,4295,4295,4271,4271,4270,4270,4270,-25,-25,4,170820,6
1442,a1607,20150413,4270,4270,4300,4337,4272,4272,4291,2,21,14,600840,14
1443,a1607,20150414,4272,4291,0,0,0,4291,4291,0,0,0,0,14
1444,a1607,20150415,4291,4291,0,0,0,4316,4316,25,25,0,0,14
1445,a1607,20150416,4316,4316,0,0,0,4316,4316,0,0,0,0,14
1446,a1607,20150417,4316,4316,4315,4315,4290,4290,4302,-26,-14,4,172100,16
1447,a1607,20150420,4290,4302,4269,4269,4269,4269,4269,-33,-33,2,85380,16
1448,a1607,20150421,4269,4269,0,0,0,4269,4269,0,0,0,0,16
1449,a1607,20150422,4269,4269,0,0,0,4334,4334,65,65,0,0,16
1450,a1607,20150423,4334,4334,4349,4349,4349,4349,4349,15,15,2,86980,16
1451,a1607,20150424,4349,4349,0,0,0,4349,4349,0,0,0,0,16
1452,a1607,20150427,4349,4349,4351,4460,4339,4350,4393,1,44,12,527160,20
1453,a1607,20150428,4350,4393,0,0,0,4393,4393,0,0,0,0,20
1454,a1607,20150429,4393,4393,0,0,0,4394,4394,1,1,0,0,20
1455,a1607,20150430,4394,4394,0,0,0,4459,4459,65,65,0,0,20
1456,a1607,20150504,4459,4459,4448,4448,4448,4448,4448,-11,-11,2,88960,18
1457,a1607,20150505,4448,4448,4449,4486,4449,4486,4473,38,25,6,268400,16
1458,a1607,20150506,4486,4473,4470,4489,4380,4489,4442,16,-31,12,533080,14
1459,a1607,20150507,4489,4442,4485,4485,4396,4481,4454,39,12,6,267240,14
1460,a1607,20150508,4481,4454,0,0,0,4437,4437,-17,-17,0,0,14
1461,a1607,20150511,4437,4437,0,0,0,4496,4496,59,59,0,0,14
1462,a1607,20150512,4496,4496,0,0,0,4496,4496,0,0,0,0,14
1463,a1607,20150513,4496,4496,4465,4539,4465,4539,4502,43,6,4,180080,14
1464,a1607,20150514,4539,4502,4510,4545,4510,4545,4527,43,25,4,181100,14
1465,a1607,20150515,4545,4527,4589,4589,4531,4531,4560,4,33,4,182400,14
1466,a1607,20150518,4531,4560,4550,4550,4515,4515,4532,-45,-28,4,181300,14
1467,a1607,20150519,4515,4532,0,0,0,4548,4548,16,16,0,0,14
1468,a1607,20150520,4548,4548,4528,4528,4528,4528,4528,-20,-20,8,362240,14
1469,a1607,20150521,4528,4528,0,0,0,4526,4526,-2,-2,0,0,14
1470,a1607,20150522,4526,4526,0,0,0,4628,4628,102,102,0,0,14
1471,a1607,20150525,4628,4628,0,0,0,4652,4652,24,24,0,0,14
1472,a1607,20150526,4652,4652,0,0,0,4655,4655,3,3,0,0,14
1473,a1607,20150527,4655,4655,0,0,0,4628,4628,-27,-27,0,0,14
1474,a1607,20150528,4628,4628,0,0,0,4628,4628,0,0,0,0,14
1475,a1607,20150529,4628,4628,4690,4690,4650,4650,4670,22,42,4,186800,16
1476,a1607,20150601,4650,4670,4610,4613,4610,4613,4611,-57,-59,4,184460,14
1477,a1607,20150602,4613,4611,0,0,0,4611,4611,0,0,0,0,14
1478,a1607,20150603,4611,4611,0,0,0,4611,4611,0,0,0,0,14
1479,a1607,20150604,4611,4611,0,0,0,4580,4580,-31,-31,0,0,14
1480,a1607,20150605,4580,4580,0,0,0,4532,4532,-48,-48,0,0,14
1481,a1607,20150608,4532,4532,0,0,0,4513,4513,-19,-19,0,0,14
1482,a1607,20150609,4513,4513,0,0,0,4513,4513,0,0,0,0,14
1483,a1607,20150610,4513,4513,0,0,0,4508,4508,-5,-5,0,0,14
1484,a1607,20150611,4508,4508,0,0,0,4508,4508,0,0,0,0,14
1485,a1607,20150612,4508,4508,0,0,0,4438,4438,-70,-70,0,0,14
1486,a1607,20150615,4438,4438,0,0,0,4430,4430,-8,-8,0,0,14
1487,a1607,20150616,4430,4430,0,0,0,4446,4446,16,16,0,0,14
1488,a1607,20150617,4446,4446,0,0,0,4446,4446,0,0,0,0,14
1489,a1607,20150618,4446,4446,0,0,0,4446,4446,0,0,0,0,14
1490,a1607,20150619,4446,4446,0,0,0,4446,4446,0,0,0,0,14
1491,a1607,20150623,4446,4446,0,0,0,4446,4446,0,0,0,0,14
1492,a1607,20150624,4446,4446,4530,4530,4400,4400,4465,-46,19,8,357220,14
1493,a1607,20150625,4400,4465,4538,4538,4538,4538,4538,73,73,4,181520,18
1494,a1607,20150626,4538,4538,0,0,0,4480,4480,-58,-58,0,0,18
1495,a1607,20150629,4480,4480,0,0,0,4450,4450,-30,-30,0,0,18
1496,a1607,20150630,4450,4450,0,0,0,4410,4410,-40,-40,0,0,18
1497,a1607,20150701,4410,4410,0,0,0,4410,4410,0,0,0,0,18
1498,a1607,20150702,4410,4410,0,0,0,4395,4395,-15,-15,0,0,18
1499,a1607,20150703,4395,4395,4494,4494,4426,4426,4460,31,65,8,356800,18
1500,a1607,20150706,4426,4460,4445,4445,4348,4382,4391,-78,-69,6,263500,18
1501,a1607,20150707,4382,4391,4320,4320,4320,4320,4320,-71,-71,2,86400,16
1502,a1607,20150708,4320,4320,4196,4268,4196,4196,4206,-124,-114,20,841280,16
1503,a1607,20150709,4196,4206,4210,4373,4158,4355,4310,149,104,38,1637820,10
1504,a1607,20150710,4355,4310,4466,4466,4465,4465,4465,155,155,4,178620,12
1505,a1607,20150713,4465,4465,4494,4494,4444,4444,4469,-21,4,4,178760,12
1506,a1607,20150714,4444,4469,4499,4499,4499,4499,4499,30,30,2,89980,10
1507,a1607,20150715,4499,4499,0,0,0,4470,4470,-29,-29,0,0,10
1508,a1607,20150716,4470,4470,0,0,0,4434,4434,-36,-36,0,0,10
1509,a1607,20150717,4434,4434,0,0,0,4442,4442,8,8,0,0,10
1510,a1607,20150720,4442,4442,4411,4411,4313,4320,4348,-122,-94,6,260880,8
1511,a1607,20150721,4320,4348,0,0,0,4340,4340,-8,-8,0,0,8
1512,a1607,20150722,4340,4340,0,0,0,4317,4317,-23,-23,0,0,8
1513,a1607,20150723,4317,4317,4339,4350,4339,4350,4344,33,27,4,173780,8
1514,a1607,20150724,4350,4344,0,0,0,4363,4363,19,19,0,0,8
1515,a1607,20150727,4363,4363,0,0,0,4363,4363,0,0,0,0,8
1516,a1607,20150728,4363,4363,4358,4358,4281,4281,4319,-82,-44,4,172780,8
1517,a1607,20150729,4281,4319,0,0,0,4399,4399,80,80,0,0,8
1518,a1607,20150730,4399,4399,0,0,0,4428,4428,29,29,0,0,8
1519,a1607,20150731,4428,4428,0,0,0,4422,4422,-6,-6,0,0,8
1520,a1607,20150803,4422,4422,0,0,0,4394,4394,-28,-28,0,0,8
1521,a1607,20150804,4394,4394,0,0,0,4410,4410,16,16,0,0,8
1522,a1607,20150805,4410,4410,0,0,0,4422,4422,12,12,0,0,8
1523,a1607,20150806,4422,4422,0,0,0,4469,4469,47,47,0,0,8
1524,a1607,20150807,4469,4469,4479,4479,4470,4470,4475,1,6,8,358000,8
1525,a1607,20150810,4470,4475,4470,4530,4470,4530,4490,55,15,6,269400,10
1526,a1607,20150811,4530,4490,0,0,0,4490,4490,0,0,0,0,10
1527,a1607,20150812,4490,4490,0,0,0,4490,4490,0,0,0,0,10
1528,a1607,20150813,4490,4490,0,0,0,4490,4490,0,0,0,0,10
1529,a1607,20150814,4490,4490,4530,4559,4461,4461,4511,-29,21,20,902220,16
1530,a1607,20150817,4461,4511,0,0,0,4511,4511,0,0,0,0,16
1531,a1607,20150818,4511,4511,0,0,0,4511,4511,0,0,0,0,16
1532,a1607,20150819,4511,4511,0,0,0,4504,4504,-7,-7,0,0,16
1533,a1607,20150820,4504,4504,4452,4453,4420,4420,4439,-84,-65,10,443960,10
1534,a1607,20150821,4420,4439,4482,4482,4439,4439,4460,0,21,4,178420,10
1535,a1607,20150824,4439,4460,0,0,0,4392,4392,-68,-68,0,0,10
1536,a1607,20150825,4392,4392,0,0,0,4392,4392,0,0,0,0,10
1537,a1607,20150826,4392,4392,0,0,0,4407,4407,15,15,0,0,10
1538,a1607,20150827,4407,4407,0,0,0,4376,4376,-31,-31,0,0,10
1539,a1607,20150828,4376,4376,0,0,0,4354,4354,-22,-22,0,0,10
1540,a1607,20150831,4354,4354,0,0,0,4328,4328,-26,-26,0,0,10
1541,a1607,20150901,4328,4328,0,0,0,4348,4348,20,20,0,0,10
1542,a1607,20150902,4348,4348,0,0,0,4354,4354,6,6,0,0,10
1543,a1607,20150907,4354,4354,0,0,0,4321,4321,-33,-33,0,0,10
1544,a1607,20150908,4321,4321,0,0,0,4305,4305,-16,-16,0,0,10
1545,a1607,20150909,4305,4305,0,0,0,4334,4334,29,29,0,0,10
1546,a1607,20150910,4334,4334,0,0,0,4319,4319,-15,-15,0,0,10
1547,a1607,20150911,4319,4319,0,0,0,4351,4351,32,32,0,0,10
1548,a1607,20150914,4351,4351,0,0,0,4347,4347,-4,-4,0,0,10
1549,a1607,20150915,4347,4347,0,0,0,4339,4339,-8,-8,0,0,10
1550,a1607,20150916,4339,4339,0,0,0,4319,4319,-20,-20,0,0,10
1551,a1607,20150917,4319,4319,0,0,0,4338,4338,19,19,0,0,10
1552,a1607,20150918,4338,4338,0,0,0,4326,4326,-12,-12,0,0,10
1553,a1607,20150921,4326,4326,0,0,0,4263,4263,-63,-63,0,0,10
1554,a1607,20150922,4263,4263,4204,4204,4204,4204,4204,-59,-59,8,336320,6
1555,a1607,20150923,4204,4204,0,0,0,4180,4180,-24,-24,0,0,6
1556,a1607,20150924,4180,4180,0,0,0,4179,4179,-1,-1,0,0,6
1557,a1607,20150925,4179,4179,0,0,0,4179,4179,0,0,0,0,6
1558,a1607,20150928,4179,4179,0,0,0,4168,4168,-11,-11,0,0,6
1559,a1607,20150929,4168,4168,4012,4191,4012,4158,4120,-10,-48,6,247220,6
1560,a1607,20150930,4158,4120,0,0,0,4155,4155,35,35,0,0,6
1561,a1607,20151008,4155,4155,0,0,0,4048,4048,-107,-107,0,0,6
1562,a1607,20151009,4048,4048,0,0,0,3984,3984,-64,-64,0,0,6
1563,a1607,20151012,3984,3984,0,0,0,4005,4005,21,21,0,0,6
1564,a1607,20151013,4005,4005,0,0,0,4005,4005,0,0,0,0,6
1565,a1607,20151014,4005,4005,0,0,0,3987,3987,-18,-18,0,0,6
1566,a1607,20151015,3987,3987,0,0,0,3997,3997,10,10,0,0,6
1567,a1607,20151016,3997,3997,0,0,0,3938,3938,-59,-59,0,0,6
1568,a1607,20151019,3938,3938,0,0,0,3889,3889,-49,-49,0,0,6
1569,a1607,20151020,3889,3889,0,0,0,3866,3866,-23,-23,0,0,6
1570,a1607,20151021,3866,3866,0,0,0,3862,3862,-4,-4,0,0,6
1571,a1607,20151022,3862,3862,0,0,0,3859,3859,-3,-3,0,0,6
1572,a1607,20151023,3859,3859,0,0,0,3868,3868,9,9,0,0,6
1573,a1607,20151026,3868,3868,0,0,0,3843,3843,-25,-25,0,0,6
1574,a1607,20151027,3843,3843,3857,3857,3857,3857,3857,14,14,6,231420,12
1575,a1607,20151028,3857,3857,0,0,0,3856,3856,-1,-1,0,0,12
1576,a1607,20151029,3856,3856,3832,3832,3832,3832,3832,-24,-24,10,383200,20
1577,a1607,20151030,3832,3832,3806,3806,3801,3801,3802,-31,-30,10,380260,12
1578,a1607,20151102,3801,3802,0,0,0,3812,3812,10,10,0,0,12
1579,a1607,20151103,3812,3812,3770,3806,3770,3806,3788,-6,-24,4,151520,12
1580,a1607,20151104,3806,3788,0,0,0,3830,3830,42,42,0,0,12
1581,a1607,20151105,3830,3830,0,0,0,3830,3830,0,0,0,0,12
1582,a1607,20151106,3830,3830,0,0,0,3807,3807,-23,-23,0,0,12
1583,a1607,20151109,3807,3807,0,0,0,3826,3826,19,19,0,0,12
1584,a1607,20151110,3826,3826,0,0,0,3808,3808,-18,-18,0,0,12
1585,a1607,20151111,3808,3808,0,0,0,3787,3787,-21,-21,0,0,12
1586,a1607,20151112,3787,3787,0,0,0,3826,3826,39,39,0,0,12
1587,a1607,20151113,3826,3826,0,0,0,3845,3845,19,19,0,0,12
1588,a1607,20151116,3845,3845,3781,3781,3781,3781,3781,-64,-64,2,75620,10
1589,a1607,20151117,3781,3781,0,0,0,3724,3724,-57,-57,0,0,10
1590,a1607,20151118,3724,3724,0,0,0,3734,3734,10,10,0,0,10
1591,a1607,20151119,3734,3734,0,0,0,3679,3679,-55,-55,0,0,10
1592,a1607,20151120,3679,3679,0,0,0,3640,3640,-39,-39,0,0,10
1593,a1607,20151123,3640,3640,0,0,0,3655,3655,15,15,0,0,10
1594,a1607,20151124,3655,3655,0,0,0,3686,3686,31,31,0,0,10
1595,a1607,20151125,3686,3686,0,0,0,3692,3692,6,6,0,0,10
1596,a1607,20151126,3692,3692,0,0,0,3711,3711,19,19,0,0,10
1597,a1607,20151127,3711,3711,0,0,0,3697,3697,-14,-14,0,0,10
1598,a1607,20151130,3697,3697,0,0,0,3697,3697,0,0,0,0,10
1599,a1607,20151201,3697,3697,3712,3790,3712,3790,3733,93,36,8,298680,10
1600,a1607,20151202,3790,3733,0,0,0,3745,3745,12,12,0,0,10
1601,a1607,20151203,3745,3745,0,0,0,3725,3725,-20,-20,0,0,10
1602,a1607,20151204,3725,3725,0,0,0,3758,3758,33,33,0,0,10
1603,a1607,20151207,3758,3758,0,0,0,3760,3760,2,2,0,0,10
1604,a1607,20151208,3760,3760,0,0,0,3760,3760,0,0,0,0,10
1605,a1607,20151209,3760,3760,0,0,0,3757,3757,-3,-3,0,0,10
1606,a1607,20151210,3757,3757,0,0,0,3755,3755,-2,-2,0,0,10
1607,a1607,20151211,3755,3755,0,0,0,3738,3738,-17,-17,0,0,10
1608,a1607,20151214,3738,3738,0,0,0,3725,3725,-13,-13,0,0,10
1609,a1607,20151215,3725,3725,3710,3710,3710,3710,3710,-15,-15,2,74200,10
1610,a1607,20151216,3710,3710,0,0,0,3713,3713,3,3,0,0,10
1611,a1607,20151217,3713,3713,0,0,0,3742,3742,29,29,0,0,10
1612,a1607,20151218,3742,3742,0,0,0,3748,3748,6,6,0,0,10
1613,a1607,20151221,3748,3748,0,0,0,3785,3785,37,37,0,0,10
1614,a1607,20151222,3785,3785,0,0,0,3781,3781,-4,-4,0,0,10
1615,a1607,20151223,3781,3781,0,0,0,3746,3746,-35,-35,0,0,10
1616,a1607,20151224,3746,3746,0,0,0,3749,3749,3,3,0,0,10
1617,a1607,20151225,3749,3749,0,0,0,3740,3740,-9,-9,0,0,10
1618,a1607,20151228,3740,3740,0,0,0,3662,3662,-78,-78,0,0,10
1619,a1607,20151229,3662,3662,0,0,0,3653,3653,-9,-9,0,0,10
1620,a1607,20151230,3653,3653,0,0,0,3676,3676,23,23,0,0,10
1621,a1607,20151231,3676,3676,3596,3596,3596,3596,3596,-80,-80,2,71920,10
1622,a1609,20150316,4362,4362,0,0,0,4353,4353,-9,-9,0,0,0
1623,a1609,20150317,4353,4353,0,0,0,4353,4353,0,0,0,0,0
1624,a1609,20150318,4353,4353,4460,4460,4460,4460,4460,107,107,20,892000,20
1625,a1609,20150319,4460,4460,4382,4382,4382,4382,4382,-78,-78,2,87640,22
1626,a1609,20150320,4382,4382,4325,4387,4325,4387,4366,5,-16,8,349280,24
1627,a1609,20150323,4387,4366,4468,4469,4440,4445,4457,79,91,64,2852920,76
1628,a1609,20150324,4445,4457,4460,4463,4423,4463,4446,6,-11,18,800300,70
1629,a1609,20150325,4463,4446,4436,4443,4369,4425,4424,-21,-22,12,530940,72
1630,a1609,20150326,4425,4424,4381,4422,4305,4305,4369,-119,-55,6,262160,74
1631,a1609,20150327,4305,4369,4368,4400,4368,4400,4384,31,15,4,175360,74
1632,a1609,20150330,4400,4384,4374,4380,4374,4380,4377,-4,-7,6,262640,74
1633,a1609,20150331,4380,4377,0,0,0,4377,4377,0,0,0,0,74
1634,a1609,20150401,4377,4377,0,0,0,4377,4377,0,0,0,0,74
1635,a1609,20150402,4377,4377,0,0,0,4377,4377,0,0,0,0,74
1636,a1609,20150403,4377,4377,4365,4387,4353,4379,4368,2,-9,16,699000,72
1637,a1609,20150407,4379,4368,4352,4368,4338,4338,4353,-30,-15,40,1741380,70
1638,a1609,20150408,4338,4353,4244,4316,4244,4302,4284,-51,-69,16,685500,64
1639,a1609,20150409,4302,4284,4201,4302,4201,4263,4262,-21,-22,8,340960,64
1640,a1609,20150410,4263,4262,4292,4292,4249,4262,4267,0,5,6,256060,66
1641,a1609,20150413,4262,4267,4300,4332,4283,4332,4304,65,37,24,1032980,76
1642,a1609,20150414,4332,4304,4310,4331,4306,4306,4317,2,13,18,777080,82
1643,a1609,20150415,4306,4317,4337,4337,4297,4297,4317,-20,0,8,345420,84
1644,a1609,20150416,4297,4317,0,0,0,4317,4317,0,0,0,0,84
1645,a1609,20150417,4317,4317,4323,4323,4307,4307,4316,-10,-1,20,863260,78
1646,a1609,20150420,4307,4316,4320,4320,4320,4320,4320,4,4,2,86400,78
1647,a1609,20150421,4320,4320,0,0,0,4320,4320,0,0,0,0,78
1648,a1609,20150422,4320,4320,4270,4369,4270,4369,4346,49,26,20,869280,70
1649,a1609,20150423,4369,4346,4363,4386,4325,4376,4360,30,14,30,1308060,76
1650,a1609,20150424,4376,4360,4377,4433,4377,4425,4418,65,58,70,3092820,76
1651,a1609,20150427,4425,4418,4430,4457,4421,4425,4436,7,18,28,1242120,84
1652,a1609,20150428,4425,4436,4447,4447,4421,4421,4434,-15,-2,4,177360,84
1653,a1609,20150429,4421,4434,4447,4447,4426,4426,4436,-8,2,4,177460,84
1654,a1609,20150430,4426,4436,4473,4525,4471,4500,4493,64,57,76,3414820,80
1655,a1609,20150504,4500,4493,4480,4495,4466,4466,4475,-27,-18,12,537100,76
1656,a1609,20150505,4466,4475,4467,4490,4435,4459,4468,-16,-7,34,1519400,76
1657,a1609,20150506,4459,4468,4461,4500,4461,4480,4479,12,11,36,1612780,84
1658,a1609,20150507,4480,4479,4487,4487,4460,4485,4479,6,0,14,627060,88
1659,a1609,20150508,4485,4479,4450,4480,4450,4470,4467,-9,-12,34,1518980,88
1660,a1609,20150511,4470,4467,4490,4532,4451,4532,4507,65,40,84,3786580,128
1661,a1609,20150512,4532,4507,4542,4542,4515,4542,4535,35,28,20,907140,132
1662,a1609,20150513,4542,4535,4492,4550,4401,4550,4526,15,-9,64,2897180,154
1663,a1609,20150514,4550,4526,4560,4560,4535,4558,4549,32,23,16,727940,156
1664,a1609,20150515,4558,4549,4560,4560,4542,4560,4553,11,4,26,1183820,164
1665,a1609,20150518,4560,4553,4550,4550,4515,4530,4536,-23,-17,30,1361000,152
1666,a1609,20150519,4530,4536,4542,4565,4542,4553,4559,17,23,84,3830300,186
1667,a1609,20150520,4553,4559,4552,4555,4527,4535,4543,-24,-16,82,3726060,170
1668,a1609,20150521,4535,4543,4536,4559,4531,4541,4545,-2,2,56,2545400,172
1669,a1609,20150522,4541,4545,4555,4688,4541,4666,4625,121,80,172,7955540,232
1670,a1609,20150525,4666,4625,4651,4678,4648,4659,4660,34,35,242,11277200,340
1671,a1609,20150526,4659,4660,4659,4670,4645,4650,4655,-10,-5,54,2513880,338
1672,a1609,20150527,4650,4655,4634,4652,4630,4632,4640,-23,-15,54,2505720,320
1673,a1609,20150528,4632,4640,4676,4676,4651,4657,4662,17,22,40,1864980,306
1674,a1609,20150529,4657,4662,4670,4681,4660,4672,4669,10,7,58,2708060,308
1675,a1609,20150601,4672,4669,4677,4691,4630,4630,4655,-39,-14,112,5214640,310
1676,a1609,20150602,4630,4655,4617,4650,4617,4632,4634,-23,-21,38,1761280,324
1677,a1609,20150603,4632,4634,4655,4677,4643,4643,4660,9,26,26,1211800,334
1678,a1609,20150604,4643,4660,4630,4633,4620,4628,4626,-32,-34,24,1110360,330
1679,a1609,20150605,4628,4626,4620,4650,4577,4589,4599,-37,-27,66,3035420,332
1680,a1609,20150608,4589,4599,4587,4621,4569,4569,4585,-30,-14,104,4768960,360
1681,a1609,20150609,4569,4585,4586,4632,4584,4584,4605,-1,20,118,5433960,384
1682,a1609,20150610,4584,4605,4589,4592,4582,4592,4586,-13,-19,10,458620,384
1683,a1609,20150611,4592,4586,4593,4609,4584,4593,4597,7,11,34,1563040,382
1684,a1609,20150612,4593,4597,4556,4579,4491,4492,4539,-105,-58,212,9624100,404
1685,a1609,20150615,4492,4539,4503,4503,4461,4461,4484,-78,-55,32,1434900,396
1686,a1609,20150616,4461,4484,4455,4517,4455,4483,4483,-1,-1,100,4483440,342
1687,a1609,20150617,4483,4483,4493,4536,4478,4499,4501,16,18,24,1080260,346
1688,a1609,20150618,4499,4501,4550,4550,4505,4516,4530,15,29,28,1268520,354
1689,a1609,20150619,4516,4530,4549,4549,4505,4519,4520,-11,-10,16,723260,358
1690,a1609,20150623,4519,4520,4516,4533,4516,4531,4527,11,7,12,543320,358
1691,a1609,20150624,4531,4527,4517,4544,4500,4522,4519,-5,-8,48,2169340,362
1692,a1609,20150625,4522,4519,4516,4534,4504,4504,4513,-15,-6,70,3159580,378
1693,a1609,20150626,4504,4513,4509,4535,4468,4468,4492,-45,-21,34,1527460,378
1694,a1609,20150629,4468,4492,4505,4520,4440,4457,4461,-35,-31,74,3301160,400
1695,a1609,20150630,4457,4461,4471,4480,4404,4404,4445,-57,-16,104,4622940,416
1696,a1609,20150701,4404,4445,4405,4500,4405,4470,4458,25,13,154,6865700,438
1697,a1609,20150702,4470,4458,4517,4517,4440,4440,4461,-18,3,92,4104540,470
1698,a1609,20150703,4440,4461,4480,4480,4458,4461,4470,0,9,44,1966920,482
1699,a1609,20150706,4461,4470,4441,4471,4419,4428,4442,-42,-28,184,8174200,508
1700,a1609,20150707,4428,4442,4424,4449,4403,4403,4424,-39,-18,106,4690200,494
1701,a1609,20150708,4403,4424,4377,4394,4248,4258,4280,-166,-144,194,8304120,472
1702,a1609,20150709,4258,4280,4156,4451,4156,4431,4370,151,90,340,14860880,516
1703,a1609,20150710,4431,4370,4477,4536,4476,4536,4494,166,124,134,6022080,494
1704,a1609,20150713,4536,4494,4526,4526,4456,4489,4484,-5,-10,110,4933380,502
1705,a1609,20150714,4489,4484,4488,4499,4470,4488,4489,4,5,154,6913160,426
1706,a1609,20150715,4488,4489,4504,4504,4452,4452,4465,-37,-24,32,1429060,426
1707,a1609,20150716,4452,4465,4431,4447,4377,4437,4423,-28,-42,86,3803900,446
1708,a1609,20150717,4437,4423,4446,4486,4403,4427,4438,4,15,118,5237280,438
1709,a1609,20150720,4427,4438,4421,4421,4350,4372,4373,-66,-65,88,3849020,470
1710,a1609,20150721,4372,4373,4420,4420,4357,4360,4373,-13,0,88,3848660,498
1711,a1609,20150722,4360,4373,4288,4386,4288,4379,4371,6,-2,154,6732220,480
1712,a1609,20150723,4379,4371,4369,4371,4361,4371,4364,0,-7,18,785680,482
1713,a1609,20150724,4371,4364,4391,4391,4378,4380,4382,16,18,64,2804580,468
1714,a1609,20150727,4380,4382,4377,4380,4314,4376,4364,-6,-18,54,2356560,476
1715,a1609,20150728,4376,4364,4324,4370,4309,4370,4332,6,-32,88,3812200,472
1716,a1609,20150729,4370,4332,4400,4447,4389,4439,4434,107,102,166,7360540,500
1717,a1609,20150730,4439,4434,4451,4478,4443,4450,4461,16,27,68,3034020,474
1718,a1609,20150731,4450,4461,4444,4470,4444,4453,4452,-8,-9,28,1246580,468
1719,a1609,20150803,4453,4452,4454,4454,4408,4408,4425,-44,-27,66,2920700,470
1720,a1609,20150804,4408,4425,4411,4433,4409,4433,4424,8,-1,34,1504180,472
1721,a1609,20150805,4433,4424,4436,4439,4424,4432,4432,8,8,28,1241000,472
1722,a1609,20150806,4432,4432,4433,4520,4424,4519,4485,87,53,84,3767920,480
1723,a1609,20150807,4519,4485,4496,4520,4458,4488,4482,3,-3,192,8606900,502
1724,a1609,20150810,4488,4482,4482,4526,4482,4526,4508,44,26,76,3426100,518
1725,a1609,20150811,4526,4508,4523,4544,4520,4529,4531,21,23,266,12053940,650
1726,a1609,20150812,4529,4531,4509,4561,4509,4533,4522,2,-9,126,5697940,686
1727,a1609,20150813,4533,4522,4558,4600,4467,4489,4506,-33,-16,190,8562540,674
1728,a1609,20150814,4489,4506,4486,4510,4483,4495,4498,-11,-8,96,4318800,688
1729,a1609,20150817,4495,4498,4502,4535,4495,4508,4506,10,8,54,2433520,684
1730,a1609,20150818,4508,4506,4514,4536,4433,4491,4503,-15,-3,90,4053380,696
1731,a1609,20150819,4491,4503,4477,4485,4447,4479,4467,-24,-36,182,8130160,706
1732,a1609,20150820,4479,4467,4471,4490,4441,4452,4469,-15,2,178,7955140,760
1733,a1609,20150821,4452,4469,4451,4500,4451,4477,4474,8,5,90,4027060,768
1734,a1609,20150824,4477,4474,4447,4499,4379,4379,4421,-95,-53,162,7162980,736
1735,a1609,20150825,4379,4421,4366,4429,4360,4395,4389,-26,-32,124,5443040,718
1736,a1609,20150826,4395,4389,4421,4443,4390,4390,4408,1,19,74,3262240,720
1737,a1609,20150827,4390,4408,4392,4415,4337,4362,4396,-46,-12,190,8353100,738
1738,a1609,20150828,4362,4396,4388,4405,4336,4336,4369,-60,-27,272,11885160,736
1739,a1609,20150831,4336,4369,4369,4444,4325,4328,4347,-41,-22,214,9302840,726
1740,a1609,20150901,4328,4347,4353,4372,4316,4366,4352,19,5,156,6790640,748
1741,a1609,20150902,4366,4352,4355,4368,4346,4365,4356,13,4,38,1655460,754
1742,a1609,20150907,4365,4356,4395,4395,4279,4309,4321,-47,-35,54,2333360,776
1743,a1609,20150908,4309,4321,4317,4327,4255,4327,4307,6,-14,274,11803380,916
1744,a1609,20150909,4327,4307,4348,4349,4307,4315,4330,8,23,160,6928860,910
1745,a1609,20150910,4315,4330,4315,4343,4310,4334,4322,4,-8,76,3284820,924
1746,a1609,20150911,4334,4322,4326,4357,4326,4339,4345,17,23,88,3823740,942
1747,a1609,20150914,4339,4345,4316,4351,4316,4329,4334,-16,-11,62,2687260,944
1748,a1609,20150915,4329,4334,4336,4347,4326,4326,4342,-8,8,48,2084180,948
1749,a1609,20150916,4326,4342,4321,4342,4301,4331,4321,-11,-21,154,6655280,948
1750,a1609,20150917,4331,4321,4325,4339,4318,4320,4330,-1,9,320,13857480,1070
1751,a1609,20150918,4320,4330,4317,4330,4293,4293,4313,-37,-17,250,10783160,1152
1752,a1609,20150921,4293,4313,4297,4305,4180,4220,4211,-93,-102,2128,89613580,2240
1753,a1609,20150922,4220,4211,4214,4214,4175,4186,4186,-25,-25,986,41275740,2626
1754,a1609,20150923,4186,4186,4174,4185,4161,4169,4172,-17,-14,550,22947980,2696
1755,a1609,20150924,4169,4172,4185,4197,4154,4154,4163,-18,-9,368,15322460,2770
1756,a1609,20150925,4154,4163,4145,4187,4131,4155,4163,-8,0,752,31309820,2706
1757,a1609,20150928,4155,4163,4166,4170,4138,4138,4150,-25,-13,300,12450000,2666
1758,a1609,20150929,4138,4150,4137,4189,4032,4188,4118,38,-32,974,40111860,2672
1759,a1609,20150930,4188,4118,4198,4218,4183,4201,4203,83,85,1922,80795300,2780
1760,a1609,20151008,4201,4203,4115,4209,4040,4060,4131,-143,-72,1246,51477020,2686
1761,a1609,20151009,4060,4131,4067,4089,3996,4027,4042,-104,-89,3168,128067460,3128
1762,a1609,20151012,4027,4042,4037,4079,4016,4079,4041,37,-1,1380,55772640,3286
1763,a1609,20151013,4079,4041,4060,4066,4032,4052,4047,11,6,1172,47438840,3236
1764,a1609,20151014,4052,4047,4058,4079,4021,4045,4049,-2,2,1176,47622260,3378
1765,a1609,20151015,4045,4049,4063,4070,4044,4053,4056,4,7,330,13387020,3318
1766,a1609,20151016,4053,4056,4045,4048,3973,3978,4007,-78,-49,1740,69735760,3844
1767,a1609,20151019,3978,4007,3951,3974,3930,3942,3952,-65,-55,1746,69005780,4196
1768,a1609,20151020,3942,3952,3943,3958,3905,3926,3928,-26,-24,2244,88151560,4584
1769,a1609,20151021,3926,3928,3925,3947,3911,3911,3927,-17,-1,1710,67167820,4632
1770,a1609,20151022,3911,3927,3914,3935,3875,3927,3903,0,-24,3124,121951280,4298
1771,a1609,20151023,3927,3903,3935,3950,3881,3920,3910,17,7,2000,78219200,4482
1772,a1609,20151026,3920,3910,3924,3930,3836,3858,3886,-52,-24,3330,129406380,5268
1773,a1609,20151027,3858,3886,3852,3852,3808,3840,3820,-46,-66,1036,39578460,5528
1774,a1609,20151028,3840,3820,3842,3846,3790,3790,3816,-30,-4,1202,45873940,5938
1775,a1609,20151029,3790,3816,3799,3819,3775,3788,3793,-28,-23,1088,41272560,6208
1776,a1609,20151030,3788,3793,3805,3810,3773,3788,3788,-5,-5,822,31143140,6386
1777,a1609,20151102,3788,3788,3793,3809,3789,3796,3801,8,13,610,23188800,6338
1778,a1609,20151103,3796,3801,3801,3809,3781,3795,3793,-6,-8,1334,50610640,6208
1779,a1609,20151104,3795,3793,3795,3838,3788,3825,3818,32,25,2320,88589680,6806
1780,a1609,20151105,3825,3818,3812,3830,3805,3815,3820,-3,2,1740,66482700,6984
1781,a1609,20151106,3815,3820,3819,3827,3790,3825,3804,5,-16,2874,109349940,8170
1782,a1609,20151109,3825,3804,3829,3855,3800,3813,3821,9,17,3488,133276980,8616
1783,a1609,20151110,3813,3821,3824,3826,3787,3788,3798,-33,-23,1472,55920180,9280
1784,a1609,20151111,3788,3798,3784,3796,3648,3796,3760,-2,-38,3830,144018240,9420
1785,a1609,20151112,3796,3760,3798,3817,3790,3806,3801,46,41,1808,68724920,9532
1786,a1609,20151113,3806,3801,3808,3837,3797,3812,3818,11,17,2066,78880200,9884
1787,a1609,20151116,3812,3818,3812,3824,3740,3744,3782,-74,-36,4390,166055020,11646
1788,a1609,20151117,3744,3782,3742,3769,3720,3738,3745,-44,-37,3230,120977520,11742
1789,a1609,20151118,3738,3745,3742,3777,3725,3734,3751,-11,6,6202,232668920,14576
1790,a1609,20151119,3734,3751,3741,3742,3643,3646,3673,-105,-78,11512,422884060,19438
1791,a1609,20151120,3646,3673,3642,3657,3608,3610,3635,-63,-38,5868,213309320,19712
1792,a1609,20151123,3610,3635,3609,3660,3607,3640,3641,5,6,7090,258200780,20680
1793,a1609,20151124,3640,3641,3645,3700,3628,3698,3670,57,29,5340,195979900,20938
1794,a1609,20151125,3698,3670,3695,3705,3658,3685,3686,15,16,3936,145112760,20970
1795,a1609,20151126,3685,3686,3678,3718,3675,3691,3692,5,6,8686,320769000,24586
1796,a1609,20151127,3691,3692,3681,3700,3657,3673,3676,-19,-16,3430,126107320,25100
1797,a1609,20151130,3673,3676,3662,3696,3653,3690,3679,14,3,3566,131216800,24154
1798,a1609,20151201,3690,3679,3689,3709,3682,3696,3693,17,14,3202,118277920,24520
1799,a1609,20151202,3696,3693,3698,3743,3665,3675,3714,-18,21,14280,530364760,25458
1800,a1609,20151203,3675,3714,3670,3734,3665,3724,3699,10,-15,10760,398054380,23012
1801,a1609,20151204,3724,3699,3727,3739,3708,3724,3726,25,27,6676,248765420,22562
1802,a1609,20151207,3724,3726,3736,3749,3705,3737,3732,11,6,4998,186565600,22630
1803,a1609,20151208,3737,3732,3736,3736,3696,3713,3715,-19,-17,7842,291369780,24706
1804,a1609,20151209,3713,3715,3725,3725,3688,3689,3705,-26,-10,4634,171707540,25754
1805,a1609,20151210,3689,3705,3689,3702,3660,3673,3681,-32,-24,6768,249188440,27962
1806,a1609,20151211,3673,3681,3658,3689,3652,3686,3670,5,-11,4356,159895600,27774
1807,a1609,20151214,3686,3670,3686,3695,3646,3647,3659,-23,-11,5660,207136380,28670
1808,a1609,20151215,3647,3659,3638,3655,3623,3626,3640,-33,-19,7932,288734100,29660
1809,a1609,20151216,3626,3640,3623,3639,3616,3632,3626,-8,-14,9724,352648440,29806
1810,a1609,20151217,3632,3626,3630,3656,3626,3641,3641,15,15,10948,398632100,27836
1811,a1609,20151218,3641,3641,3630,3665,3628,3665,3648,24,7,4800,175149180,26950
1812,a1609,20151221,3665,3648,3666,3700,3662,3696,3681,48,33,6856,252374760,27160
1813,a1609,20151222,3696,3681,3696,3706,3654,3654,3682,-27,1,8492,312701780,27644
1814,a1609,20151223,3654,3682,3660,3673,3644,3664,3656,-18,-26,7268,265788340,28010
1815,a1609,20151224,3664,3656,3671,3672,3648,3650,3659,-6,3,4794,175444060,28156
1816,a1609,20151225,3650,3659,3651,3672,3618,3619,3641,-40,-18,18188,662250360,30306
1817,a1609,20151228,3619,3641,3619,3629,3514,3518,3564,-123,-77,25944,924669040,38456
1818,a1609,20151229,3518,3564,3528,3529,3501,3525,3515,-39,-49,21218,745840420,41358
1819,a1609,20151230,3525,3515,3525,3555,3520,3533,3535,18,20,18348,648764640,40080
1820,a1609,20151231,3533,3535,3533,3535,3518,3528,3527,-7,-8,10092,356026680,39880
1821,a1611,20150518,4527,4527,0,0,0,4511,4511,-16,-16,0,0,0
1822,a1611,20150519,4511,4511,0,0,0,4533,4533,22,22,0,0,0
1823,a1611,20150520,4533,4533,0,0,0,4518,4518,-15,-15,0,0,0
1824,a1611,20150521,4518,4518,0,0,0,4519,4519,1,1,0,0,0
1825,a1611,20150522,4519,4519,0,0,0,4598,4598,79,79,0,0,0
1826,a1611,20150525,4598,4598,0,0,0,4632,4632,34,34,0,0,0
1827,a1611,20150526,4632,4632,0,0,0,4628,4628,-4,-4,0,0,0
1828,a1611,20150527,4628,4628,0,0,0,4628,4628,0,0,0,0,0
1829,a1611,20150528,4628,4628,0,0,0,4649,4649,21,21,0,0,0
1830,a1611,20150529,4649,4649,0,0,0,4655,4655,6,6,0,0,0
1831,a1611,20150601,4655,4655,0,0,0,4642,4642,-13,-13,0,0,0
1832,a1611,20150602,4642,4642,0,0,0,4642,4642,0,0,0,0,0
1833,a1611,20150603,4642,4642,0,0,0,4668,4668,26,26,0,0,0
1834,a1611,20150604,4668,4668,0,0,0,4668,4668,0,0,0,0,0
1835,a1611,20150605,4668,4668,0,0,0,4641,4641,-27,-27,0,0,0
1836,a1611,20150608,4641,4641,0,0,0,4627,4627,-14,-14,0,0,0
1837,a1611,20150609,4627,4627,0,0,0,4647,4647,20,20,0,0,0
1838,a1611,20150610,4647,4647,4739,4739,4280,4577,4575,-70,-72,12,549020,0
1839,a1611,20150611,4577,4575,0,0,0,4585,4585,10,10,0,0,0
1840,a1611,20150612,4585,4585,4430,4605,4430,4600,4536,15,-49,8,362900,0
1841,a1611,20150615,4600,4536,0,0,0,4482,4482,-54,-54,0,0,0
1842,a1611,20150616,4482,4482,0,0,0,4482,4482,0,0,0,0,0
1843,a1611,20150617,4482,4482,0,0,0,4482,4482,0,0,0,0,0
1844,a1611,20150618,4482,4482,0,0,0,4482,4482,0,0,0,0,0
1845,a1611,20150619,4482,4482,0,0,0,4473,4473,-9,-9,0,0,0
1846,a1611,20150623,4473,4473,0,0,0,4479,4479,6,6,0,0,0
1847,a1611,20150624,4479,4479,0,0,0,4472,4472,-7,-7,0,0,0
1848,a1611,20150625,4472,4472,0,0,0,4467,4467,-5,-5,0,0,0
1849,a1611,20150626,4467,4467,0,0,0,4447,4447,-20,-20,0,0,0
1850,a1611,20150629,4447,4447,0,0,0,4417,4417,-30,-30,0,0,0
1851,a1611,20150630,4417,4417,0,0,0,4402,4402,-15,-15,0,0,0
1852,a1611,20150701,4402,4402,0,0,0,4402,4402,0,0,0,0,0
1853,a1611,20150702,4402,4402,0,0,0,4404,4404,2,2,0,0,0
1854,a1611,20150703,4404,4404,0,0,0,4412,4412,8,8,0,0,0
1855,a1611,20150706,4412,4412,0,0,0,4385,4385,-27,-27,0,0,0
1856,a1611,20150707,4385,4385,4267,4485,4267,4433,4395,48,10,6,263700,0
1857,a1611,20150708,4433,4395,0,0,0,4252,4252,-143,-143,0,0,0
1858,a1611,20150709,4252,4252,0,0,0,4341,4341,89,89,0,0,0
1859,a1611,20150710,4341,4341,0,0,0,4464,4464,123,123,0,0,0
1860,a1611,20150713,4464,4464,4403,4591,4403,4474,4498,10,34,8,359900,0
1861,a1611,20150714,4474,4498,0,0,0,4503,4503,5,5,0,0,0
1862,a1611,20150715,4503,4503,0,0,0,4503,4503,0,0,0,0,0
1863,a1611,20150716,4503,4503,0,0,0,4461,4461,-42,-42,0,0,0
1864,a1611,20150717,4461,4461,0,0,0,4476,4476,15,15,0,0,0
1865,a1611,20150720,4476,4476,0,0,0,4411,4411,-65,-65,0,0,0
1866,a1611,20150721,4411,4411,0,0,0,4411,4411,0,0,0,0,0
1867,a1611,20150722,4411,4411,0,0,0,4411,4411,0,0,0,0,0
1868,a1611,20150723,4411,4411,0,0,0,4404,4404,-7,-7,0,0,0
1869,a1611,20150724,4404,4404,0,0,0,4404,4404,0,0,0,0,0
1870,a1611,20150727,4404,4404,0,0,0,4386,4386,-18,-18,0,0,0
1871,a1611,20150728,4386,4386,0,0,0,4354,4354,-32,-32,0,0,0
1872,a1611,20150729,4354,4354,0,0,0,4456,4456,102,102,0,0,0
1873,a1611,20150730,4456,4456,0,0,0,4483,4483,27,27,0,0,0
1874,a1611,20150731,4483,4483,0,0,0,4474,4474,-9,-9,0,0,0
1875,a1611,20150803,4474,4474,0,0,0,4447,4447,-27,-27,0,0,0
1876,a1611,20150804,4447,4447,0,0,0,4446,4446,-1,-1,0,0,0
1877,a1611,20150805,4446,4446,0,0,0,4454,4454,8,8,0,0,0
1878,a1611,20150806,4454,4454,4493,4632,4438,4492,4538,38,84,22,998440,2
1879,a1611,20150807,4492,4538,0,0,0,4535,4535,-3,-3,0,0,2
1880,a1611,20150810,4535,4535,4544,4544,4544,4544,4544,9,9,4,181760,4
1881,a1611,20150811,4544,4544,4570,4570,4570,4570,4570,26,26,2,91400,6
1882,a1611,20150812,4570,4570,0,0,0,4564,4564,-6,-6,0,0,6
1883,a1611,20150813,4564,4564,4535,4535,4517,4518,4525,-46,-39,14,633540,8
1884,a1611,20150814,4518,4525,0,0,0,4525,4525,0,0,0,0,8
1885,a1611,20150817,4525,4525,0,0,0,4525,4525,0,0,0,0,8
1886,a1611,20150818,4525,4525,0,0,0,4525,4525,0,0,0,0,8
1887,a1611,20150819,4525,4525,0,0,0,4489,4489,-36,-36,0,0,8
1888,a1611,20150820,4489,4489,0,0,0,4491,4491,2,2,0,0,8
1889,a1611,20150821,4491,4491,0,0,0,4491,4491,0,0,0,0,8
1890,a1611,20150824,4491,4491,0,0,0,4435,4435,-56,-56,0,0,8
1891,a1611,20150825,4435,4435,0,0,0,4403,4403,-32,-32,0,0,8
1892,a1611,20150826,4403,4403,0,0,0,4422,4422,19,19,0,0,8
1893,a1611,20150827,4422,4422,0,0,0,4410,4410,-12,-12,0,0,8
1894,a1611,20150828,4410,4410,4373,4373,4373,4373,4373,-37,-37,2,87460,8
1895,a1611,20150831,4373,4373,4293,4383,4228,4316,4332,-57,-41,32,1386420,6
1896,a1611,20150901,4316,4332,0,0,0,4336,4336,4,4,0,0,6
1897,a1611,20150902,4336,4336,0,0,0,4339,4339,3,3,0,0,6
1898,a1611,20150907,4339,4339,0,0,0,4339,4339,0,0,0,0,6
1899,a1611,20150908,4339,4339,0,0,0,4325,4325,-14,-14,0,0,6
1900,a1611,20150909,4325,4325,0,0,0,4325,4325,0,0,0,0,6
1901,a1611,20150910,4325,4325,0,0,0,4325,4325,0,0,0,0,6
1902,a1611,20150911,4325,4325,0,0,0,4325,4325,0,0,0,0,6
1903,a1611,20150914,4325,4325,0,0,0,4315,4315,-10,-10,0,0,6
1904,a1611,20150915,4315,4315,0,0,0,4322,4322,7,7,0,0,6
1905,a1611,20150916,4322,4322,4348,4349,4305,4305,4326,-17,4,8,346140,6
1906,a1611,20150917,4305,4326,0,0,0,4326,4326,0,0,0,0,6
1907,a1611,20150918,4326,4326,0,0,0,4326,4326,0,0,0,0,6
1908,a1611,20150921,4326,4326,4272,4272,4169,4169,4220,-157,-106,4,168820,6
1909,a1611,20150922,4169,4220,0,0,0,4220,4220,0,0,0,0,6
1910,a1611,20150923,4220,4220,0,0,0,4206,4206,-14,-14,0,0,6
1911,a1611,20150924,4206,4206,0,0,0,4197,4197,-9,-9,0,0,6
1912,a1611,20150925,4197,4197,0,0,0,4197,4197,0,0,0,0,6
1913,a1611,20150928,4197,4197,0,0,0,4184,4184,-13,-13,0,0,6
1914,a1611,20150929,4184,4184,0,0,0,4152,4152,-32,-32,0,0,6
1915,a1611,20150930,4152,4152,0,0,0,4237,4237,85,85,0,0,6
1916,a1611,20151008,4237,4237,4106,4160,4075,4075,4113,-162,-124,12,493640,6
1917,a1611,20151009,4075,4113,4040,4040,4040,4040,4040,-73,-73,2,80800,6
1918,a1611,20151012,4040,4040,0,0,0,4040,4040,0,0,0,0,6
1919,a1611,20151013,4040,4040,4100,4100,4100,4100,4100,60,60,2,82000,8
1920,a1611,20151014,4100,4100,0,0,0,4100,4100,0,0,0,0,8
1921,a1611,20151015,4100,4100,0,0,0,4107,4107,7,7,0,0,8
1922,a1611,20151016,4107,4107,4020,4020,4020,4020,4020,-87,-87,2,80400,8
1923,a1611,20151019,4020,4020,0,0,0,3965,3965,-55,-55,0,0,8
1924,a1611,20151020,3965,3965,3906,3906,3905,3905,3905,-60,-60,4,156220,6
1925,a1611,20151021,3905,3905,0,0,0,3905,3905,0,0,0,0,6
1926,a1611,20151022,3905,3905,0,0,0,3882,3882,-23,-23,0,0,6
1927,a1611,20151023,3882,3882,3862,3912,3862,3912,3887,30,5,4,155480,6
1928,a1611,20151026,3912,3887,0,0,0,3864,3864,-23,-23,0,0,6
1929,a1611,20151027,3864,3864,0,0,0,3799,3799,-65,-65,0,0,6
1930,a1611,20151028,3799,3799,0,0,0,3796,3796,-3,-3,0,0,6
1931,a1611,20151029,3796,3796,3706,3821,3706,3796,3759,0,-37,46,1729500,16
1932,a1611,20151030,3796,3759,3787,3787,3744,3745,3758,-14,-1,6,225520,14
1933,a1611,20151102,3745,3758,0,0,0,3770,3770,12,12,0,0,14
1934,a1611,20151103,3770,3770,0,0,0,3770,3770,0,0,0,0,14
1935,a1611,20151104,3770,3770,3800,3800,3800,3800,3800,30,30,2,76000,14
1936,a1611,20151105,3800,3800,0,0,0,3800,3800,0,0,0,0,14
1937,a1611,20151106,3800,3800,0,0,0,3785,3785,-15,-15,0,0,14
1938,a1611,20151109,3785,3785,0,0,0,3801,3801,16,16,0,0,14
1939,a1611,20151110,3801,3801,0,0,0,3801,3801,0,0,0,0,14
1940,a1611,20151111,3801,3801,0,0,0,3763,3763,-38,-38,0,0,14
1941,a1611,20151112,3763,3763,3770,3802,3770,3802,3786,39,23,4,151440,12
1942,a1611,20151113,3802,3786,0,0,0,3802,3802,16,16,0,0,12
1943,a1611,20151116,3802,3802,0,0,0,3767,3767,-35,-35,0,0,12
1944,a1611,20151117,3767,3767,0,0,0,3731,3731,-36,-36,0,0,12
1945,a1611,20151118,3731,3731,0,0,0,3736,3736,5,5,0,0,12
1946,a1611,20151119,3736,3736,0,0,0,3659,3659,-77,-77,0,0,12
1947,a1611,20151120,3659,3659,0,0,0,3622,3622,-37,-37,0,0,12
1948,a1611,20151123,3622,3622,0,0,0,3627,3627,5,5,0,0,12
1949,a1611,20151124,3627,3627,0,0,0,3655,3655,28,28,0,0,12
1950,a1611,20151125,3655,3655,0,0,0,3670,3670,15,15,0,0,12
1951,a1611,20151126,3670,3670,3702,3702,3702,3702,3702,32,32,2,74040,12
1952,a1611,20151127,3702,3702,0,0,0,3686,3686,-16,-16,0,0,12
1953,a1611,20151130,3686,3686,0,0,0,3689,3689,3,3,0,0,12
1954,a1611,20151201,3689,3689,0,0,0,3703,3703,14,14,0,0,12
1955,a1611,20151202,3703,3703,0,0,0,3724,3724,21,21,0,0,12
1956,a1611,20151203,3724,3724,3706,3706,3706,3706,3706,-18,-18,2,74120,12
1957,a1611,20151204,3706,3706,3687,3687,3687,3687,3687,-19,-19,2,73740,10
1958,a1611,20151207,3687,3687,0,0,0,3692,3692,5,5,0,0,10
1959,a1611,20151208,3692,3692,3663,3750,3663,3750,3706,58,14,4,148260,10
1960,a1611,20151209,3750,3706,0,0,0,3697,3697,-9,-9,0,0,10
1961,a1611,20151210,3697,3697,0,0,0,3674,3674,-23,-23,0,0,10
1962,a1611,20151211,3674,3674,0,0,0,3664,3664,-10,-10,0,0,10
1963,a1611,20151214,3664,3664,0,0,0,3654,3654,-10,-10,0,0,10
1964,a1611,20151215,3654,3654,0,0,0,3636,3636,-18,-18,0,0,10
1965,a1611,20151216,3636,3636,0,0,0,3623,3623,-13,-13,0,0,10
1966,a1611,20151217,3623,3623,0,0,0,3637,3637,14,14,0,0,10
1967,a1611,20151218,3637,3637,0,0,0,3643,3643,6,6,0,0,10
1968,a1611,20151221,3643,3643,0,0,0,3675,3675,32,32,0,0,10
1969,a1611,20151222,3675,3675,0,0,0,3675,3675,0,0,0,0,10
1970,a1611,20151223,3675,3675,3670,3670,3670,3670,3670,-5,-5,2,73400,8
1971,a1611,20151224,3670,3670,0,0,0,3673,3673,3,3,0,0,8
1972,a1611,20151225,3673,3673,0,0,0,3655,3655,-18,-18,0,0,8
1973,a1611,20151228,3655,3655,0,0,0,3578,3578,-77,-77,0,0,8
1974,a1611,20151229,3578,3578,0,0,0,3529,3529,-49,-49,0,0,8
1975,a1611,20151230,3529,3529,3505,3574,3505,3574,3539,45,10,4,141580,8
1976,a1611,20151231,3574,3539,3585,3585,3579,3579,3584,40,45,12,430080,18
1977,a1701,20150715,4484,4484,0,0,0,4484,4484,0,0,0,0,0
1978,a1701,20150716,4484,4484,4296,4296,4250,4250,4252,-234,-232,64,2721880,64
1979,a1701,20150717,4250,4252,4422,4422,4326,4326,4383,74,131,10,438360,66
1980,a1701,20150720,4326,4383,4325,4454,4295,4375,4346,-8,-37,74,3216320,68
1981,a1701,20150721,4375,4346,4399,4410,4338,4410,4399,64,53,22,967940,76
1982,a1701,20150722,4410,4399,4400,4420,4400,4400,4404,1,5,14,616640,74
1983,a1701,20150723,4400,4404,0,0,0,4404,4404,0,0,0,0,74
1984,a1701,20150724,4404,4404,0,0,0,4404,4404,0,0,0,0,74
1985,a1701,20150727,4404,4404,4403,4403,4321,4321,4362,-83,-42,4,174480,74
1986,a1701,20150728,4321,4362,4345,4409,4307,4330,4340,-32,-22,12,520900,74
1987,a1701,20150729,4330,4340,4400,4470,4400,4458,4437,118,97,26,1153720,90
1988,a1701,20150730,4458,4437,4500,4500,4450,4493,4471,56,34,12,536520,88
1989,a1701,20150731,4493,4471,4465,4465,4439,4439,4456,-32,-15,6,267380,88
1990,a1701,20150803,4439,4456,4463,4475,4419,4425,4445,-31,-11,8,355640,90
1991,a1701,20150804,4425,4445,4449,4449,4424,4424,4436,-21,-9,4,177460,94
1992,a1701,20150805,4424,4436,4449,4462,4426,4426,4445,-10,9,6,266740,94
1993,a1701,20150806,4426,4445,4450,4521,4450,4500,4482,55,37,18,806800,104
1994,a1701,20150807,4500,4482,4492,4540,4452,4480,4508,-2,26,116,5230020,196
1995,a1701,20150810,4480,4508,4510,4539,4510,4530,4522,22,14,112,5065700,258
1996,a1701,20150811,4530,4522,4530,4541,4530,4535,4531,13,9,66,2990560,298
1997,a1701,20150812,4535,4531,4519,4568,4514,4530,4526,-1,-5,62,2806680,332
1998,a1701,20150813,4530,4526,4535,4590,4400,4498,4505,-28,-21,62,2793240,344
1999,a1701,20150814,4498,4505,4497,4528,4497,4510,4514,5,9,28,1264000,340
2000,a1701,20150817,4510,4514,4535,4535,4515,4528,4520,14,6,14,632900,336
2001,a1701,20150818,4528,4520,4516,4517,4500,4500,4513,-20,-7,12,541640,332
2002,a1701,20150819,4500,4513,4519,4519,4466,4496,4487,-17,-26,30,1346280,320
2003,a1701,20150820,4496,4487,4500,4500,4481,4486,4488,-1,1,44,1975140,306
2004,a1701,20150821,4486,4488,4485,4514,4473,4495,4499,7,11,158,7109460,282
2005,a1701,20150824,4495,4499,4480,4486,4401,4409,4449,-90,-50,80,3559280,270
2006,a1701,20150825,4409,4449,4399,4448,4392,4420,4424,-29,-25,98,4336120,244
2007,a1701,20150826,4420,4424,4451,4469,4425,4425,4441,1,17,44,1954320,250
2008,a1701,20150827,4425,4441,4415,4442,4412,4435,4434,-6,-7,178,7893620,282
2009,a1701,20150828,4435,4434,4430,4440,4367,4367,4413,-67,-21,60,2648260,274
2010,a1701,20150831,4367,4413,4371,4371,4343,4364,4355,-49,-58,50,2177520,310
2011,a1701,20150901,4364,4355,4371,4375,4343,4361,4358,6,3,36,1568920,328
2012,a1701,20150902,4361,4358,4360,4375,4360,4375,4364,17,6,18,785660,334
2013,a1701,20150907,4375,4364,4352,4352,4308,4322,4323,-42,-41,40,1729220,348
2014,a1701,20150908,4322,4323,4331,4331,4299,4326,4314,3,-9,166,7162660,478
2015,a1701,20150909,4326,4314,4343,4344,4310,4310,4332,-4,18,12,519900,480
2016,a1701,20150910,4310,4332,4315,4330,4311,4330,4319,-2,-13,32,1382300,488
2017,a1701,20150911,4330,4319,4318,4362,4318,4345,4336,26,17,18,780520,498
2018,a1701,20150914,4345,4336,4344,4345,4334,4336,4342,0,6,22,955440,510
2019,a1701,20150915,4336,4342,4355,4355,4338,4338,4342,-4,0,14,608000,508
2020,a1701,20150916,4338,4342,4330,4340,4317,4338,4327,-4,-15,126,5452760,564
2021,a1701,20150917,4338,4327,4337,4337,4330,4333,4333,6,6,14,606640,568
2022,a1701,20150918,4333,4333,4322,4329,4290,4290,4301,-43,-32,54,2322900,604
2023,a1701,20150921,4290,4301,4270,4270,4172,4182,4190,-119,-111,222,9303460,712
2024,a1701,20150922,4182,4190,4211,4211,4144,4160,4156,-30,-34,242,10058340,820
2025,a1701,20150923,4160,4156,4138,4138,4110,4120,4121,-36,-35,202,8324920,968
2026,a1701,20150924,4120,4121,4127,4145,4110,4110,4126,-11,5,52,2146000,996
2027,a1701,20150925,4110,4126,4110,4129,4068,4123,4111,-3,-15,284,11675820,1162
2028,a1701,20150928,4123,4111,4080,4106,4080,4100,4100,-11,-11,104,4264180,1226
2029,a1701,20150929,4100,4100,4115,4118,4083,4108,4105,8,5,54,2216700,1238
2030,a1701,20150930,4108,4105,4101,4127,4083,4110,4108,5,3,212,8710080,1292
2031,a1701,20151008,4110,4108,4110,4110,3994,3994,4016,-114,-92,248,9959960,1332
2032,a1701,20151009,3994,4016,4014,4014,3960,3972,3985,-44,-31,208,8290780,1412
2033,a1701,20151012,3972,3985,3995,3995,3920,3975,3947,-10,-38,520,20525240,1768
2034,a1701,20151013,3975,3947,3960,4005,3950,3975,3983,28,36,492,19599720,1608
2035,a1701,20151014,3975,3983,3990,3999,3968,3998,3986,15,3,176,7015620,1598
2036,a1701,20151015,3998,3986,3992,3994,3981,3981,3988,-5,2,74,2951640,1626
2037,a1701,20151016,3981,3988,3983,3983,3882,3889,3918,-99,-70,1030,40356940,2258
2038,a1701,20151019,3889,3918,3871,3890,3865,3876,3875,-42,-43,312,12092900,2126
2039,a1701,20151020,3876,3875,3870,3957,3870,3877,3912,2,37,1090,42647000,1986
2040,a1701,20151021,3877,3912,3895,3897,3882,3882,3890,-30,-22,190,7392840,2038
2041,a1701,20151022,3882,3890,3873,3873,3815,3861,3842,-29,-48,1112,42727080,2378
2042,a1701,20151023,3861,3842,3870,3880,3842,3860,3860,18,18,622,24014380,2386
2043,a1701,20151026,3860,3860,3868,3871,3810,3815,3841,-45,-19,506,19436340,2370
2044,a1701,20151027,3815,3841,3816,3816,3775,3802,3798,-39,-43,924,35100860,2138
2045,a1701,20151028,3802,3798,3817,3817,3731,3736,3767,-62,-31,1702,64127140,3054
2046,a1701,20151029,3736,3767,3775,3775,3723,3725,3747,-42,-20,1688,63253600,3002
2047,a1701,20151030,3725,3747,3721,3757,3702,3725,3717,-22,-30,882,32788920,3316
2048,a1701,20151102,3725,3717,3723,3730,3710,3726,3722,9,5,350,13029420,3376
2049,a1701,20151103,3726,3722,3722,3730,3710,3716,3716,-6,-6,332,12339620,3378
2050,a1701,20151104,3716,3716,3711,3745,3709,3734,3739,18,23,1000,37398760,3366
2051,a1701,20151105,3734,3739,3722,3742,3722,3729,3733,-10,-6,382,14260560,3504
2052,a1701,20151106,3729,3733,3730,3732,3701,3732,3717,-1,-16,692,25723820,3692
2053,a1701,20151109,3732,3717,3736,3744,3716,3731,3732,14,15,1748,65239360,3840
2054,a1701,20151110,3731,3732,3726,3736,3707,3710,3716,-22,-16,742,27576620,4186
2055,a1701,20151111,3710,3716,3707,3728,3685,3704,3701,-12,-15,1034,38272680,4014
2056,a1701,20151112,3704,3701,3729,3739,3705,3715,3715,14,14,742,27567380,4182
2057,a1701,20151113,3715,3715,3715,3739,3683,3728,3726,13,11,1512,56342260,4052
2058,a1701,20151116,3728,3726,3726,3735,3692,3692,3715,-34,-11,1348,50083660,4652
2059,a1701,20151117,3692,3715,3707,3715,3671,3695,3699,-20,-16,792,29298860,4642
2060,a1701,20151118,3695,3699,3686,3725,3686,3700,3701,1,2,302,11178300,4622
2061,a1701,20151119,3700,3701,3685,3710,3629,3631,3646,-70,-55,2246,81900600,4630
2062,a1701,20151120,3631,3646,3649,3649,3616,3617,3627,-29,-19,1110,40270020,4416
2063,a1701,20151123,3617,3627,3634,3683,3613,3647,3652,20,25,1252,45731640,4386
2064,a1701,20151124,3647,3652,3646,3678,3645,3669,3660,17,8,2626,96137660,6066
2065,a1701,20151125,3669,3660,3671,3700,3655,3662,3668,2,8,430,15776520,6082
2066,a1701,20151126,3662,3668,3652,3699,3640,3685,3679,17,11,748,27525020,6246
2067,a1701,20151127,3685,3679,3690,3690,3655,3655,3665,-24,-14,270,9896180,6360
2068,a1701,20151130,3655,3665,3654,3670,3641,3668,3657,3,-8,374,13680200,6346
2069,a1701,20151201,3668,3657,3663,3700,3643,3671,3669,14,12,380,13942760,6332
2070,a1701,20151202,3671,3669,3669,3716,3669,3689,3699,20,30,1662,61480200,7226
2071,a1701,20151203,3689,3699,3683,3722,3665,3713,3706,14,7,1038,38473460,7672
2072,a1701,20151204,3713,3706,3709,3730,3690,3697,3703,-9,-3,490,18147720,7682
2073,a1701,20151207,3697,3703,3693,3714,3688,3704,3704,1,1,214,7928320,7714
2074,a1701,20151208,3704,3704,3709,3709,3671,3674,3686,-30,-18,228,8405180,7788
2075,a1701,20151209,3674,3686,3674,3685,3657,3658,3671,-28,-15,262,9619640,7762
2076,a1701,20151210,3658,3671,3663,3666,3648,3650,3656,-21,-15,368,13455200,7852
2077,a1701,20151211,3650,3656,3654,3659,3636,3653,3643,-3,-13,594,21645280,7816
2078,a1701,20151214,3653,3643,3655,3662,3640,3640,3645,-3,2,190,6927320,7860
2079,a1701,20151215,3640,3645,3640,3648,3630,3633,3636,-12,-9,566,20584160,8092
2080,a1701,20151216,3633,3636,3636,3645,3624,3644,3633,8,-3,272,9884140,8116
2081,a1701,20151217,3644,3633,3644,3656,3630,3644,3645,11,12,870,31712480,8426
2082,a1701,20151218,3644,3645,3634,3696,3631,3668,3651,23,6,1004,36659640,8658
2083,a1701,20151221,3668,3651,3673,3700,3666,3700,3686,49,35,2222,81922580,8972
2084,a1701,20151222,3700,3686,3700,3717,3670,3670,3691,-16,5,2004,73987180,9364
2085,a1701,20151223,3670,3691,3671,3684,3657,3672,3665,-19,-26,1530,56083460,9392
2086,a1701,20151224,3672,3665,3661,3678,3652,3665,3666,0,1,574,21043780,9376
2087,a1701,20151225,3665,3666,3665,3674,3619,3624,3640,-42,-26,6454,234926180,9526
2088,a1701,20151228,3624,3640,3628,3628,3495,3495,3551,-145,-89,3792,134663780,10500
2089,a1701,20151229,3495,3551,3486,3498,3478,3495,3488,-56,-63,2730,95241880,10656
2090,a1701,20151230,3495,3488,3495,3516,3484,3499,3504,11,16,3510,123010140,10784
2091,a1701,20151231,3499,3504,3499,3499,3484,3484,3491,-20,-13,1942,67796120,11048
2092,a1703,20150917,4342,4342,4420,4420,4167,4167,4293,-175,-49,4,171740,2
2093,a1703,20150918,4167,4293,0,0,0,4262,4262,-31,-31,0,0,2
2094,a1703,20150921,4262,4262,4262,4262,4141,4141,4201,-121,-61,4,168060,2
2095,a1703,20150922,4141,4201,4175,4175,4162,4162,4172,-39,-29,12,500740,12
2096,a1703,20150923,4162,4172,4105,4115,4091,4108,4107,-64,-65,90,3696300,100
2097,a1703,20150924,4108,4107,0,0,0,4107,4107,0,0,0,0,100
2098,a1703,20150925,4107,4107,0,0,0,4093,4093,-14,-14,0,0,100
2099,a1703,20150928,4093,4093,0,0,0,4083,4083,-10,-10,0,0,100
2100,a1703,20150929,4083,4083,0,0,0,4087,4087,4,4,0,0,100
2101,a1703,20150930,4087,4087,0,0,0,4089,4089,2,2,0,0,100
2102,a1703,20151008,4089,4089,3990,3991,3980,3980,3988,-109,-101,40,1595200,140
2103,a1703,20151009,3980,3988,3960,3978,3956,3978,3959,-10,-29,26,1029520,164
2104,a1703,20151012,3978,3959,0,0,0,3959,3959,0,0,0,0,164
2105,a1703,20151013,3959,3959,3926,3937,3915,3935,3927,-24,-32,14,549900,172
2106,a1703,20151014,3935,3927,3947,3990,3947,3980,3976,53,49,14,556680,178
2107,a1703,20151015,3980,3976,0,0,0,3977,3977,1,1,0,0,178
2108,a1703,20151016,3977,3977,3878,3927,3876,3876,3896,-101,-81,22,857200,192
2109,a1703,20151019,3876,3896,3796,3883,3796,3883,3864,-13,-32,28,1082140,212
2110,a1703,20151020,3883,3864,3869,3883,3770,3869,3860,5,-4,120,4633180,118
2111,a1703,20151021,3869,3860,3859,3859,3859,3859,3859,-1,-1,2,77180,118
2112,a1703,20151022,3859,3859,3810,3870,3810,3836,3841,-23,-18,18,691440,128
2113,a1703,20151023,3836,3841,3840,3840,3836,3840,3839,-1,-2,16,614320,130
2114,a1703,20151026,3840,3839,3856,3856,3798,3798,3820,-41,-19,18,687680,140
2115,a1703,20151027,3798,3820,3774,3774,3769,3770,3770,-50,-50,8,301640,138
2116,a1703,20151028,3770,3770,3784,3800,3712,3712,3767,-58,-3,90,3390760,194
2117,a1703,20151029,3712,3767,3719,3740,3712,3712,3724,-55,-43,18,670340,196
2118,a1703,20151030,3712,3724,3727,3727,3692,3697,3701,-27,-23,60,2221160,226
2119,a1703,20151102,3697,3701,0,0,0,3703,3703,2,2,0,0,226
2120,a1703,20151103,3703,3703,3692,3692,3692,3692,3692,-11,-11,2,73840,226
2121,a1703,20151104,3692,3692,3696,3725,3695,3716,3714,24,22,20,742960,236
2122,a1703,20151105,3716,3714,3709,3717,3698,3713,3709,-1,-5,14,519320,238
2123,a1703,20151106,3713,3709,3699,3716,3697,3716,3703,7,-6,28,1037080,242
2124,a1703,20151109,3716,3703,3713,3730,3704,3720,3709,17,6,34,1261160,262
2125,a1703,20151110,3720,3709,3714,3790,3700,3703,3719,-6,10,118,4388640,348
2126,a1703,20151111,3703,3719,3690,3705,3679,3705,3692,-14,-27,30,1107720,352
2127,a1703,20151112,3705,3692,3710,3715,3708,3715,3711,23,19,20,742360,354
2128,a1703,20151113,3715,3711,3709,3715,3709,3710,3712,-1,1,26,965300,346
2129,a1703,20151116,3710,3712,3711,3711,3677,3677,3692,-35,-20,50,1846240,358
2130,a1703,20151117,3677,3692,3688,3710,3661,3698,3680,6,-12,48,1766400,338
2131,a1703,20151118,3698,3680,3688,3703,3674,3681,3690,1,10,54,1992700,342
2132,a1703,20151119,3681,3690,3691,3691,3543,3617,3595,-73,-95,296,10641560,244
2133,a1703,20151120,3617,3595,3622,3624,3592,3592,3613,-3,18,26,939500,238
2134,a1703,20151123,3592,3613,3641,3641,3620,3632,3627,19,14,54,1958800,204
2135,a1703,20151124,3632,3627,3638,3665,3638,3665,3653,38,26,30,1095920,206
2136,a1703,20151125,3665,3653,3668,3693,3648,3655,3663,2,10,22,805880,200
2137,a1703,20151126,3655,3663,3647,3679,3647,3664,3665,1,2,42,1539380,198
2138,a1703,20151127,3664,3665,3677,3677,3642,3642,3660,-23,-5,24,878440,192
2139,a1703,20151130,3642,3660,0,0,0,3660,3660,0,0,0,0,192
2140,a1703,20151201,3660,3660,3648,3658,3647,3655,3654,-5,-6,54,1973500,174
2141,a1703,20151202,3655,3654,3683,3683,3642,3644,3665,-10,11,30,1099780,160
2142,a1703,20151203,3644,3665,3658,3688,3658,3688,3682,23,17,40,1473140,130
2143,a1703,20151204,3688,3682,0,0,0,3682,3682,0,0,0,0,130
2144,a1703,20151207,3682,3682,0,0,0,3688,3688,6,6,0,0,130
2145,a1703,20151208,3688,3688,3681,3691,3675,3675,3681,-13,-7,10,368140,130
2146,a1703,20151209,3675,3681,3667,3668,3667,3668,3667,-13,-14,4,146700,130
2147,a1703,20151210,3668,3667,3649,3656,3649,3650,3652,-17,-15,10,365200,130
2148,a1703,20151211,3650,3652,3646,3652,3637,3642,3644,-10,-8,16,583120,132
2149,a1703,20151214,3642,3644,3665,3665,3645,3645,3655,1,11,12,438600,132
2150,a1703,20151215,3645,3655,3652,3654,3638,3640,3647,-15,-8,10,364720,132
2151,a1703,20151216,3640,3647,3638,3651,3638,3651,3644,4,-3,14,510160,132
2152,a1703,20151217,3651,3644,0,0,0,3644,3644,0,0,0,0,132
2153,a1703,20151218,3644,3644,0,0,0,3644,3644,0,0,0,0,132
2154,a1703,20151221,3644,3644,3672,3767,3671,3709,3730,65,86,80,2984040,144
2155,a1703,20151222,3709,3730,3726,3735,3689,3689,3714,-41,-16,26,965800,150
2156,a1703,20151223,3689,3714,3682,3683,3666,3666,3674,-48,-40,12,440920,154
2157,a1703,20151224,3666,3674,0,0,0,3674,3674,0,0,0,0,154
2158,a1703,20151225,3674,3674,3676,3676,3625,3625,3665,-49,-9,14,513100,150
2159,a1703,20151228,3625,3665,3625,3625,3519,3519,3582,-146,-83,68,2436260,160
2160,a1703,20151229,3519,3582,3498,3510,3498,3510,3507,-72,-75,10,350700,160
2161,a1703,20151230,3510,3507,3520,3525,3504,3504,3515,-3,8,16,562440,160
2162,a1703,20151231,3504,3515,3502,3506,3491,3491,3501,-24,-14,22,770280,164
2163,a1705,20151116,3715,3715,3680,3835,3680,3710,3721,-5,6,102,3795520,60
2164,a1705,20151117,3710,3721,3695,3730,3695,3728,3728,7,7,178,6636560,126
2165,a1705,20151118,3728,3728,3718,3727,3652,3709,3702,-19,-26,16,592420,132
2166,a1705,20151119,3709,3702,3638,3700,3600,3629,3642,-73,-60,118,4298220,156
2167,a1705,20151120,3629,3642,3610,3645,3596,3621,3624,-21,-18,136,4929880,186
2168,a1705,20151123,3621,3624,3622,3667,3622,3630,3640,6,16,42,1529060,188
2169,a1705,20151124,3630,3640,3653,3735,3639,3686,3667,46,27,40,1466820,196
2170,a1705,20151125,3686,3667,3657,3672,3657,3671,3668,4,1,24,880380,200
2171,a1705,20151126,3671,3668,3680,3689,3671,3676,3678,8,10,58,2133500,234
2172,a1705,20151127,3676,3678,3678,3678,3660,3660,3667,-18,-11,42,1540180,244
2173,a1705,20151130,3660,3667,3652,3664,3652,3664,3659,-3,-8,22,805160,244
2174,a1705,20151201,3664,3659,3657,3678,3657,3677,3673,18,14,48,1763400,246
2175,a1705,20151202,3677,3673,3678,3720,3672,3678,3695,5,22,48,1773840,246
2176,a1705,20151203,3678,3695,3676,3708,3676,3700,3693,5,-2,80,2954500,246
2177,a1705,20151204,3700,3693,3729,3729,3680,3685,3693,-8,0,68,2511440,244
2178,a1705,20151207,3685,3693,3709,3709,3695,3695,3704,2,11,12,444520,244
2179,a1705,20151208,3695,3704,3691,3757,3671,3679,3690,-25,-14,62,2288200,246
2180,a1705,20151209,3679,3690,3678,3678,3662,3662,3670,-28,-20,24,880920,254
2181,a1705,20151210,3662,3670,3654,3669,3642,3642,3654,-28,-16,34,1242660,258
2182,a1705,20151211,3642,3654,3649,3659,3633,3659,3641,5,-13,108,3933320,226
2183,a1705,20151214,3659,3641,3647,3655,3636,3645,3644,4,3,16,583100,224
2184,a1705,20151215,3645,3644,3647,3670,3637,3637,3646,-7,2,40,1458760,228
2185,a1705,20151216,3637,3646,3666,3666,3642,3655,3654,9,8,120,4385980,298
2186,a1705,20151217,3655,3654,3656,3660,3655,3658,3656,4,2,216,7898820,232
2187,a1705,20151218,3658,3656,3631,3695,3625,3695,3674,39,18,122,4483020,254
2188,a1705,20151221,3695,3674,3692,3732,3692,3732,3713,58,39,156,5792440,302
2189,a1705,20151222,3732,3713,3741,3741,3706,3706,3726,-7,13,200,7452540,386
2190,a1705,20151223,3706,3726,3706,3708,3689,3689,3697,-37,-29,410,15158540,270
2191,a1705,20151224,3689,3697,3688,3703,3688,3697,3695,0,-2,54,1995620,284
2192,a1705,20151225,3697,3695,3696,3699,3648,3649,3670,-46,-25,308,11306240,418
2193,a1705,20151228,3649,3670,3628,3650,3524,3530,3582,-140,-88,392,14042720,482
2194,a1705,20151229,3530,3582,3526,3536,3517,3530,3528,-52,-54,382,13478060,534
2195,a1705,20151230,3530,3528,3450,3560,3450,3527,3525,-1,-3,242,8532420,518
2196,a1705,20151231,3527,3525,3530,3533,3510,3514,3517,-11,-8,184,6471620,558
